Total Forecast,Total Measured & Upscaled,Monitored Capacity,Total Forecast,Total Measured & Upscaled,Monitored Capacity ,Total Forecast ,Total Measured & Upscaled ,Monitored Capacity
260350,178632.4,930650,166910,149488.5,338450,93440,29143.9,592200
262830,176457.9,930650,167540,148617.6,338450,95290,27840.3,592200
265390,180155,930650,168220,153415.1,338450,97170,26739.9,592200
267910,187204,930650,168880,156407.2,338450,99030,30796.8,592200
270450,181069.8,930650,169540,150313.3,338450,100910,30756.5,592200
273220,174892,930650,170330,145988.3,338450,102890,28903.7,592200
275930,174926.5,930650,171090,146941.6,338450,104840,27984.9,592200
278680,179011,930650,171890,149818,338450,106790,29193,592200
281510,184026.6,930650,172680,155443.1,338450,108830,28583.5,592200
282960,194414.9,930650,173010,162762.9,338450,109950,31652,592200
284410,201563.6,930650,173370,169668.4,338450,111040,31895.2,592200
285880,207961.4,930650,173720,175568.8,338450,112160,32392.6,592200
287320,207801,930650,174050,176825,338450,113270,30976,592200
288480,211571.6,930650,174200,178684.7,338450,114280,32886.9,592200
289650,214580.4,930650,174340,181446,338450,115310,33134.4,592200
290820,204880.8,930650,174490,172142.1,338450,116330,32738.7,592200
291990,199946.2,930650,174640,169200.5,338450,117350,30745.7,592200
293060,201566.4,930650,174620,173452.5,338450,118440,28113.9,592200
294110,196214.3,930650,174610,166997,338450,119500,29217.3,592200
295180,200356.9,930650,174610,171928.5,338450,120570,28428.4,592200
296300,201325.8,930650,174590,172715.3,338450,121710,28610.5,592200
298870,199837.6,930650,174850,169422.9,338450,124020,30414.7,592200
301430,195969.7,930650,175110,168730.2,338450,126320,27239.5,592200
304030,199268.7,930650,175360,169455,338450,128670,29813.7,592200
306630,200606.8,930650,175630,170735,338450,131000,29871.8,592200
309620,198697,930650,176300,168557.2,338450,133320,30139.8,592200
312590,176300.7,930650,176990,148355.8,338450,135600,27944.9,592200
315550,171263.8,930650,177650,145906.3,338450,137900,25357.5,592200
318530,178804.2,930650,178360,149117,338450,140170,29687.2,592200
321040,161978.5,930650,178400,132800.7,338450,142640,29177.8,592200
323610,158671,930650,178440,130316.1,338450,145170,28354.9,592200
326170,162233.3,930650,178470,131280.5,338450,147700,30952.8,592200
328710,373867.8,930650,178550,183887.9,338450,150160,189979.9,592200
325720,373806.3,930650,178220,190056.4,338450,147500,183749.9,592200
322720,184351.8,930650,177920,154931.1,338450,144800,29420.7,592200
319810,162513.4,930650,177620,134312.2,338450,142190,28201.2,592200
316860,154289,930650,177340,127036.7,338450,139520,27252.3,592200
313780,150069.5,930650,177330,126391.2,338450,136450,23678.3,592200
310660,262366.8,930650,177300,161316.8,338450,133360,101050,592200
307520,148391.1,930650,177300,124664.5,338450,130220,23726.6,592200
304440,135001.6,930650,177300,112665.4,338450,127140,22336.2,592200
296050,189493.8,930650,176190,109229.4,338450,119860,80264.4,592200
287640,169684.2,930650,175080,100035,338450,112560,69649.2,592200
279200,169010.9,930650,173970,100514.8,338450,105230,68496.1,592200
270830,179850.8,930650,172890,109528.3,338450,97940,70322.5,592200
275510,192767.6,930650,174590,112287.3,338450,100920,80480.3,592200
280210,217541.2,930650,176300,124650,338450,103910,92891.2,592200
284910,241572,930650,178010,140262.6,338450,106900,101309.4,592200
289650,236259.2,930650,179710,148854.1,338450,109940,87405.1,592200
294460,235356,930650,180740,149268.3,338450,113720,86087.7,592200
299220,286554.2,930650,181750,171300.8,338450,117470,115253.4,592200
304030,307830.5,930650,182770,179859.2,338450,121260,127971.3,592200
308800,313340.9,930650,183760,184572.2,338450,125040,128768.7,592200
314200,313868.5,930650,185350,183052.7,338450,128850,130815.8,592200
319590,315685.8,930650,186900,183137.6,338450,132690,132548.2,592200
324990,300151.8,930650,188480,175469.3,338450,136510,124682.5,592200
330390,285596.9,930650,190040,168274.2,338450,140350,117322.7,592200
333950,270218.1,930650,191220,158488.5,338450,142730,111729.6,592200
337500,286120,930650,192390,169563.5,338450,145110,116556.5,592200
341070,306130.2,930650,193570,187265.8,338450,147500,118864.4,592200
344630,319474.3,930650,194750,193028.2,338450,149880,126446.1,592200
349850,351448.7,930650,197160,199788.9,338450,152690,151659.8,592200
355080,356619.7,930650,199620,201579.4,338450,155460,155040.3,592200
360240,371313.8,930650,202050,202910.2,338450,158190,168403.6,592200
365520,354686.2,930650,204490,199549.7,338450,161030,155136.5,592200
370820,347506.4,930650,207560,197697.6,338450,163260,149808.8,592200
376260,379236.7,930650,210620,207325.8,338450,165640,171910.9,592200
381550,362328.5,930650,213620,208194.6,338450,167930,154133.9,592200
386960,364008.8,930650,216700,207504.9,338450,170260,156503.9,592200
387300,354118.8,930650,216750,204428.8,338450,170550,149690,592200
387700,372975.7,930650,216780,212859.1,338450,170920,160116.6,592200
388060,374225,930650,216830,216879.4,338450,171230,157345.6,592200
388420,382663.7,930650,216870,217242.1,338450,171550,165421.6,592200
389620,390320.7,930650,217040,216939.1,338450,172580,173381.6,592200
390800,408934.2,930650,217220,222129.9,338450,173580,186804.3,592200
391990,406739.8,930650,217390,225858.9,338450,174600,180880.9,592200
393210,413610.8,930650,217570,232759.4,338450,175640,180851.4,592200
394410,445273.4,930650,217350,245987.7,338450,177060,199285.7,592200
395650,442686.2,930650,217120,249598.4,338450,178530,193087.8,592200
396880,446287,930650,216890,253764.2,338450,179990,192522.8,592200
398130,440529.3,930650,216680,249552.1,338450,181450,190977.2,592200
400000,465021.8,930650,215240,258837.9,338450,184760,206183.9,592200
401870,493409.8,930650,213780,259189.7,338450,188090,234220.1,592200
403710,499272.4,930650,212350,259752.7,338450,191360,239519.7,592200
405580,499954.3,930650,210910,258332.4,338450,194670,241621.9,592200
407680,495744.7,930650,209810,260882,338450,197870,234862.7,592200
409810,494227.2,930650,208720,244996.3,338450,201090,249230.9,592200
411920,468194.9,930650,207610,227347.1,338450,204310,240847.8,592200
414020,437598.5,930650,206510,207721.7,338450,207510,229876.8,592200
413540,448698.8,930650,203640,218873.3,338450,209900,229825.5,592200
413050,456221.3,930650,200760,216369.8,338450,212290,239851.5,592200
412580,479579.4,930650,197910,225656.4,338450,214670,253923,592200
412120,470090.3,930650,195020,217905.3,338450,217100,252185,592200
409350,467856.6,930650,192970,217670,338450,216380,250186.6,592200
406560,474046,930650,190900,224500.1,338450,215660,249545.9,592200
403870,448030.5,930650,188860,215084.8,338450,215010,232945.7,592200
413610,464485,930650,185560,231768.8,338450,228050,232716.2,592200
411020,482047.4,930650,183030,232154,338450,227990,249893.4,592200
408400,458590.3,930650,180490,216314.1,338450,227910,242276.2,592200
405750,453165.2,930650,177960,208764,338450,227790,244401.2,592200
403020,430990,930650,175440,203236.9,338450,227580,227753.1,592200
399150,415600.5,930650,172900,195824.1,338450,226250,219776.4,592200
395390,395205.8,930650,170400,179101.9,338450,224990,216103.9,592200
391590,399172.5,930650,167850,182066.8,338450,223740,217105.7,592200
387790,384027.3,930650,165320,171839.1,338450,222470,212188.2,592200
381010,348451.7,930650,162800,161607.3,338450,218210,186844.4,592200
374130,342603.4,930650,160260,157359.3,338450,213870,185244.1,592200
367290,338547.9,930650,157740,152876.1,338450,209550,185671.8,592200
360460,332564.1,930650,155210,158074.6,338450,205250,174489.5,592200
353380,319716.6,930650,152480,148207.4,338450,200900,171509.2,592200
346210,327350.1,930650,149720,150981.1,338450,196490,176369,592200
339110,315364.1,930650,147000,137817.8,338450,192110,177546.3,592200
332000,286394,930650,144250,114752.9,338450,187750,171641.1,592200
324900,308179.8,930650,141230,126744.3,338450,183670,181435.5,592200
317790,313765,930650,138170,122884.1,338450,179620,190880.9,592200
310720,318365.7,930650,135160,127679.4,338450,175560,190686.3,592200
303690,319888.9,930650,132130,132709.5,338450,171560,187179.4,592200
299750,296271.9,930650,130840,131396.2,338450,168910,164875.7,592200
295930,286486.6,930650,129590,127522.5,338450,166340,158964.1,592200
292140,260284.7,930650,128360,111245.9,338450,163780,149038.8,592200
288280,290129.4,930650,127100,122444,338450,161180,167685.4,592200
285550,295088.8,930650,126890,131677.4,338450,158660,163411.4,592200
282770,279681.2,930650,126680,121747,338450,156090,157934.2,592200
280070,257676.4,930650,126490,112212.2,338450,153580,145464.2,592200
277290,260269.2,930650,126290,110420.8,338450,151000,149848.4,592200
274040,270084.6,930650,125360,118198.1,338450,148680,151886.5,592200
270820,273700,930650,124430,120296.1,338450,146390,153403.9,592200
267500,272510.8,930650,123470,117041.4,338450,144030,155469.4,592200
264260,282652.7,930650,122550,123365.3,338450,141710,159287.4,592200
265710,277778.5,930650,123410,116064.9,338450,142300,161713.6,592200
267080,256683.8,930650,124290,101833.5,338450,142790,154850.3,592200
268550,230199.4,930650,125160,85692.9,338450,143390,144506.5,592200
269980,207593.6,930650,126040,72134.7,338450,143940,135458.9,592200
271540,199315.7,930650,127420,67040.9,338450,144120,132274.8,592200
273000,197078.2,930650,128840,69259.8,338450,144160,127818.4,592200
274610,213345,930650,130270,79768.3,338450,144340,133576.7,592200
276130,231376.2,930650,131680,90855.2,338450,144450,140521,592200
278250,219831.3,930650,133040,77552.1,338450,145210,142279.2,592200
280420,223438.9,930650,134360,78962.1,338450,146060,144476.8,592200
282530,250148.2,930650,135720,94498.8,338450,146810,155649.4,592200
284710,239368.6,930650,137050,87871.7,338450,147660,151496.9,592200
290820,256046,930650,141200,99679.5,338450,149620,156366.5,592200
296870,269730.5,930650,145370,110777.1,338450,151500,158953.4,592200
303000,271993.2,930650,149520,114312.1,338450,153480,157681.1,592200
309100,272507,930650,153700,112246.8,338450,155400,160260.2,592200
314530,294815,930650,157500,122816.6,338450,157030,171998.4,592200
319950,304081.1,930650,161330,130449.7,338450,158620,173631.4,592200
325400,313125.4,930650,165150,133037.8,338450,160250,180087.6,592200
330850,314948.6,930650,168980,131708.5,338450,161870,183240.1,592200
337690,293278.1,930650,174090,116400.9,338450,163600,176877.2,592200
344610,332480.9,930650,179240,140926.6,338450,165370,191554.3,592200
351490,292396,930650,184360,118961.9,338450,167130,173434.1,592200
358350,281121.2,930650,189460,104516.8,338450,168890,176604.4,592200
361120,320852.4,930650,191340,134756.4,338450,169780,186096,592200
363910,337325.7,930650,193220,142110.6,338450,170690,195215.1,592200
366660,360110.8,930650,195080,161581.7,338450,171580,198529.1,592200
369400,360518.9,930650,196970,171262.6,338450,172430,189256.3,592200
371280,363724.7,930650,198270,168589,338450,173010,195135.7,592200
373290,360757.1,930650,199580,168975.5,338450,173710,191781.6,592200
375190,350973.9,930650,200890,173128.1,338450,174300,177845.8,592200
377080,359434.1,930650,202190,179303,338450,174890,180131.1,592200
378810,383417.4,930650,203680,194070.3,338450,175130,189347.1,592200
380460,393678.8,930650,205150,201603.1,338450,175310,192075.7,592200
382070,403497.9,930650,206620,207729.1,338450,175450,195768.8,592200
383780,397524.8,930650,208090,210773.1,338450,175690,186751.7,592200
383010,409685.6,930650,208450,211729.3,338450,174560,197956.3,592200
382170,420701.8,930650,208830,216905.1,338450,173340,203796.7,592200
381440,408498.4,930650,209220,212553,338450,172220,195945.4,592200
380620,399164.7,930650,209590,204476.9,338450,171030,194687.8,592200
380130,393048.2,930650,209960,202209.4,338450,170170,190838.8,592200
379720,380160.1,930650,210340,198316.9,338450,169380,181843.2,592200
379240,380735.7,930650,210710,200735.4,338450,168530,180000.3,592200
378820,384438.7,930650,211100,204335.3,338450,167720,180103.4,592200
379180,407812.6,930650,211640,215041.9,338450,167540,192770.7,592200
379460,388370.8,930650,212200,207321.6,338450,167260,181049.2,592200
379820,382808.4,930650,212770,206167.8,338450,167050,176640.6,592200
380250,414724.3,930650,213350,219758.6,338450,166900,194965.7,592200
390200,425703.9,930650,215930,219581.6,338450,174270,206122.3,592200
400120,415800.2,930650,218500,208763.8,338450,181620,207036.4,592200
410150,418175.6,930650,221090,208175.5,338450,189060,210000.1,592200
420060,448225.9,930650,223660,234351.6,338450,196400,213874.3,592200
429690,467522.3,930650,225920,242760.1,338450,203770,224762.2,592200
439170,475229.2,930650,228170,244653.8,338450,211000,230575.4,592200
448680,504038.7,930650,230430,256635.8,338450,218250,247402.9,592200
458290,514259.5,930650,232670,262150,338450,225620,252109.5,592200
467810,513216.9,930650,235030,259302.9,338450,232780,253914,592200
477400,512975.9,930650,237400,258055.7,338450,240000,254920.2,592200
486980,525958.7,930650,239760,259661.4,338450,247220,266297.3,592200
496560,557185.5,930650,242120,273197.1,338450,254440,283988.4,592200
503000,559638.8,930650,243670,264566.5,338450,259330,295072.3,592200
509520,538788.1,930650,245200,251017.8,338450,264320,287770.3,592200
515920,541793,930650,246740,253791.9,338450,269180,288001.1,592200
534700,544296.4,930650,252680,255377.2,338450,282020,288919.2,592200
543590,559985,930650,254950,260783.7,338450,288640,299201.3,592200
552430,529559.9,930650,257230,235367,338450,295200,294192.9,592200
561280,551543.7,930650,259480,245469,338450,301800,306074.7,592200
570150,596068.7,930650,261740,271583.5,338450,308410,324485.2,592200
579080,624715.2,930650,264230,275973.1,338450,314850,348742.1,592200
587920,631590.7,930650,266670,277084.7,338450,321250,354506,592200
596830,617358.9,930650,269130,271234.5,338450,327700,346124.4,592200
605730,616723.2,930650,271610,274893.4,338450,334120,341829.8,592200
608280,602553.9,930650,271970,268453.5,338450,336310,334100.4,592200
610790,587164.3,930650,272330,261056.1,338450,338460,326108.2,592200
613400,591218,930650,272700,260533.1,338450,340700,330684.9,592200
615890,591562.7,930650,273040,268562.4,338450,342850,323000.3,592200
618550,581402.3,930650,273370,262988.5,338450,345180,318413.8,592200
621230,584330.9,930650,273700,263407.7,338450,347530,320923.2,592200
623960,601467.6,930650,274020,274717.6,338450,349940,326750,592200
626580,609673.2,930650,274340,278988.3,338450,352240,330684.9,592200
629510,613204.2,930650,274740,274773.9,338450,354770,338430.3,592200
632390,606707.8,930650,275100,270247.8,338450,357290,336460,592200
635280,632125.1,930650,275490,275848.8,338450,359790,356276.3,592200
638170,633738.9,930650,275860,278211.5,338450,362310,355527.4,592200
634750,645101.8,930650,273660,274228.7,338450,361090,370873.1,592200
631340,654259.2,930650,271460,274346.5,338450,359880,379912.7,592200
627970,658218.2,930650,269260,275467.5,338450,358710,382750.7,592200
624540,631558.8,930650,267060,256149.3,338450,357480,375409.5,592200
621240,666008.1,930650,264360,278756.7,338450,356880,387251.4,592200
617920,677006.4,930650,261660,284968.7,338450,356260,392037.7,592200
614640,686275,930650,258970,288529.9,338450,355670,397745.1,592200
611380,680905.8,930650,256250,287230,338450,355130,393675.8,592200
607640,682473.1,930650,253990,290495,338450,353650,391978.1,592200
603940,679064.2,930650,251720,287390.6,338450,352220,391673.6,592200
600200,654298.6,930650,249430,280108.6,338450,350770,374190,592200
596440,661536.2,930650,247160,278579.2,338450,349280,382957,592200
593750,691804,930650,243760,285357.7,338450,349990,406446.3,592200
591080,687839.5,930650,240360,279803.2,338450,350720,408036.3,592200
588370,655718,930650,236950,260117.6,338450,351420,395600.4,592200
585710,650458.9,930650,233560,259401.4,338450,352150,391057.5,592200
582280,698730,930650,230000,282673,338450,352280,416057,592200
578910,688675.5,930650,226450,275810.1,338450,352460,412865.4,592200
575530,661583.1,930650,222920,262706,338450,352610,398877.1,592200
572130,656164.9,930650,219350,263318.2,338450,352780,392846.7,592200
569630,653614.1,930650,215940,248233.9,338450,353690,405380.2,592200
567050,640075.6,930650,212480,244585.4,338450,354570,395490.2,592200
564490,629013.5,930650,209060,242160.6,338450,355430,386852.9,592200
561940,636172.9,930650,205600,238424.7,338450,356340,397748.2,592200
570650,640988,930650,210260,251955.4,338450,360390,389032.6,592200
579390,663934.3,930650,214910,272317.4,338450,364480,391616.9,592200
588150,655892.3,930650,219560,268127.1,338450,368590,387765.2,592200
596890,665004.2,930650,224210,273401.4,338450,372680,391602.8,592200
604260,660067.1,930650,227740,271077,338450,376520,388990.1,592200
611620,656410.4,930650,231240,264884.5,338450,380380,391525.9,592200
618950,673269.6,930650,234760,272363.9,338450,384190,400905.7,592200
626370,631174.9,930650,238290,243866,338450,388080,387308.9,592200
636270,555243.2,930650,244100,206449.9,338450,392170,348793.3,592200
646180,481134.5,930650,249910,163045.7,338450,396270,318088.8,592200
656030,512961.7,930650,255710,185611,338450,400320,327350.7,592200
665890,497797.9,930650,261480,184150,338450,404410,313647.9,592200
673750,496348.6,930650,264810,186556.5,338450,408940,309792.1,592200
681570,514690.1,930650,268120,200568,338450,413450,314122.1,592200
689430,517768.3,930650,271430,210633.8,338450,418000,307134.5,592200
697200,454423.9,930650,274720,169223.5,338450,422480,285200.4,592200
705090,509885.8,930650,278510,200684,338450,426580,309201.8,592200
712890,558918.8,930650,282240,221245.6,338450,430650,337673.2,592200
720760,533269.2,930650,286000,210557.8,338450,434760,322711.4,592200
728570,508452.3,930650,289750,206993.6,338450,438820,301458.7,592200
736070,527299.6,930650,292370,212440.9,338450,443700,314858.7,592200
743680,540288.7,930650,295030,221655.3,338450,448650,318633.4,592200
751290,538030.1,930650,297670,238687.4,338450,453620,299342.7,592200
758800,570792.5,930650,300320,252205,338450,458480,318587.5,592200
758470,557354.1,930650,299440,250707.4,338450,459030,306646.7,592200
758170,534929.7,930650,298540,236620.6,338450,459630,298309.1,592200
757800,515254.8,930650,297640,227141.3,338450,460160,288113.5,592200
757500,505847.4,930650,296730,219516.2,338450,460770,286331.2,592200
752590,515521.3,930650,291710,217827,338450,460880,297694.3,592200
747730,482627.2,930650,286670,205172.2,338450,461060,277455,592200
742910,483736,930650,281650,202920.5,338450,461260,280815.5,592200
738040,477920.8,930650,276610,199829.8,338450,461430,278091,592200
735410,467523.6,930650,274230,195058.9,338450,461180,272464.7,592200
732820,457983.7,930650,271800,181800,338450,461020,276183.7,592200
730210,507556.7,930650,269400,208939.1,338450,460810,298617.6,592200
727560,537632.7,930650,267000,223170.7,338450,460560,314462,592200
723160,551403.7,930650,267430,230196,338450,455730,321207.7,592200
718850,551146.8,930650,267850,226214,338450,451000,324932.8,592200
714440,520913.5,930650,268290,215149.9,338450,446150,305763.6,592200
710070,547333.4,930650,268700,212916.4,338450,441370,334417,592200
703130,570228.1,930650,266920,232435.3,338450,436210,337792.8,592200
696070,581703.4,930650,265170,244914,338450,430900,336789.4,592200
689010,553051.9,930650,263340,224835.9,338450,425670,328216,592200
682020,545710,930650,261560,226580.2,338450,420460,319129.8,592200
675930,583021,930650,260270,249353.7,338450,415660,333667.3,592200
669900,555067.4,930650,259000,224352.7,338450,410900,330714.7,592200
663850,573472.1,930650,257720,230753.4,338450,406130,342718.7,592200
657770,610651.7,930650,256420,243231.8,338450,401350,367419.9,592200
646010,653872.7,930650,252730,263598.7,338450,393280,390274,592200
634160,645979.5,930650,249010,255236.6,338450,385150,390742.9,592200
622390,619256,930650,245280,239022.6,338450,377110,380233.4,592200
501930,583841.3,930650,177410,216513.8,338450,324520,367327.5,592200
504780,566408.3,930650,176120,207318.6,338450,328660,359089.7,592200
507530,549884.4,930650,174810,206055.5,338450,332720,343828.9,592200
510400,542888.6,930650,173550,204793.6,338450,336850,338095,592200
513180,531907.8,930650,172250,197993.8,338450,340930,333914,592200
516800,512457.5,930650,171540,176473.3,338450,345260,335984.2,592200
520420,475628.7,930650,170820,149482.6,338450,349600,326146.1,592200
524010,445851.9,930650,170080,135763.2,338450,353930,310088.7,592200
527650,437937.9,930650,169340,136179,338450,358310,301758.9,592200
518890,434738.2,930650,167570,141594,338450,351320,293144.2,592200
510070,433674.3,930650,165800,144193.7,338450,344270,289480.6,592200
501320,426226.8,930650,164010,138231.8,338450,337310,287995,592200
492520,408096.9,930650,162220,123955.6,338450,330300,284141.3,592200
484430,419777,930650,161990,128656.4,338450,322440,291120.6,592200
476370,420877.1,930650,161730,130012.4,338450,314640,290864.7,592200
468240,423979.4,930650,161480,134105.4,338450,306760,289874,592200
460160,430407.4,930650,161230,133002.3,338450,298930,297405.1,592200
450590,439806.2,930650,159850,132346.4,338450,290740,307459.8,592200
441000,450413.9,930650,158460,133108.2,338450,282540,317305.7,592200
431410,454993.8,930650,157070,133981.6,338450,274340,321012.2,592200
421810,470733,930650,155680,148771.7,338450,266130,321961.3,592200
406180,488617.5,930650,150130,153099.5,338450,256050,335518,592200
390580,481584.1,930650,144590,144415.3,338450,245990,337168.8,592200
374900,485022.6,930650,139040,148075.4,338450,235860,336947.2,592200
359280,491355.3,930650,133470,155669.7,338450,225810,335685.6,592200
343190,491775.4,930650,126930,158341.6,338450,216260,333433.8,592200
327210,463719.5,930650,120390,143464.3,338450,206820,320255.2,592200
311120,423228.5,930650,113870,116568.5,338450,197250,306660,592200
295120,406527.8,930650,107330,111398.5,338450,187790,295129.3,592200
278590,414637.1,930650,100520,123559.6,338450,178070,291077.5,592200
262020,393784,930650,93700,115866.1,338450,168320,277917.9,592200
245410,384968,930650,86890,108649.1,338450,158520,276318.9,592200
228880,434792.4,930650,80090,141339.1,338450,148790,293453.3,592200
224360,364384.5,930650,78940,92175.9,338450,145420,272208.6,592200
219880,335095.6,930650,77810,73159.6,338450,142070,261936,592200
215340,375879.8,930650,76660,107707.4,338450,138680,268172.4,592200
210840,400824.1,930650,75530,119290.9,338450,135310,281533.2,592200
207730,392909.3,930650,75050,114430.4,338450,132680,278478.9,592200
204650,341236.1,930650,74620,103464,338450,130030,237772.1,592200
201500,328715.9,930650,74160,105853,338450,127340,222862.9,592200
198410,326313,930650,73700,120118.2,338450,124710,206194.8,592200
196060,300652.1,930650,73330,115818.2,338450,122730,184833.9,592200
193780,314759.3,930650,72950,128239.4,338450,120830,186519.9,592200
191410,317727.7,930650,72560,132307.6,338450,118850,185420.1,592200
189040,297622.1,930650,72190,130479.3,338450,116850,167142.8,592200
199710,291652.2,930650,77220,136287.1,338450,122490,155365.1,592200
210410,275072,930650,82280,128677.1,338450,128130,146394.9,592200
221120,301472.7,930650,87290,139431.1,338450,133830,162041.6,592200
231820,314808.6,930650,92320,137695.2,338450,139500,177113.4,592200
237540,356898.9,930650,94850,144437.2,338450,142690,212461.7,592200
243210,346078.8,930650,97390,140831.3,338450,145820,205247.5,592200
248900,352224.5,930650,99890,144491.3,338450,149010,207733.2,592200
254590,367537.4,930650,102440,145074.7,338450,152150,222462.7,592200
261440,381060.9,930650,105660,156133.5,338450,155780,224927.4,592200
268370,386005.3,930650,108880,166837.4,338450,159490,219167.9,592200
275220,361275.8,930650,112100,153599.7,338450,163120,207676.1,592200
282030,355360.7,930650,115340,147265.9,338450,166690,208094.8,592200
291690,361316.5,930650,121020,154472,338450,170670,206844.5,592200
301310,367016.5,930650,126700,161730.8,338450,174610,205285.7,592200
310990,372657.1,930650,132370,163566,338450,178620,209091.1,592200
320610,380617.5,930650,138060,175426.3,338450,182550,205191.2,592200
329180,413037.9,930650,142310,184734.4,338450,186870,228303.5,592200
337650,418157,930650,146510,184361.2,338450,191140,233795.8,592200
346120,444786,930650,150740,201535.5,338450,195380,243250.5,592200
354630,418593.3,930650,154960,178415.8,338450,199670,240177.5,592200
360500,397441.6,930650,158620,176973,338450,201880,220468.6,592200
366330,401555.2,930650,162280,179331.7,338450,204050,222223.5,592200
372190,392302.4,930650,165940,180339.1,338450,206250,211963.3,592200
378060,366860,930650,169590,161754.4,338450,208470,205105.6,592200
366950,346769.7,930650,166000,140620.2,338450,200950,206149.5,592200
355970,307225.4,930650,162370,111157.3,338450,193600,196068.1,592200
344940,251415.4,930650,158780,92924.2,338450,186160,158491.2,592200
333850,252358.7,930650,155170,91054.6,338450,178680,161304.1,592200
323010,257224.9,930650,151190,110678,338450,171820,146546.9,592200
312170,253892,930650,147220,122703.5,338450,164950,131188.5,592200
301320,261559.1,930650,143250,128184.9,338450,158070,133374.2,592200
290460,290152.3,930650,139270,136042.8,338450,151190,154109.5,592200
282250,310919,930650,135840,149742.3,338450,146410,161176.7,592200
274100,341825.3,930650,132410,167802.2,338450,141690,174023.1,592200
265910,355648.6,930650,128980,184799.9,338450,136930,170848.7,592200
257710,373092.3,930650,125540,190027.2,338450,132170,183065.1,592200
268040,390139.5,930650,131570,198177.6,338450,136470,191961.9,592200
278290,418454.2,930650,137600,211469.7,338450,140690,206984.5,592200
288510,442192.5,930650,143610,219105,338450,144900,223087.5,592200
298740,468462,930650,149620,227879.9,338450,149120,240582.1,592200
307850,480757.7,930650,154790,230501.6,338450,153060,250256.1,592200
316890,490887.9,930650,159950,238416,338450,156940,252471.9,592200
325950,498251.8,930650,165150,248986.1,338450,160800,249265.7,592200
335040,486385.9,930650,170310,244678.7,338450,164730,241707.2,592200
342320,480642.6,930650,174060,241772.1,338450,168260,238870.5,592200
349550,469825.1,930650,177770,234833.1,338450,171780,234992,592200
356800,456017.8,930650,181510,224769.2,338450,175290,231248.6,592200
364080,464244.7,930650,185260,233852.2,338450,178820,230392.5,592200
364320,474014.4,930650,185810,235717,338450,178510,238297.4,592200
364590,485526.7,930650,186360,239464.9,338450,178230,246061.8,592200
364810,487071.3,930650,186890,235281.1,338450,177920,251790.2,592200
352720,481652.3,930650,184220,231673.3,338450,168500,249979,592200
355220,468341.8,930650,182240,219317.7,338450,172980,249024.1,592200
357680,411325.3,930650,180220,175090.3,338450,177460,236235,592200
360180,394108.1,930650,178220,168364.2,338450,181960,225743.9,592200
362730,403686.8,930650,176250,171985.9,338450,186480,231700.9,592200
363680,416206.6,930650,173730,174712.5,338450,189950,241494.1,592200
364560,440170.4,930650,171170,178471.4,338450,193390,261699,592200
365530,442669.8,930650,168640,176629.2,338450,196890,266040.6,592200
366430,445313.3,930650,166120,177559.7,338450,200310,267753.6,592200
379410,473712.1,930650,170810,193331.3,338450,208600,280380.8,592200
392350,474954.9,930650,175510,189240,338450,216840,285714.9,592200
405280,482743.4,930650,180210,191273.4,338450,225070,291470,592200
418220,488410.2,930650,184900,196626.5,338450,233320,291783.7,592200
429360,481136.7,930650,188730,187504.7,338450,240630,293632,592200
440480,494176.8,930650,192580,188952,338450,247900,305224.8,592200
451670,491071.6,930650,196430,188696.3,338450,255240,302375.3,592200
462780,484262,930650,200260,189626.1,338450,262520,294635.9,592200
472910,529369,930650,203600,216292.8,338450,269310,313076.2,592200
482990,559006.8,930650,206930,229545.6,338450,276060,329461.2,592200
493000,581276.6,930650,210250,237021.8,338450,282750,344254.8,592200
503170,614905.6,930650,213580,252992,338450,289590,361913.6,592200
518130,671285.7,930650,214280,279184.1,338450,303850,392101.6,592200
533080,694574.8,930650,214990,286392.3,338450,318090,408182.5,592200
548040,695148.9,930650,215700,288203.2,338450,332340,406945.7,592200
563040,701210.7,930650,216390,287424.5,338450,346650,413786.2,592200
584780,745179.8,930650,222180,301644.3,338450,362600,443535.5,592200
606630,759361.6,930650,227980,299899.3,338450,378650,459462.3,592200
628430,790071,930650,233770,309306.9,338450,394660,480764.1,592200
650190,804440.6,930650,239570,313065.7,338450,410620,491374.9,592200
675530,806258.9,930650,246840,308620.7,338450,428690,497638.2,592200
700830,726639.8,930650,254140,265228.8,338450,446690,461411,592200
726180,627051.1,930650,261410,186276.6,338450,464770,440774.5,592200
751530,614292.5,930650,268700,173861.3,338450,482830,440431.2,592200
758370,583147.4,930650,271430,150575.2,338450,486940,432572.2,592200
765250,579082.6,930650,274140,148799.2,338450,491110,430283.4,592200
772100,583148.8,930650,276880,147536.4,338450,495220,435612.4,592200
778870,565236.6,930650,279570,141367.2,338450,499300,423869.4,592200
782030,551040.5,930650,279700,140498.5,338450,502330,410542,592200
785130,563612.4,930650,279830,146135.9,338450,505300,417476.5,592200
788240,570000.9,930650,279940,160969,338450,508300,409031.9,592200
791350,725617,930650,280070,262503,338450,511280,463114,592200
793590,772482.9,930650,279820,307191.1,338450,513770,465291.8,592200
795750,755967.9,930650,279570,287700.5,338450,516180,468267.4,592200
797970,681994.7,930650,279320,242221.2,338450,518650,439773.5,592200
800220,681477.4,930650,279070,224128.9,338450,521150,457348.5,592200
789520,647862.9,930650,274100,196132.2,338450,515420,451730.7,592200
778850,615325.7,930650,269120,182779.3,338450,509730,432546.4,592200
768110,590721.7,930650,264130,173455.7,338450,503980,417266,592200
757480,600872.6,930650,259170,187409.9,338450,498310,413462.7,592200
746860,633500.3,930650,254840,225238.7,338450,492020,408261.6,592200
736240,630040.1,930650,250530,231855.1,338450,485710,398185,592200
725540,624664.5,930650,246200,234261.6,338450,479340,390402.9,592200
714870,614773,930650,241870,233761.4,338450,473000,381011.6,592200
706020,588540.9,930650,238960,216989.6,338450,467060,371551.3,592200
697250,579612.4,930650,236060,210965.4,338450,461190,368647,592200
688470,605507.2,930650,233130,234563.9,338450,455340,370943.3,592200
679580,603778,930650,230230,239193.9,338450,449350,364584.1,592200
667190,584668.5,930650,227580,227077,338450,439610,357591.5,592200
654850,585976.3,930650,224970,231160,338450,429880,354816.3,592200
642420,602353.8,930650,222340,241676.2,338450,420080,360677.6,592200
630070,606664.8,930650,219700,247194,338450,410370,359470.8,592200
616860,594328.1,930650,217300,246278.5,338450,399560,348049.6,592200
603790,598702.4,930650,214940,248202.8,338450,388850,350499.6,592200
590680,611861.5,930650,212540,259186,338450,378140,352675.5,592200
577570,587512.9,930650,210190,240222.5,338450,367380,347290.4,592200
563020,584074.6,930650,207250,240189.6,338450,355770,343885,592200
548550,525154.6,930650,204370,219511.2,338450,344180,305643.4,592200
533960,484649.4,930650,201430,187075.1,338450,332530,297574.3,592200
519510,449898.3,930650,198550,163691.5,338450,320960,286206.8,592200
498220,442001.7,930650,191130,157935.5,338450,307090,284066.2,592200
476970,425359.8,930650,183690,148783.3,338450,293280,276576.5,592200
455830,420177.9,930650,176270,148832.2,338450,279560,271345.7,592200
434550,415781.4,930650,168830,139148.1,338450,265720,276633.3,592200
414760,405146.1,930650,161850,129424,338450,252910,275722.1,592200
394900,398464.6,930650,154880,135642,338450,240020,262822.6,592200
375190,389326.7,930650,147880,131042.4,338450,227310,258284.3,592200
355370,364330.5,930650,140900,120658.1,338450,214470,243672.4,592200
334560,346340.4,930650,133430,113424.3,338450,201130,232916.1,592200
313810,364787.6,930650,125950,125063.7,338450,187860,239723.9,592200
292980,362026.8,930650,118500,119899.9,338450,174480,242126.9,592200
272260,347802.5,930650,111030,117544.5,338450,161230,230258,592200
263930,319356.6,930650,106990,98336.4,338450,156940,221020.2,592200
255610,289906.3,930650,102960,84650.6,338450,152650,205255.7,592200
247340,296311.9,930650,98910,82779.8,338450,148430,213532.1,592200
239010,277687.8,930650,94870,70255.5,338450,144140,207432.3,592200
231360,275578,930650,91450,60092.1,338450,139910,215485.9,592200
223750,298590.7,930650,88000,60832.6,338450,135750,237758.1,592200
216170,286355.4,930650,84600,49367.6,338450,131570,236987.8,592200
208530,286061.3,930650,81160,45710.6,338450,127370,240350.7,592200
200770,280252.3,930650,77140,45092.5,338450,123630,235159.8,592200
192970,264752.6,930650,73130,38418,338450,119840,226334.6,592200
185090,250119.2,930650,69080,31923.2,338450,116010,218196,592200
177310,259376,930650,65060,40403,338450,112250,218973,592200
175790,266143.4,930650,63740,39560.7,338450,112050,226582.7,592200
174270,261688.4,930650,62410,34726.9,338450,111860,226961.5,592200
172640,282741.4,930650,61050,45627.2,338450,111590,237114.2,592200
194140,308288.6,930650,60590,57401.3,338450,133550,250887.3,592200
198190,342541.9,930650,60510,69181.2,338450,137680,273360.7,592200
202280,347546,930650,60440,77338.1,338450,141840,270207.9,592200
206390,361311,930650,60340,87379.3,338450,146050,273931.7,592200
210480,372501.9,930650,60280,90747.2,338450,150200,281754.7,592200
216400,376601.5,930650,61200,92115,338450,155200,284486.5,592200
222370,384423.7,930650,62120,97756,338450,160250,286667.7,592200
228290,386133.2,930650,63040,98695.4,338450,165250,287437.8,592200
234270,386799.9,930650,63970,93100.2,338450,170300,293699.7,592200
237500,380713.1,930650,63730,84673.5,338450,173770,296039.6,592200
240770,379787.5,930650,63510,78260.6,338450,177260,301526.9,592200
243970,374571.2,930650,63270,71172.9,338450,180700,303398.3,592200
247210,360761.3,930650,63020,77455.4,338450,184190,283305.9,592200
248480,355468.1,930650,62060,76767.7,338450,186420,278700.4,592200
249720,369909.8,930650,61100,83759.4,338450,188620,286150.4,592200
250990,389971.7,930650,60150,95376.6,338450,190840,294595.1,592200
252220,400935.1,930650,59190,99649.3,338450,193030,301285.8,592200
253310,393639,930650,58450,88017.5,338450,194860,305621.5,592200
254440,396186.5,930650,57720,92169.1,338450,196720,304017.4,592200
255520,387298,930650,57000,85397.7,338450,198520,301900.3,592200
256570,377643.8,930650,56270,82490.9,338450,200300,295152.9,592200
258350,394532.8,930650,58640,106003,338450,199710,288529.8,592200
260090,427113.8,930650,61020,126827.7,338450,199070,300286.1,592200
261850,463573.2,930650,63380,151874.6,338450,198470,311698.6,592200
263600,461355.8,930650,65750,147482.4,338450,197850,313873.4,592200
266790,487980.5,930650,69250,173666.3,338450,197540,314314.2,592200
270000,515464.4,930650,72770,197084,338450,197230,318380.4,592200
273220,538811.5,930650,76280,212789.1,338450,196940,326022.4,592200
276420,539345.2,930650,79780,204956.1,338450,196640,334389.1,592200
278040,533501.1,930650,81510,199293.7,338450,196530,334207.4,592200
279670,499684.7,930650,83240,167615.8,338450,196430,332068.9,592200
281330,512045.9,930650,84980,182116,338450,196350,329929.9,592200
282940,522915.3,930650,86690,183021.1,338450,196250,339894.2,592200
279380,476783.2,930650,84710,159096.1,338450,194670,317687.1,592200
275750,441532.6,930650,82710,136796.4,338450,193040,304736.2,592200
272270,451830.1,930650,80730,137446.2,338450,191540,314383.9,592200
268610,450570.2,930650,78750,138549.9,338450,189860,312020.3,592200
265280,463609,930650,76980,138629.6,338450,188300,324979.4,592200
261950,466390.3,930650,75220,136990.4,338450,186730,329399.9,592200
258580,456172.9,930650,73430,149577.3,338450,185150,306595.6,592200
255220,423110.9,930650,71670,132562.2,338450,183550,290548.7,592200
252710,429513.1,930650,70200,140224.4,338450,182510,289288.7,592200
250190,431894.1,930650,68680,136958.5,338450,181510,294935.6,592200
247740,427126.5,930650,67190,120672.8,338450,180550,306453.7,592200
245250,412803.6,930650,65720,116001.8,338450,179530,296801.8,592200
236660,399844.4,930650,62370,115444.8,338450,174290,284399.6,592200
228110,395108.4,930650,59060,119971.1,338450,169050,275137.3,592200
219520,395309.2,930650,55720,126228.6,338450,163800,269080.6,592200
210930,382247.5,930650,52390,108618.5,338450,158540,273629,592200
201760,384724.5,930650,49210,95006.9,338450,152550,289717.6,592200
192500,389045.4,930650,46000,94325.7,338450,146500,294719.7,592200
183240,353922.6,930650,42810,79679.5,338450,140430,274243.1,592200
174090,317098.7,930650,39630,67051.5,338450,134460,250047.2,592200
165110,266401.1,930650,36530,42431.1,338450,128580,223970,592200
156190,232991.7,930650,33450,31289.9,338450,122740,201701.8,592200
147240,187229.3,930650,30380,17730,338450,116860,169499.3,592200
138300,169553,930650,27280,10290.7,338450,111020,159262.3,592200
131250,144963.8,930650,25490,7334.2,338450,105760,137629.6,592200
124040,120716,930650,23670,5351.6,338450,100370,115364.4,592200
116930,109829.2,930650,21850,4000.7,338450,95080,105828.5,592200
109780,109772.1,930650,20030,3360.3,338450,89750,106411.8,592200
102840,106722,930650,18260,2706.9,338450,84580,104015.1,592200
95860,101754.8,930650,16510,2208.3,338450,79350,99546.5,592200
88910,97166.9,930650,14750,2255,338450,74160,94911.9,592200
81930,100620.4,930650,12990,2769.4,338450,68940,97851,592200
74770,98723.4,930650,11200,3068.1,338450,63570,95655.3,592200
67610,98304,930650,9390,3433.9,338450,58220,94870.1,592200
60360,95037.8,930650,7570,3558.1,338450,52790,91479.7,592200
53160,94251.2,930650,5740,3851,338450,47420,90400.2,592200
51130,87662.9,930650,6000,3588.5,338450,45130,84074.4,592200
49170,77300.1,930650,6240,2976,338450,42930,74324.1,592200
47180,66418.3,930650,6480,2413.5,338450,40700,64004.8,592200
45070,62943.4,930650,6730,2301,338450,38340,60642.4,592200
42920,62334.2,930650,6760,2426,338450,36160,59908.2,592200
40740,61290.8,930650,6790,2488.5,338450,33950,58802.3,592200
38490,67509.1,930650,6820,4562.7,338450,31670,62946.4,592200
36270,71621.9,930650,6880,5729.9,338450,29390,65892,592200
34200,74530.5,930650,7020,7482.3,338450,27180,67048.2,592200
32100,77855,930650,7130,10090,338450,24970,67765,592200
29980,78158.2,930650,7250,10105.9,338450,22730,68052.3,592200
27910,81001.5,930650,7390,11325.3,338450,20520,69676.2,592200
28660,88820.8,930650,8060,15135.8,338450,20600,73685,592200
29400,93257.3,930650,8720,17440.3,338450,20680,75817,592200
30100,97661.7,930650,9350,19350.7,338450,20750,78311,592200
30910,94610.4,930650,10050,17029.5,338450,20860,77580.9,592200
31640,92019.7,930650,10700,16292.9,338450,20940,75726.8,592200
32380,96790,930650,11350,18914.2,338450,21030,77875.8,592200
33100,108083,930650,12030,25412.9,338450,21070,82670.1,592200
33810,99975.6,930650,12680,21100.3,338450,21130,78875.3,592200
34810,100642.1,930650,13400,18997.9,338450,21410,81644.2,592200
35830,100496.6,930650,14170,16918.5,338450,21660,83578.1,592200
36790,99919.2,930650,14900,16065.3,338450,21890,83853.9,592200
37710,104836.5,930650,15650,17852.1,338450,22060,86984.4,592200
39380,116407.3,930650,16070,21610.5,338450,23310,94796.8,592200
41020,114641.9,930650,16470,20229.6,338450,24550,94412.3,592200
42670,122661.6,930650,16900,25709.4,338450,25770,96952.2,592200
30890,126782.7,930650,10800,30259.4,338450,20090,96523.3,592200
33180,121331.2,930650,11790,25653.7,338450,21390,95677.5,592200
35360,116042.4,930650,12780,21389,338450,22580,94653.4,592200
37560,111738.7,930650,13750,18305.6,338450,23810,93433.1,592200
39810,113805.6,930650,14740,18295.9,338450,25070,95509.7,592200
42110,114109.7,930650,15770,19616.9,338450,26340,94492.8,592200
44430,118672.2,930650,16800,21583.9,338450,27630,97088.3,592200
46640,127715.8,930650,17790,26315.5,338450,28850,101400.3,592200
48860,136161.9,930650,18790,28222.1,338450,30070,107939.8,592200
52280,129416.3,930650,19470,22921.8,338450,32810,106494.5,592200
55660,122536.2,930650,20120,21401.1,338450,35540,101135.1,592200
58960,123384.4,930650,20770,22320.6,338450,38190,101063.8,592200
62320,127244,930650,21420,23255.6,338450,40900,103988.4,592200
66070,139974.2,930650,22600,26502.5,338450,43470,113471.7,592200
69900,149158.6,930650,23770,30300.2,338450,46130,118858.4,592200
73680,149490.3,930650,24930,32674.8,338450,48750,116815.5,592200
77530,152575.3,930650,26120,31725.9,338450,51410,120849.4,592200
81390,157492.8,930650,27240,34281.4,338450,54150,123211.4,592200
85260,164533.9,930650,28340,40097.6,338450,56920,124436.3,592200
89060,154349.9,930650,29460,34322.8,338450,59600,120027.1,592200
92950,162828.8,930650,30590,33849.8,338450,62360,128979,592200
91160,167543.9,930650,30300,38757.5,338450,60860,128786.4,592200
89400,147043.5,930650,30020,34130.5,338450,59380,112913,592200
87620,130543.7,930650,29760,27984.7,338450,57860,102559,592200
85860,133947.5,930650,29460,27303.7,338450,56400,106643.8,592200
84180,122352.1,930650,29510,21285.5,338450,54670,101066.6,592200
82450,125026.7,930650,29550,18712.8,338450,52900,106313.9,592200
80780,119448.3,930650,29590,18131.4,338450,51190,101316.9,592200
79040,113994.9,930650,29610,19442.5,338450,49430,94552.4,592200
76490,113106.4,930650,29150,21431.7,338450,47340,91674.7,592200
73770,109539.2,930650,28650,20720.5,338450,45120,88818.7,592200
71190,102586,930650,28170,17046.7,338450,43020,85539.3,592200
68500,107366.6,930650,27690,16831.8,338450,40810,90534.8,592200
66920,111728.1,930650,27450,16738.3,338450,39470,94989.8,592200
65310,101724.1,930650,27200,15611.1,338450,38110,86113,592200
63730,90193.6,930650,26940,12398.4,338450,36790,77795.2,592200
62120,83913.6,930650,26670,9565.6,338450,35450,74348,592200
60560,80721.1,930650,26970,10588.4,338450,33590,70132.7,592200
58980,82120.9,930650,27290,11395.7,338450,31690,70725.2,592200
57380,78807.2,930650,27560,10479.1,338450,29820,68328.1,592200
55820,80319.2,930650,27870,8837.4,338450,27950,71481.8,592200
52000,82405.8,930650,25980,8437.9,338450,26020,73967.9,592200
48210,82540.1,930650,24100,8763.9,338450,24110,73776.2,592200
44380,79875.1,930650,22210,7222.2,338450,22170,72652.9,592200
40570,56927.6,930650,20330,4944.5,338450,20240,51983.1,592200
40110,61741.4,930650,19420,5308.7,338450,20690,56432.7,592200
39570,60772.1,930650,18490,5588.6,338450,21080,55183.5,592200
39060,65534.5,930650,17590,6315.6,338450,21470,59218.9,592200
38580,64602.5,930650,16670,6819.6,338450,21910,57782.9,592200
38950,66377.5,930650,16480,7893.7,338450,22470,58483.8,592200
39320,69287.4,930650,16310,9719.2,338450,23010,59568.2,592200
39750,65101,930650,16140,8970.2,338450,23610,56130.8,592200
40100,58448.1,930650,15960,6090,338450,24140,52358.1,592200
40000,56395.6,930650,15400,5435,338450,24600,50960.6,592200
39820,56129.9,930650,14850,6337.7,338450,24970,49792.2,592200
39700,49998.5,930650,14280,5668.4,338450,25420,44330.1,592200
39550,48583.4,930650,13710,4342.2,338450,25840,44241.2,592200
38100,47432.6,930650,12850,4049,338450,25250,43383.6,592200
36680,46936,930650,12000,3586.3,338450,24680,43349.7,592200
35190,46812.2,930650,11150,4736.6,338450,24040,42075.6,592200
33760,48272,930650,10290,3458.2,338450,23470,44813.8,592200
32470,50084.4,930650,9500,3770.8,338450,22970,46313.6,592200
31200,44256.5,930650,8710,3118.5,338450,22490,41138,592200
29840,48087.9,930650,7880,3405.5,338450,21960,44682.4,592200
28620,51038.7,930650,7090,4115.3,338450,21530,46923.4,592200
27410,51640.4,930650,6550,5968.7,338450,20860,45671.7,592200
26260,51145.8,930650,6010,4052.5,338450,20250,47093.3,592200
25060,47687.7,930650,5470,3160.4,338450,19590,44527.3,592200
23940,47978.8,930650,4940,3096.6,338450,19000,44882.2,592200
24090,49314.4,930650,4910,3197,338450,19180,46117.4,592200
24270,48148.1,930650,4900,3220.7,338450,19370,44927.4,592200
24410,46476.2,930650,4890,3012.2,338450,19520,43464,592200
24610,46804.5,930650,4880,3019,338450,19730,43785.5,592200
24920,47783.9,930650,4740,3056.5,338450,20180,44727.4,592200
25260,46980.2,930650,4620,2940.9,338450,20640,44039.3,592200
25580,43464.9,930650,4510,2447.6,338450,21070,41017.3,592200
25930,42671,930650,4380,2351,338450,21550,40320,592200
26560,43181.2,930650,4480,2486.5,338450,22080,40694.7,592200
27160,41864.2,930650,4570,2618.5,338450,22590,39245.7,592200
27720,41385,930650,4620,2895.5,338450,23100,38489.5,592200
28360,40182.2,930650,4720,2392.2,338450,23640,37790,592200
28230,40647.5,930650,4640,2442,338450,23590,38205.5,592200
28050,40856.1,930650,4570,2349.9,338450,23480,38506.2,592200
27870,43254.6,930650,4490,2720.5,338450,23380,40534.1,592200
27690,44194.6,930650,4400,2877.4,338450,23290,41317.2,592200
26940,46013.9,930650,4350,3483.2,338450,22590,42530.7,592200
26110,47421.3,930650,4260,3506.7,338450,21850,43914.6,592200
25330,49475,930650,4210,3698.8,338450,21120,45776.2,592200
24570,49444.5,930650,4140,3560,338450,20430,45884.5,592200
24110,50711,930650,4170,4754.6,338450,19940,45956.4,592200
23720,50241.2,930650,4220,4145.9,338450,19500,46095.3,592200
23220,50965.9,930650,4250,4367.1,338450,18970,46598.8,592200
22820,51235.6,930650,4300,5036,338450,18520,46199.6,592200
22200,53255.3,930650,4350,5429.7,338450,17850,47825.6,592200
21530,55301.7,930650,4390,6136.3,338450,17140,49165.4,592200
20840,57686.2,930650,4430,6532.6,338450,16410,51153.6,592200
21630,59005.9,930650,5460,7967.6,338450,16170,51038.3,592200
23300,57888.9,930650,6080,7482.4,338450,17220,50406.5,592200
24860,60162.4,930650,6670,7376.8,338450,18190,52785.6,592200
26530,66388.8,930650,7240,10695.9,338450,19290,55692.9,592200
28100,74750.9,930650,7840,13845.2,338450,20260,60905.7,592200
30280,79941.7,930650,8890,14741.8,338450,21390,65199.9,592200
32460,86902.1,930650,9920,16924.6,338450,22540,69977.5,592200
34580,96373,930650,10990,21949.4,338450,23590,74423.6,592200
36750,103193.4,930650,12010,25862.2,338450,24740,77331.2,592200
39620,114546.1,930650,13170,32714.1,338450,26450,81832,592200
42490,127100.6,930650,14340,39152.9,338450,28150,87947.7,592200
45370,134052.1,930650,15500,42445.8,338450,29870,91606.3,592200
48200,139949.4,930650,16670,43830.3,338450,31530,96119.1,592200
51920,150936.5,930650,18240,49494.6,338450,33680,101441.9,592200
55590,160731.8,930650,19760,55897,338450,35830,104834.8,592200
59320,168165.5,930650,21300,58897.3,338450,38020,109268.2,592200
63050,174317.9,930650,22830,63139.3,338450,40220,111178.6,592200
66850,180459.4,930650,24380,65496.8,338450,42470,114962.6,592200
70520,192573.1,930650,25930,72636.3,338450,44590,119936.8,592200
74250,213313.2,930650,27450,81520.5,338450,46800,131792.7,592200
78030,229902.3,930650,29000,91007.9,338450,49030,138894.4,592200
82970,222769.9,930650,30920,81531.8,338450,52050,141238.1,592200
87890,218747.9,930650,32880,74819.4,338450,55010,143928.5,592200
92770,225031.5,930650,34810,77838.9,338450,57960,147192.6,592200
97650,227566.8,930650,36770,80347.2,338450,60880,147219.6,592200
102330,228394.6,930650,38740,78658.6,338450,63590,149736,592200
106930,232977.5,930650,40690,82812,338450,66240,150165.5,592200
111620,239944.7,930650,42630,88848.7,338450,68990,151096,592200
116260,243874.8,930650,44600,90415.4,338450,71660,153459.4,592200
121420,256769.8,930650,46590,99227,338450,74830,157542.8,592200
126500,254305,930650,48530,97783.1,338450,77970,156521.9,592200
131690,252714.3,930650,50510,91935.4,338450,81180,160778.9,592200
136770,258939.4,930650,52460,95873.6,338450,84310,163065.8,592200
135200,244728.1,930650,53010,92201.4,338450,82190,152526.7,592200
133630,238003.6,930650,53570,90719.3,338450,80060,147284.3,592200
132030,256487.8,930650,54120,90555.9,338450,77910,165931.9,592200
130400,279410.7,930650,54660,102158.8,338450,75740,177251.9,592200
129010,288422.4,930650,55410,110544.2,338450,73600,177878.2,592200
127570,295458.5,930650,56150,119420.2,338450,71420,176038.3,592200
126100,272050.4,930650,56920,110903.4,338450,69180,161147,592200
124710,242536.2,930650,57650,97690.4,338450,67060,144845.8,592200
121200,227029.9,930650,57570,92117.3,338450,63630,134912.6,592200
117740,211168.8,930650,57490,82883.6,338450,60250,128285.2,592200
114270,188705.2,930650,57420,69694.9,338450,56850,119010.3,592200
110780,176658.6,930650,57330,60316.7,338450,53450,116341.9,592200
106960,160684.9,930650,55300,52500.9,338450,51660,108184,592200
103220,162076.1,930650,53270,54644,338450,49950,107432.1,592200
99480,154394.9,930650,51230,49804.5,338450,48250,104590.4,592200
95720,150719.1,930650,49210,44932.4,338450,46510,105786.7,592200
92800,138642.5,930650,47220,38654,338450,45580,99988.5,592200
89910,136696.2,930650,45250,36607.7,338450,44660,100088.5,592200
87110,135393.9,930650,43300,36287.4,338450,43810,99106.5,592200
84160,134243.6,930650,41320,34541.7,338450,42840,99701.9,592200
80880,135900.6,930650,39450,37481,338450,41430,98419.6,592200
77650,135176.3,930650,37620,37369.5,338450,40030,97806.8,592200
74360,131470.2,930650,35750,34153.2,338450,38610,97317,592200
71060,125294.3,930650,33920,30811.4,338450,37140,94482.9,592200
70960,129757.6,930650,33710,34802,338450,37250,94955.6,592200
70860,127471.8,930650,33500,34266.7,338450,37360,93205.1,592200
70730,134303.3,930650,33250,37156,338450,37480,97147.3,592200
70620,131004.4,930650,33050,34876.7,338450,37570,96127.7,592200
71150,130888.7,930650,33310,38628.5,338450,37840,92260.2,592200
71700,148159.2,930650,33580,51094.2,338450,38120,97065,592200
72240,163619.6,930650,33880,60428.5,338450,38360,103191.1,592200
72870,167311.3,930650,34160,58431.9,338450,38710,108879.4,592200
72900,168698.6,930650,33810,55188,338450,39090,113510.6,592200
72960,154818.6,930650,33480,47661.4,338450,39480,107157.2,592200
73000,154145.2,930650,33140,45626.8,338450,39860,108518.4,592200
73050,164111.5,930650,32790,53668.3,338450,40260,110443.2,592200
72620,158198.8,930650,32080,53170.2,338450,40540,105028.6,592200
72180,166322.5,930650,31370,59436.8,338450,40810,106885.7,592200
71690,178333.5,930650,30620,62067.2,338450,41070,116266.3,592200
71240,174789.8,930650,29910,56427.7,338450,41330,118362.1,592200
70290,163582.6,930650,28560,46310.8,338450,41730,117271.8,592200
69300,162979.4,930650,27220,42528.1,338450,42080,120451.3,592200
68410,177677.4,930650,25870,46495,338450,42540,131182.4,592200
67550,189343.3,930650,24540,47080.6,338450,43010,142262.7,592200
67230,175614,930650,23660,41748.8,338450,43570,133865.2,592200
66990,173939.6,930650,22770,40214.2,338450,44220,133725.4,592200
66770,175678.2,930650,21900,37362.8,338450,44870,138315.4,592200
66440,176547.5,930650,21010,35495.1,338450,45430,141052.4,592200
63070,175264.1,930650,19720,33293.6,338450,43350,141970.5,592200
59680,163601.2,930650,18420,26932.6,338450,41260,136668.6,592200
56330,159159,930650,17110,19696.4,338450,39220,139462.6,592200
52980,149924.4,930650,15820,21731.8,338450,37160,128192.6,592200
49840,167014.8,930650,14860,23412.2,338450,34980,143602.6,592200
46650,149087,930650,13890,23169.4,338450,32760,125917.6,592200
43420,137695.2,930650,12910,19239.2,338450,30510,118456,592200
40270,131134,930650,11950,16598.4,338450,28320,114535.6,592200
37640,121819.6,930650,11250,15556.6,338450,26390,106263,592200
34950,110026.9,930650,10500,14039.1,338450,24450,95987.8,592200
32280,93914.2,930650,9780,10229.4,338450,22500,83684.8,592200
29580,94229.2,930650,9080,11082.9,338450,20500,83146.3,592200
29500,95282.8,930650,9280,12766.2,338450,20220,82516.6,592200
29450,97814.2,930650,9490,15136.1,338450,19960,82678.1,592200
29350,104732.1,930650,9680,18302.2,338450,19670,86429.9,592200
47620,101743.3,930650,23490,17859.9,338450,24130,83883.4,592200
51140,103969.7,930650,26280,19390.4,338450,24860,84579.3,592200
54670,97164.6,930650,29060,20659.7,338450,25610,76504.9,592200
58120,92956.9,930650,31810,22393.6,338450,26310,70563.3,592200
61680,90353.6,930650,34620,22439.5,338450,27060,67914.1,592200
66420,84672.8,930650,38140,21129.9,338450,28280,63542.9,592200
71100,83186.5,930650,41670,21462.1,338450,29430,61724.4,592200
75820,84676.6,930650,45190,23429.4,338450,30630,61247.2,592200
80540,84363.6,930650,48720,23946.7,338450,31820,60416.9,592200
85270,97348.4,930650,50800,33522.3,338450,34470,63826.1,592200
89960,110670.5,930650,52870,42278.6,338450,37090,68391.9,592200
94660,123889.6,930650,54970,50771.2,338450,39690,73118.4,592200
99370,140406.8,930650,57040,60048.9,338450,42330,80357.9,592200
103240,143654,930650,58410,60839.5,338450,44830,82814.5,592200
107200,153600.3,930650,59790,67417.1,338450,47410,86183.2,592200
111050,152888.9,930650,61140,65547.7,338450,49910,87341.2,592200
114960,155423,930650,62550,63626.3,338450,52410,91796.7,592200
118340,163477.5,930650,63730,64194.1,338450,54610,99283.4,592200
121710,166282.4,930650,64910,62563.6,338450,56800,103718.8,592200
125080,168102.7,930650,66090,60769.5,338450,58990,107333.2,592200
128450,178776.9,930650,67270,67276.9,338450,61180,111500,592200
125400,177265.5,930650,65990,69360.1,338450,59410,107905.4,592200
122410,164273.4,930650,64700,63457.5,338450,57710,100815.9,592200
119380,156853.6,930650,63410,56131.1,338450,55970,100722.5,592200
116400,139210.1,930650,62150,46296.4,338450,54250,92913.7,592200
113290,134438.5,930650,60590,42744,338450,52700,91694.5,592200
110130,126802.7,930650,59010,36921.9,338450,51120,89880.8,592200
107000,133472.1,930650,57450,40630.6,338450,49550,92841.5,592200
103880,159034,930650,55890,59763.6,338450,47990,99270.4,592200
100590,171936.5,930650,53990,67820.1,338450,46600,104116.4,592200
97280,169011.3,930650,52060,65184.8,338450,45220,103826.5,592200
94000,150747.2,930650,50170,53325.8,338450,43830,97421.4,592200
90660,141895.6,930650,48240,49062.2,338450,42420,92833.4,592200
88480,135778.3,930650,48320,44514,338450,40160,91264.3,592200
86140,132748.3,930650,48360,43991.5,338450,37780,88756.8,592200
83900,128209.4,930650,48410,44042.2,338450,35490,84167.2,592200
81650,124880.1,930650,48490,44090.4,338450,33160,80789.7,592200
77520,121634.5,930650,46800,44368.3,338450,30720,77266.2,592200
73350,123433.7,930650,45090,45596.7,338450,28260,77837,592200
69260,124466,930650,43440,44446.3,338450,25820,80019.7,592200
65190,114168.4,930650,41780,38883.5,338450,23410,75284.9,592200
62410,101841.2,930650,41470,34235.5,338450,20940,67605.7,592200
59640,89188.3,930650,41150,28037.9,338450,18490,61150.4,592200
56790,99473.6,930650,40830,29071.4,338450,15960,70402.2,592200
54010,101375.8,930650,40510,26732.9,338450,13500,74642.9,592200
53500,89537.1,930650,39680,20545.3,338450,13820,68991.8,592200
52990,94678.2,930650,38810,22421.2,338450,14180,72257,592200
52520,119131.2,930650,37980,35438.5,338450,14540,83692.7,592200
52020,139665.4,930650,37120,48069.2,338450,14900,91596.2,592200
50920,138715.5,930650,35570,48360.8,338450,15350,90354.7,592200
49680,129859.1,930650,34010,39734.4,338450,15670,90124.7,592200
48500,122877.8,930650,32450,37065.6,338450,16050,85812.2,592200
47410,116199.4,930650,30920,32771.6,338450,16490,83427.8,592200
46270,111273.1,930650,29420,28867.6,338450,16850,82405.5,592200
45140,104268.9,930650,27890,27454.7,338450,17250,76814.2,592200
43990,99071.6,930650,26340,24746.7,338450,17650,74324.9,592200
42870,95026.5,930650,24830,23283,338450,18040,71743.5,592200
41810,92643.5,930650,23720,20661.9,338450,18090,71981.6,592200
40780,91457.1,930650,22610,20914.2,338450,18170,70542.9,592200
39750,90742.9,930650,21470,20843.6,338450,18280,69899.3,592200
38770,97756.6,930650,20370,22387.3,338450,18400,75369.3,592200
37120,95769.1,930650,19000,22175.6,338450,18120,73593.5,592200
35540,94830,930650,17640,20914.3,338450,17900,73915.7,592200
33910,93864.9,930650,16250,19134.4,338450,17660,74730.5,592200
32220,95230.8,930650,14900,19604.5,338450,17320,75626.3,592200
30870,93398.2,930650,13750,18104.1,338450,17120,75294.1,592200
29430,92147.5,930650,12580,16240.8,338450,16850,75906.7,592200
28000,93389.4,930650,11420,17630.1,338450,16580,75759.3,592200
26580,95954.9,930650,10270,19877.3,338450,16310,76077.6,592200
27370,97868.7,930650,10260,18122,338450,17110,79746.7,592200
28130,103741.1,930650,10240,20283,338450,17890,83458.1,592200
28900,98936.7,930650,10230,18637.3,338450,18670,80299.4,592200
29690,97510.7,930650,10200,17864.7,338450,19490,79646,592200
30510,99476,930650,10270,18505,338450,20240,80971,592200
31280,102349.6,930650,10320,17772.7,338450,20960,84576.9,592200
32150,96103.1,930650,10410,13973.8,338450,21740,82129.3,592200
32960,91627.5,930650,10440,10770.3,338450,22520,80857.2,592200
34110,98852,930650,10690,13481.7,338450,23420,85370.3,592200
35220,104853.6,930650,10940,16223.5,338450,24280,88630.1,592200
36370,112759.3,930650,11180,18380.7,338450,25190,94378.6,592200
37520,119051.2,930650,11410,20398.8,338450,26110,98652.4,592200
37920,117463.4,930650,11630,20234.4,338450,26290,97229,592200
38330,120948.2,930650,11870,22052,338450,26460,98896.2,592200
38710,129153,930650,12100,23299.1,338450,26610,105853.9,592200
39060,135511.9,930650,12310,26366.1,338450,26750,109145.8,592200
39770,128873.9,930650,12750,23132.4,338450,27020,105741.5,592200
40520,121372.2,930650,13190,19262.5,338450,27330,102109.7,592200
41190,120151.2,930650,13600,17603.5,338450,27590,102547.7,592200
41920,115438,930650,14040,17218.7,338450,27880,98219.3,592200
42100,109481.8,930650,14130,16112.6,338450,27970,93369.2,592200
42350,105201.7,930650,14220,14413.1,338450,28130,90788.6,592200
42590,107935,930650,14300,15725.8,338450,28290,92209.2,592200
42870,114002.2,930650,14400,17899.2,338450,28470,96103,592200
41770,117065,930650,13950,19586.4,338450,27820,97478.6,592200
40630,120483.3,930650,13500,21311,338450,27130,99172.3,592200
39570,123002.5,930650,13050,22262.8,338450,26520,100739.7,592200
38410,119815.6,930650,12600,21747.2,338450,25810,98068.4,592200
37140,120803.7,930650,12000,22347.8,338450,25140,98455.9,592200
35930,119516.9,930650,11410,20858.9,338450,24520,98658,592200
34550,119260.6,930650,10800,20263.4,338450,23750,98997.2,592200
33290,116830.8,930650,10200,19291.9,338450,23090,97538.9,592200
32310,109742.5,930650,9740,18049.9,338450,22570,91692.6,592200
31400,111322.7,930650,9290,18919.2,338450,22110,92403.5,592200
30340,106035.4,930650,8830,14275.9,338450,21510,91759.5,592200
29370,108470.3,930650,8370,16600.4,338450,21000,91869.9,592200
22120,107006.1,930650,7190,17244.2,338450,14930,89761.9,592200
20830,101512.1,930650,6500,14521.8,338450,14330,86990.3,592200
19620,91234.5,930650,5850,10857.9,338450,13770,80376.6,592200
18340,89358.1,930650,5200,9307.4,338450,13140,80050.7,592200
17280,88068.2,930650,4730,9670.9,338450,12550,78397.3,592200
16240,88535.2,930650,4270,10628.6,338450,11970,77906.6,592200
15150,91285,930650,3790,11520.3,338450,11360,79764.7,592200
14130,90983.5,930650,3330,10398.2,338450,10800,80585.3,592200
13040,86556.9,930650,2860,8369.7,338450,10180,78187.2,592200
11930,83753.7,930650,2380,7052.8,338450,9550,76700.9,592200
10820,82834.5,930650,1920,7502.1,338450,8900,75332.4,592200
9680,83142.9,930650,1430,7207.4,338450,8250,75935.5,592200
9990,81452.9,930650,1560,7990.4,338450,8430,73462.5,592200
10300,81426.4,930650,1680,8325.3,338450,8620,73101.1,592200
10530,84384.7,930650,1790,8936.4,338450,8740,75448.3,592200
10760,89816.3,930650,1890,10218.5,338450,8870,79597.8,592200
11060,91493.5,930650,2000,11626.5,338450,9060,79867,592200
11430,91680.1,930650,2120,11959.3,338450,9310,79720.8,592200
11750,93635.4,930650,2250,12740.4,338450,9500,80895,592200
12040,94371.4,930650,2360,12743.6,338450,9680,81627.8,592200
12330,99686.2,930650,2470,14316.3,338450,9860,85369.9,592200
12500,103401,930650,2560,15029.7,338450,9940,88371.3,592200
12740,106310.2,930650,2670,15435.4,338450,10070,90874.8,592200
12940,109402.2,930650,2780,16416.8,338450,10160,92985.4,592200
12520,106721.5,930650,2790,17381.3,338450,9730,89340.2,592200
12060,88068.1,930650,2770,17483.1,338450,9290,70585,592200
11620,86160.5,930650,2780,17141.2,338450,8840,69019.3,592200
11250,84208,930650,2790,17063.3,338450,8460,67144.7,592200
10880,88609.4,930650,2770,19297.3,338450,8110,69312.1,592200
10490,86305.5,930650,2740,18136.5,338450,7750,68169,592200
10170,76057.2,930650,2740,15834.4,338450,7430,60222.8,592200
9790,66678.4,930650,2710,12836.1,338450,7080,53842.3,592200
9410,58386.1,930650,2770,10930.2,338450,6640,47455.9,592200
9090,50844.7,930650,2810,8073.7,338450,6280,42771,592200
8680,47474.6,930650,2870,5582.8,338450,5810,41891.8,592200
8310,49506.3,930650,2890,5688.7,338450,5420,43817.6,592200
7910,54203,930650,2750,7109.5,338450,5160,47093.5,592200
7530,60109.8,930650,2590,9230.8,338450,4940,50879,592200
7050,70573.8,930650,2440,12379.3,338450,4610,58194.5,592200
6680,76963.6,930650,2310,15838.8,338450,4370,61124.8,592200
6550,76978.8,930650,2240,16042.7,338450,4310,60936.1,592200
6430,75876.7,930650,2200,15499.5,338450,4230,60377.2,592200
6290,69944.1,930650,2140,12733.6,338450,4150,57210.5,592200
6180,68258.5,930650,2080,11230.7,338450,4100,57027.8,592200
6130,63122.3,930650,1990,8929.4,338450,4140,54192.9,592200
6030,61037.8,930650,1890,8570.6,338450,4140,52467.2,592200
5930,56721.8,930650,1800,7069.9,338450,4130,49651.9,592200
5860,55201.7,930650,1700,6432.9,338450,4160,48768.8,592200
6200,56390.2,930650,1750,6933.9,338450,4450,49456.3,592200
6570,58203.5,930650,1800,7622.1,338450,4770,50581.4,592200
6950,62160.3,930650,1860,8581,338450,5090,53579.3,592200
7300,63143.4,930650,1890,9342.6,338450,5410,53800.8,592200
7990,63738.3,930650,1990,9695.6,338450,6000,54042.7,592200
8720,64430.3,930650,2110,9435.1,338450,6610,54995.2,592200
9410,83510.6,930650,2200,12031,338450,7210,71479.6,592200
10130,93636.7,930650,2290,12420.6,338450,7840,81216.1,592200
10840,90204.6,930650,2440,12298,338450,8400,77906.6,592200
11580,90616.3,930650,2580,13575.5,338450,9000,77040.8,592200
12330,92745.3,930650,2750,12929.9,338450,9580,79815.4,592200
13070,93570.6,930650,2890,13009.6,338450,10180,80561,592200
17410,91626.2,930650,4320,12942.8,338450,13090,78683.4,592200
21710,89164.5,930650,5760,12174.9,338450,15950,76989.6,592200
26000,91155,930650,7210,13756.5,338450,18790,77398.5,592200
30260,90611.4,930650,8630,13184.4,338450,21630,77427,592200
34760,89252.5,930650,10250,11889,338450,24510,77363.5,592200
39220,91173,930650,11890,11804.5,338450,27330,79368.5,592200
43690,102633.9,930650,13500,17403,338450,30190,85230.9,592200
48200,110243.5,930650,15130,20456.1,338450,33070,89787.4,592200
52930,126921.9,930650,16960,24984.9,338450,35970,101937,592200
57650,138369.7,930650,18800,26121.2,338450,38850,112248.5,592200
62440,149016.6,930650,20630,29755.7,338450,41810,119260.9,592200
67220,164519.5,930650,22500,35650.5,338450,44720,128869,592200
69670,174994.6,930650,24120,38485.1,338450,45550,136509.5,592200
72240,182854.6,930650,25750,40965.5,338450,46490,141889.1,592200
74800,184220.7,930650,27430,40578.1,338450,47370,143642.6,592200
77280,192164.4,930650,29080,44339.2,338450,48200,147825.2,592200
79350,193586.2,930650,30480,44285.4,338450,48870,149300.8,592200
81380,204538.7,930650,31880,49576.4,338450,49500,154962.3,592200
83460,208115.1,930650,33320,50207.9,338450,50140,157907.2,592200
85510,211053.4,930650,34730,52725.7,338450,50780,158327.7,592200
87560,210369.6,930650,36040,51546.3,338450,51520,158823.3,592200
89510,212731.5,930650,37330,51044.8,338450,52180,161686.7,592200
91540,215395.5,930650,38640,56313.4,338450,52900,159082.1,592200
93490,214161.9,930650,39940,57141.3,338450,53550,157020.6,592200
93630,215798.7,930650,40480,58548.7,338450,53150,157250,592200
93790,217605.2,930650,41020,62268,338450,52770,155337.2,592200
93930,222302.6,930650,41570,67436.7,338450,52360,154865.9,592200
94020,229795.8,930650,42120,71380.2,338450,51900,158415.6,592200
95080,225014.4,930650,43150,75617.5,338450,51930,149396.9,592200
96130,237340,930650,44170,80627.9,338450,51960,156712.1,592200
97210,238354.2,930650,45220,81455.4,338450,51990,156898.8,592200
98360,237339.4,930650,46250,80704.6,338450,52110,156634.8,592200
99280,246952.5,930650,47170,79923.2,338450,52110,167029.3,592200
100310,260754,930650,48100,81556.6,338450,52210,179197.4,592200
101310,244639.8,930650,49020,84755.5,338450,52290,159884.3,592200
102320,262473,930650,49950,88319.5,338450,52370,174153.5,592200
104540,279855.3,930650,51520,92322.4,338450,53020,187532.9,592200
106810,270713.1,930650,53070,93451.1,338450,53740,177262,592200
109120,256243.8,930650,54640,89046.4,338450,54480,167197.4,592200
111430,255854,930650,56220,89373.2,338450,55210,166480.8,592200
113540,253137.1,930650,57700,93468,338450,55840,159669.1,592200
115560,266253.9,930650,59170,99627.7,338450,56390,166626.2,592200
117640,266015.8,930650,60630,97275.3,338450,57010,168740.5,592200
119760,245568.3,930650,62130,91963.2,338450,57630,153605.1,592200
122660,256176.1,930650,63940,87982.5,338450,58720,168193.6,592200
125520,258683.7,930650,65730,84968.2,338450,59790,173715.5,592200
128400,256485.1,930650,67550,86911.9,338450,60850,169573.2,592200
131230,249153.5,930650,69340,83749.4,338450,61890,165404.1,592200
135820,237683.6,930650,71900,76395.6,338450,63920,161288,592200
140410,236221.3,930650,74450,77760.4,338450,65960,158460.9,592200
145050,245583.5,930650,77020,84052.2,338450,68030,161531.3,592200
149630,230000.3,930650,79560,77556.6,338450,70070,152443.7,592200
154070,225517.8,930650,81840,76766.6,338450,72230,148751.2,592200
158530,226813.5,930650,84130,76161.5,338450,74400,150652,592200
162970,240985,930650,86400,80409.6,338450,76570,160575.4,592200
167400,242956.6,930650,88690,79965,338450,78710,162991.6,592200
171360,229075.7,930650,90890,74493.6,338450,80470,154582.1,592200
175320,235174.7,930650,93100,79465,338450,82220,155709.7,592200
179300,241128.6,930650,95260,81451.2,338450,84040,159677.4,592200
183220,228343,930650,97470,75198.3,338450,85750,153144.7,592200
160880,226734.6,930650,86850,71856.6,338450,74030,154878,592200
159400,232418.1,930650,86570,76874.3,338450,72830,155543.8,592200
158050,193999,930650,86330,71232.1,338450,71720,122766.9,592200
156560,159626.9,930650,86080,66917.7,338450,70480,92709.2,592200
155130,152225.6,930650,85820,63287.1,338450,69310,88938.5,592200
153710,149303.4,930650,85570,64705.3,338450,68140,84598.1,592200
152270,141555.6,930650,85300,68111,338450,66970,73444.6,592200
150890,144539.2,930650,85050,71557.2,338450,65840,72982,592200
149430,136624.4,930650,84810,71369.4,338450,64620,65255,592200
147980,130963.3,930650,84530,72900.5,338450,63450,58062.8,592200
146580,133685.1,930650,84300,77027,338450,62280,56658.1,592200
145200,129649.2,930650,84040,77281.9,338450,61160,52367.3,592200
143480,152885,930650,83360,73704.1,338450,60120,79180.9,592200
141660,174255.2,930650,82660,71987.3,338450,59000,102267.9,592200
139960,164723.8,930650,81940,66503.8,338450,58020,98220,592200
138180,166000.6,930650,81260,68785.2,338450,56920,97215.4,592200
136420,153224.2,930650,80560,64289.5,338450,55860,88934.7,592200
134730,162697.8,930650,79860,65044.8,338450,54870,97653,592200
132990,161766.3,930650,79170,66054,338450,53820,95712.3,592200
131230,163661,930650,78480,69109.4,338450,52750,94551.6,592200
129500,196698.1,930650,77780,91832.1,338450,51720,104866,592200
127710,194056.3,930650,77090,90521.9,338450,50620,103534.4,592200
126040,183829.9,930650,76380,83545.1,338450,49660,100284.8,592200
124250,196090.2,930650,75710,95887.4,338450,48540,100202.8,592200
128590,198348.4,930650,77590,101364.6,338450,51000,96983.8,592200
132900,196209.8,930650,79490,99464.2,338450,53410,96745.6,592200
137330,208259.5,930650,81390,101738.7,338450,55940,106520.8,592200
141620,218079.5,930650,83290,108311,338450,58330,109768.5,592200
145950,230336.6,930650,85170,117221.5,338450,60780,113115.1,592200
150250,220338.5,930650,87060,121810.5,338450,63190,98528,592200
154650,228438.5,930650,88960,118871,338450,65690,109567.5,592200
158940,218410.7,930650,90840,121666.1,338450,68100,96744.6,592200
163340,219304.1,930650,92740,129022.1,338450,70600,90282,592200
167660,216813.3,930650,94630,129904.9,338450,73030,86908.4,592200
171990,227880.8,930650,96530,129382.6,338450,75460,98498.2,592200
176330,219289.7,930650,98430,120994.1,338450,77900,98295.6,592200
183470,228668,930650,101490,117081.5,338450,81980,111586.5,592200
190660,197324.2,930650,104590,100362.7,338450,86070,96961.5,592200
197860,185508,930650,107670,91690.6,338450,90190,93817.4,592200
205060,161740.2,930650,110760,77757.3,338450,94300,83982.9,592200
212280,198039.6,930650,113870,102721.3,338450,98410,95318.3,592200
219410,224932.9,930650,116940,119715.6,338450,102470,105217.3,592200
226550,183454.9,930650,120020,88762.8,338450,106530,94692.1,592200
233720,197205.3,930650,123100,91649.5,338450,110620,105555.8,592200
240940,234175.3,930650,126190,113927.4,338450,114750,120247.9,592200
248120,271568.2,930650,129290,138007.1,338450,118830,133561.1,592200
255320,299214.4,930650,132360,151279.1,338450,122960,147935.3,592200
262410,324412.3,930650,135450,163172.9,338450,126960,161239.4,592200
266860,312307.5,930650,136790,155408,338450,130070,156899.5,592200
271260,335529,930650,138160,162951.3,338450,133100,172577.7,592200
275660,323513.2,930650,139530,154076.8,338450,136130,169436.4,592200
280060,298099.2,930650,140870,138119.3,338450,139190,159979.9,592200
284410,283976.5,930650,142220,129414.1,338450,142190,154562.4,592200
288810,308799.7,930650,143580,146193.8,338450,145230,162605.9,592200
293260,296148.7,930650,144940,136555,338450,148320,159593.7,592200
297660,290342.8,930650,146290,128731.2,338450,151370,161611.6,592200
302050,288666.8,930650,147610,126755.5,338450,154440,161911.3,592200
306480,319075.2,930650,148980,147989.5,338450,157500,171085.7,592200
310850,311391.3,930650,150340,146606,338450,160510,164785.3,592200
315240,300261.7,930650,151690,137497,338450,163550,162764.7,592200
319220,302160,930650,153030,143808.9,338450,166190,158351.1,592200
323070,287404.2,930650,154360,133800.6,338450,168710,153603.6,592200
326900,279230.2,930650,155690,129296,338450,171210,149934.2,592200
401100,286291.6,930650,179490,127844.5,338450,221610,158447.1,592200
397250,297456.9,930650,176450,135527.2,338450,220800,161929.7,592200
393390,305255.8,930650,173390,140140.7,338450,220000,165115.1,592200
389520,291119.8,930650,170340,129594.4,338450,219180,161525.4,592200
385590,257781.2,930650,167290,111032.3,338450,218300,146748.9,592200
381290,255801.5,930650,164420,108656.7,338450,216870,147144.8,592200
376980,268889.9,930650,161580,116857.9,338450,215400,152032,592200
372670,282940.7,930650,158740,118053.8,338450,213930,164886.9,592200
368350,254236.5,930650,155860,106459.7,338450,212490,147776.8,592200
361080,262763,930650,154050,111379.5,338450,207030,151383.5,592200
353740,262281.6,930650,152220,106680,338450,201520,155601.6,592200
346440,247642.3,930650,150370,101952.1,338450,196070,145690.2,592200
339160,235515.7,930650,148550,95721.1,338450,190610,139794.6,592200
333360,231678.3,930650,147400,95236.3,338450,185960,136442,592200
327640,221392.4,930650,146260,83453.8,338450,181380,137938.6,592200
321870,203295.4,930650,145140,75380.1,338450,176730,127915.3,592200
316080,200292.6,930650,143970,76263.9,338450,172110,124028.7,592200
310190,299339.5,930650,143310,136255.1,338450,166880,163084.4,592200
304340,296324.1,930650,142660,128119.9,338450,161680,168204.2,592200
298470,310789.1,930650,141990,140357.3,338450,156480,170431.8,592200
292540,366689.9,930650,141320,173248.8,338450,151220,193441.1,592200
299710,410858.8,930650,145610,208302.1,338450,154100,202556.7,592200
306890,424375.5,930650,149910,216538.1,338450,156980,207837.4,592200
314030,415596.7,930650,154230,211421,338450,159800,204175.7,592200
321230,422063.1,930650,158540,222785.8,338450,162690,199277.3,592200
328620,408008.4,930650,162800,216110.5,338450,165820,191897.9,592200
335930,399914.2,930650,167080,204737.6,338450,168850,195176.6,592200
343350,414611.7,930650,171360,212166.7,338450,171990,202445,592200
350720,406441.4,930650,175630,218218.4,338450,175090,188223,592200
359450,425821.9,930650,180930,223199.6,338450,178520,202622.3,592200
368170,425133.2,930650,186200,223289.9,338450,181970,201843.3,592200
376900,414301.1,930650,191500,202660.3,338450,185400,211640.8,592200
385600,416506.9,930650,196790,216964.7,338450,188810,199542.2,592200
394020,421043.8,930650,199300,222311.2,338450,194720,198732.6,592200
402430,420108.6,930650,201810,218117.5,338450,200620,201991.1,592200
410810,424472.9,930650,204310,222378.9,338450,206500,202094,592200
419240,440555.6,930650,206830,226413.9,338450,212410,214141.7,592200
428090,454673.7,930650,209640,233230.1,338450,218450,221443.6,592200
436910,457626,930650,212450,230574.2,338450,224460,227051.8,592200
445850,452063.7,930650,215290,227616.3,338450,230560,224447.4,592200
454700,466120.4,930650,218090,233980.1,338450,236610,232140.3,592200
462280,519507.8,930650,220530,265829.1,338450,241750,253678.7,592200
469810,530760.7,930650,222950,268560.4,338450,246860,262200.3,592200
477380,518351,930650,225390,252989.2,338450,251990,265361.8,592200
484960,529522,930650,227840,245956.7,338450,257120,283565.3,592200
494030,526882.8,930650,230000,258032.2,338450,264030,268850.6,592200
503010,533701.5,930650,232180,264395.3,338450,270830,269306.2,592200
512010,567392.9,930650,234360,277882.1,338450,277650,289510.8,592200
521100,571437,930650,236520,279136.4,338450,284580,292300.6,592200
528130,610980.6,930650,238180,291006.7,338450,289950,319973.9,592200
535250,635585.6,930650,239830,293273.1,338450,295420,342312.5,592200
542360,628828.2,930650,241500,292493.5,338450,300860,336334.7,592200
549470,635876.9,930650,243150,291741.9,338450,306320,344135,592200
556430,634656.8,930650,244990,289290.3,338450,311440,345366.5,592200
563370,657200.9,930650,246840,294608.7,338450,316530,362592.2,592200
570330,668722.3,930650,248680,293835.5,338450,321650,374886.8,592200
577310,662190.4,930650,250530,297134.5,338450,326780,365055.9,592200
575000,682869.5,930650,249310,304186.1,338450,325690,378683.4,592200
572630,671277.8,930650,248100,297937,338450,324530,373340.8,592200
570330,652755.5,930650,246920,280848.4,338450,323410,371907.1,592200
568020,634710.8,930650,245710,267807.5,338450,322310,366903.3,592200
565510,648196.5,930650,244510,271657.4,338450,321000,376539.1,592200
562970,658307.3,930650,243300,284994.7,338450,319670,373312.6,592200
560460,699731.9,930650,242080,302655.7,338450,318380,397076.2,592200
557930,679454,930650,240860,301971.6,338450,317070,377482.4,592200
554400,676161.5,930650,240020,295958.3,338450,314380,380203.2,592200
550980,662064.5,930650,239230,295092.8,338450,311750,366971.7,592200
547370,668608.2,930650,238380,290179.7,338450,308990,378428.5,592200
543910,676012,930650,237580,287625.9,338450,306330,388386.1,592200
534020,640791.9,930650,234060,273660.7,338450,299960,367131.2,592200
524070,580420.1,930650,230560,246230,338450,293510,334190.1,592200
514130,590251.4,930650,227000,270570.5,338450,287130,319680.9,592200
504160,550135.4,930650,223480,260701.9,338450,280680,289433.5,592200
495150,496439.4,930650,220230,223229.1,338450,274920,273210.3,592200
486060,499708.3,930650,216970,226622,338450,269090,273086.3,592200
477020,433574.3,930650,213710,199836.1,338450,263310,233738.2,592200
467970,423759.4,930650,210450,184710.3,338450,257520,239049.1,592200
460090,410047.4,930650,207670,179638.3,338450,252420,230409.1,592200
452210,386703.7,930650,204860,168152.5,338450,247350,218551.2,592200
444300,359654.1,930650,202060,161392,338450,242240,198262.1,592200
436480,391374.4,930650,199280,174313.6,338450,237200,217060.8,592200
437610,414618.8,930650,199800,179080.5,338450,237810,235538.3,592200
438700,427446,930650,200310,178025.4,338450,238390,249420.6,592200
439800,397689.5,930650,200830,157679,338450,238970,240010.5,592200
440900,478686.7,930650,201330,209204.6,338450,239570,269482.1,592200
440930,504483.4,930650,200710,226660.5,338450,240220,277822.9,592200
440960,525224.4,930650,200080,241331.2,338450,240880,283893.2,592200
440970,527737.6,930650,199460,234971.3,338450,241510,292766.3,592200
441040,533753.8,930650,198880,241776.1,338450,242160,291977.7,592200
441020,531705.1,930650,198860,241863.7,338450,242160,289841.4,592200
441040,496652,930650,198900,218205.5,338450,242140,278446.5,592200
441040,500847.7,930650,198890,217337.2,338450,242150,283510.5,592200
441090,466456.7,930650,198900,202016.2,338450,242190,264440.5,592200
432830,473279,930650,194080,208555.3,338450,238750,264723.7,592200
424550,473907.8,930650,189260,215582.7,338450,235290,258325.1,592200
416340,436382.9,930650,184450,191488.9,338450,231890,244894,592200
405190,410375.3,930650,171780,167356,338450,233410,243019.3,592200
395790,378781.4,930650,167020,147541.6,338450,228770,231239.8,592200
386350,381528.8,930650,162230,149359.8,338450,224120,232169,592200
376950,376814.6,930650,157490,144476,338450,219460,232338.6,592200
367520,375522.5,930650,152710,146540.7,338450,214810,228981.8,592200
359880,385722,930650,149160,148880.1,338450,210720,236841.9,592200
352200,401028,930650,145600,162006.4,338450,206600,239021.6,592200
344590,419169.7,930650,142070,172762.1,338450,202520,246407.6,592200
336920,390181.4,930650,138510,153827.6,338450,198410,236353.8,592200
337380,444864.3,930650,140480,197674.3,338450,196900,247190,592200
337830,457015,930650,142430,196907.8,338450,195400,260107.2,592200
338290,516425.9,930650,144390,234215.6,338450,193900,282210.3,592200
338690,567683.7,930650,146340,270500.5,338450,192350,297183.2,592200
338150,500746.7,930650,147440,234846,338450,190710,265900.7,592200
337640,411474.8,930650,148510,178091.4,338450,189130,233383.4,592200
337080,402168.4,930650,149580,169840.7,338450,187500,232327.7,592200
336540,380024.1,930650,150680,150552.4,338450,185860,229471.7,592200
337420,423976,930650,153310,176747.9,338450,184110,247228.1,592200
338300,450857,930650,155940,194127.6,338450,182360,256729.4,592200
339150,437666.2,930650,158580,189347.9,338450,180570,248318.3,592200
340080,479185.9,930650,161220,195966.9,338450,178860,283219,592200
345950,484896.9,930650,163660,195125.2,338450,182290,289771.7,592200
351910,461301,930650,166120,187026,338450,185790,274275,592200
357860,488298.1,930650,168600,214582.9,338450,189260,273715.2,592200
363800,522114.8,930650,171060,231623.5,338450,192740,290491.3,592200
369740,523205,930650,173480,226227.4,338450,196260,296977.6,592200
375740,478136.5,930650,175900,194105.7,338450,199840,284030.8,592200
381720,493021.4,930650,178320,205021.6,338450,203400,287999.8,592200
387660,501111.3,930650,180720,218717.1,338450,206940,282394.2,592200
392130,487092.1,930650,182210,218746.4,338450,209920,268345.7,592200
396530,430090.4,930650,183680,186356.2,338450,212850,243734.2,592200
401020,409001.9,930650,185180,179089.6,338450,215840,229912.3,592200
405470,411085.8,930650,186670,182773.7,338450,218800,228312.1,592200
408150,383735.4,930650,187610,161905.3,338450,220540,221830.1,592200
410940,393129.2,930650,188570,163127.3,338450,222370,230001.9,592200
413730,397208.3,930650,189520,166860,338450,224210,230348.3,592200
416540,404841.9,930650,190490,175904.5,338450,226050,228937.4,592200
418790,448751.6,930650,190830,207305,338450,227960,241446.6,592200
421050,457187,930650,191170,202140.2,338450,229880,255046.8,592200
423320,518524.2,930650,191500,229637.8,338450,231820,288886.4,592200
425610,522778.3,930650,191840,222405.9,338450,233770,300372.4,592200
428390,485561.1,930650,192420,206860.6,338450,235970,278700.5,592200
431280,450794.6,930650,193010,187917.1,338450,238270,262877.5,592200
434080,493723.4,930650,193600,205029.3,338450,240480,288694.1,592200
436890,486157.3,930650,194200,206992.7,338450,242690,279164.6,592200
442250,468736.2,930650,193210,197091.8,338450,249040,271644.4,592200
447600,390769.2,930650,192220,152743.9,338450,255380,238025.3,592200
452900,396966.8,930650,191250,169767.9,338450,261650,227198.9,592200
458260,411304.1,930650,190270,173966,338450,267990,237338.1,592200
465000,453287.3,930650,190140,196760,338450,274860,256527.3,592200
471740,451317.7,930650,190030,189510.4,338450,281710,261807.3,592200
478580,444785.8,930650,189950,176540.5,338450,288630,268245.3,592200
485320,471444.5,930650,189840,189718,338450,295480,281726.5,592200
491670,498222.1,930650,189130,205599.7,338450,302540,292622.4,592200
497990,514410,930650,188400,214323.1,338450,309590,300086.9,592200
504350,506235.1,930650,187680,216392.5,338450,316670,289842.6,592200
510690,457707.6,930650,186960,179013.4,338450,323730,278694.2,592200
499030,387242.1,930650,182530,118355.6,338450,316500,268886.5,592200
487350,381411.5,930650,178090,113042.2,338450,309260,268369.3,592200
475660,409054.3,930650,173680,129562.4,338450,301980,279491.9,592200
463950,395093.5,930650,169230,125607.1,338450,294720,269486.4,592200
451200,427075,930650,164190,135700.8,338450,287010,291374.2,592200
438500,397834.2,930650,159150,125122,338450,279350,272712.2,592200
425770,387259.4,930650,154090,109345.3,338450,271680,277914.1,592200
413060,391371.7,930650,149070,114114.3,338450,263990,277257.4,592200
400210,364020.3,930650,143470,95781,338450,256740,268239.3,592200
387360,309681.7,930650,137910,72298.5,338450,249450,237383.2,592200
374490,255925.3,930650,132350,49769.3,338450,242140,206156,592200
361700,229887.4,930650,126790,53852.6,338450,234910,176034.8,592200
357370,256633,930650,126710,71023.2,338450,230660,185609.8,592200
353080,245902,930650,126620,60871.1,338450,226460,185030.9,592200
348780,264540.3,930650,126490,64749.8,338450,222290,199790.5,592200
344460,284172.2,930650,126410,75415.5,338450,218050,208756.7,592200
339600,281226,930650,125560,80001.9,338450,214040,201224.1,592200
334720,303499.2,930650,124680,99075.5,338450,210040,204423.7,592200
329870,319441.7,930650,123850,109028.6,338450,206020,210413.1,592200
324940,297042.9,930650,123010,100354.9,338450,201930,196688,592200
320500,324181.5,930650,121700,115345.3,338450,198800,208836.2,592200
316010,343649.3,930650,120370,121794.8,338450,195640,221854.5,592200
311610,356341.8,930650,119090,132474.6,338450,192520,223867.2,592200
307080,362771.5,930650,117770,138689.2,338450,189310,224082.3,592200
314790,389407.4,930650,121850,153135.4,338450,192940,236272,592200
322630,414618.4,930650,125980,170540.3,338450,196650,244078.1,592200
330370,394411.5,930650,130070,148130.4,338450,200300,246281.1,592200
338140,397124.5,930650,134180,147847.5,338450,203960,249277,592200
348220,440830.8,930650,140260,176924.8,338450,207960,263906,592200
358270,414506,930650,146300,162408.6,338450,211970,252097.4,592200
368420,410890.7,930650,152380,159383.6,338450,216040,251507.1,592200
378500,402897.4,930650,158470,157512.6,338450,220030,245384.8,592200
386000,401275.9,930650,162200,148529.7,338450,223800,252746.2,592200
393450,387541.7,930650,165920,134328.8,338450,227530,253212.9,592200
400900,360565.3,930650,169660,113798.7,338450,231240,246766.6,592200
408340,365828,930650,173390,123136.6,338450,234950,242691.4,592200
405110,355398.7,930650,172190,113190,338450,232920,242208.7,592200
401950,465116.4,930650,170970,182925,338450,230980,282191.4,592200
398770,474932.6,930650,169760,188481.9,338450,229010,286450.7,592200
446840,458329.6,930650,168570,175682.8,338450,278270,282646.8,592200
444110,471966.5,930650,169250,184135.4,338450,274860,287831.1,592200
441450,470018.8,930650,169980,183067.4,338450,271470,286951.4,592200
438730,454171.4,930650,170700,176729.6,338450,268030,277441.8,592200
436090,452150.6,930650,171400,176601.8,338450,264690,275548.8,592200
433690,422028.5,930650,172720,164501.5,338450,260970,257527,592200
431390,391831.2,930650,174030,152189.9,338450,257360,239641.3,592200
429000,346556.4,930650,175330,128274.1,338450,253670,218282.3,592200
426590,354198.6,930650,176660,137376.7,338450,249930,216821.9,592200
420170,391229.9,930650,174000,156039.2,338450,246170,235190.7,592200
413850,352282.8,930650,171340,131140.9,338450,242510,221141.9,592200
407440,375001.7,930650,168670,148523,338450,238770,226478.7,592200
401090,360356,930650,166020,138933.7,338450,235070,221422.3,592200
394420,416092.1,930650,163790,170579.4,338450,230630,245512.7,592200
387850,379573,930650,161560,161405.6,338450,226290,218167.4,592200
381280,372757.8,930650,159310,155039.7,338450,221970,217718.1,592200
374750,367001.7,930650,157100,161516.4,338450,217650,205485.3,592200
368090,316646.8,930650,154980,137178.8,338450,213110,179468,592200
361550,305497.4,930650,152880,133606,338450,208670,171891.4,592200
354990,334159.5,930650,150770,144634.3,338450,204220,189525.2,592200
348320,275637.4,930650,148650,122420.8,338450,199670,153216.6,592200
338480,252366.4,930650,144740,116350.6,338450,193740,136015.8,592200
328610,285729.6,930650,140830,137659.1,338450,187780,148070.5,592200
318690,271707.6,930650,136930,128984.1,338450,181760,142723.5,592200
308780,289856,930650,132990,134495.5,338450,175790,155360.5,592200
298710,297433.1,930650,129310,139363.6,338450,169400,158069.5,592200
288570,268526.7,930650,125590,116106.1,338450,162980,152420.6,592200
278420,255959.7,930650,121860,112054.7,338450,156560,143905,592200
268350,280340.3,930650,118150,132217.7,338450,150200,148122.6,592200
257870,292863.9,930650,114440,134571.8,338450,143430,158292.1,592200
247380,266197.4,930650,110730,115419.8,338450,136650,150777.6,592200
236880,248199.3,930650,107010,105338.8,338450,129870,142860.5,592200
226400,233049.8,930650,103310,97770.3,338450,123090,135279.5,592200
215530,246634.3,930650,98810,100370.9,338450,116720,146263.4,592200
204600,236784.7,930650,94290,100287.6,338450,110310,136497.1,592200
193640,224272.5,930650,89770,93892.5,338450,103870,130380,592200
182660,194273.3,930650,85250,82288.4,338450,97410,111984.9,592200
172180,195027,930650,80790,80136.3,338450,91390,114890.7,592200
161820,193857.7,930650,76370,76518.7,338450,85450,117339,592200
151290,172914.9,930650,71910,70119.4,338450,79380,102795.5,592200
140810,163081.2,930650,67460,63278.2,338450,73350,99803,592200
129210,139132.4,930650,63170,53292.5,338450,66040,85839.9,592200
117450,137443,930650,58850,52874.9,338450,58600,84568.1,592200
105790,132272.1,930650,54550,52219.2,338450,51240,80052.9,592200
94070,130360.1,930650,50240,51614.2,338450,43830,78745.9,592200
89440,128898.6,930650,48510,51849.8,338450,40930,77048.8,592200
84800,116298.7,930650,46750,46412.3,338450,38050,69886.4,592200
80160,109744.5,930650,44980,43269.8,338450,35180,66474.7,592200
75520,101783.4,930650,43240,39040.4,338450,32280,62743,592200
72320,99715.3,930650,41720,37188,338450,30600,62527.3,592200
69150,97688,930650,40190,35851.1,338450,28960,61836.9,592200
65940,101649.3,930650,38660,38211.5,338450,27280,63437.8,592200
62710,106266.1,930650,37150,40227.4,338450,25560,66038.7,592200
59270,100278.4,930650,35610,38122.3,338450,23660,62156.1,592200
55770,92039.8,930650,34080,34587.1,338450,21690,57452.7,592200
52310,95196.4,930650,32530,37672.1,338450,19780,57524.3,592200
48950,106948.7,930650,31010,46162.2,338450,17940,60786.5,592200
50820,117649.9,930650,33040,55983.3,338450,17780,61666.6,592200
52750,123419.5,930650,35060,61642.6,338450,17690,61776.9,592200
54720,130816.7,930650,37100,66957.3,338450,17620,63859.4,592200
56610,147567.7,930650,39130,77543.7,338450,17480,70024,592200
58510,146524.8,930650,40940,77292.1,338450,17570,69232.7,592200
60420,140180.4,930650,42760,74967.2,338450,17660,65213.2,592200
62250,163584.4,930650,44570,89955,338450,17680,73629.4,592200
64220,163823.1,930650,46390,90574.5,338450,17830,73248.6,592200
66700,169696.6,930650,48560,95436.6,338450,18140,74260,592200
69180,172883,930650,50740,98029.9,338450,18440,74853.1,592200
71740,163862,930650,52920,94215,338450,18820,69647,592200
74150,166206.6,930650,55080,95752.3,338450,19070,70454.3,592200
77800,158806.9,930650,57750,91093.4,338450,20050,67713.5,592200
81470,171980.1,930650,60380,99841.9,338450,21090,72138.2,592200
85110,159672.5,930650,63010,90343.6,338450,22100,69328.9,592200
88780,167647.8,930650,65690,97100,338450,23090,70547.8,592200
92590,182696.6,930650,68620,107732.1,338450,23970,74964.5,592200
96400,201365.7,930650,71540,118809.8,338450,24860,82555.9,592200
100160,236330,930650,74470,142395.9,338450,25690,93934.1,592200
103910,236244.7,930650,77390,141857.1,338450,26520,94387.6,592200
106620,254861.7,930650,79140,153417.7,338450,27480,101444,592200
109380,266914.1,930650,80900,161925.7,338450,28480,104988.4,592200
112070,304566.4,930650,82650,185237.4,338450,29420,119329,592200
114820,311997.8,930650,84400,189520.1,338450,30420,122477.7,592200
113050,320018.4,930650,81920,191113.2,338450,31130,128905.2,592200
111230,318534.4,930650,79450,185119.9,338450,31780,133414.5,592200
109530,304323,930650,76970,176593.6,338450,32560,127729.4,592200
107710,262867.8,930650,74510,144660.7,338450,33200,118207.1,592200
107620,321815.1,930650,73690,188263,338450,33930,133552.1,592200
107710,307426,930650,72930,176423.8,338450,34780,131002.2,592200
107620,290192.6,930650,72130,168898.3,338450,35490,121294.3,592200
107620,291583,930650,71330,160216.6,338450,36290,131366.4,592200
106960,263131.7,930650,69450,139089.1,338450,37510,124042.6,592200
106380,306262.8,930650,67570,163401.4,338450,38810,142861.4,592200
105700,320778.9,930650,65670,175989.2,338450,40030,144789.7,592200
105030,324885.8,930650,63770,190027.4,338450,41260,134858.4,592200
110960,346056.7,930650,67770,187123.7,338450,43190,158933,592200
116940,325567.8,930650,71770,173120.5,338450,45170,152447.3,592200
122910,290630.3,930650,75760,144562.9,338450,47150,146067.4,592200
318940,336223.3,930650,182310,179447.9,338450,136630,156775.4,592200
330820,319282.7,930650,185740,171284.2,338450,145080,147998.5,592200
342670,357571.2,930650,189160,202928.8,338450,153510,154642.4,592200
354560,356041.5,930650,192570,219391.7,338450,161990,136649.8,592200
366360,363862.7,930650,196010,215589.1,338450,170350,148273.6,592200
378470,388069.2,930650,199400,227856.3,338450,179070,160212.9,592200
390630,409070.6,930650,202790,238260.6,338450,187840,170810,592200
402700,433325.7,930650,206200,250711.9,338450,196500,182613.8,592200
414870,455250.7,930650,209610,258287.3,338450,205260,196963.4,592200
419840,458380.6,930650,206750,250168.4,338450,213090,208212.2,592200
424770,459368.3,930650,203870,249581.2,338450,220900,209787.1,592200
429700,474624.9,930650,201010,257395.4,338450,228690,217229.5,592200
434730,489811.1,930650,198150,263428.1,338450,236580,226383,592200
438630,475956.4,930650,195250,257683.5,338450,243380,218272.9,592200
442640,473444.6,930650,192390,256801,338450,250250,216643.6,592200
446590,458859.3,930650,189520,248042.5,338450,257070,210816.8,592200
450550,448072.1,930650,186640,241566.7,338450,263910,206505.4,592200
454020,433517.3,930650,183630,227871.6,338450,270390,205645.7,592200
457460,424823.1,930650,180650,218791.7,338450,276810,206031.4,592200
460880,384293,930650,177610,190102.6,338450,283270,194190.4,592200
464290,379661,930650,174610,181421,338450,289680,198240,592200
448760,398594.9,930650,166920,183274.6,338450,281840,215320.3,592200
433390,369986.8,930650,159270,160655.5,338450,274120,209331.3,592200
417910,373485.9,930650,151590,153498.4,338450,266320,219987.5,592200
402370,371014.7,930650,143880,158637.9,338450,258490,212376.8,592200
386550,358877.5,930650,136450,156182.1,338450,250100,202695.4,592200
370680,335313.1,930650,129050,136057.6,338450,241630,199255.5,592200
354870,345970.1,930650,121640,121754.7,338450,233230,224215.4,592200
338960,312256.1,930650,114200,105401.2,338450,224760,206854.9,592200
325320,248556.2,930650,108080,78784.7,338450,217240,169771.5,592200
311620,240042.8,930650,101910,73157,338450,209710,166885.8,592200
297910,223250.4,930650,95760,64236.8,338450,202150,159013.6,592200
284170,206639.4,930650,89590,60014.2,338450,194580,146625.2,592200
269110,193708.6,930650,84590,56581.6,338450,184520,137127,592200
254050,200625.4,930650,79580,59360.7,338450,174470,141264.7,592200
238990,201967.4,930650,74540,53652.5,338450,164450,148314.9,592200
223930,204526.2,930650,69560,53202.1,338450,154370,151324.1,592200
209330,188305.7,930650,64690,48427.1,338450,144640,139878.6,592200
194820,163008.4,930650,59850,42358.3,338450,134970,120650.1,592200
180260,160249.1,930650,55010,46903,338450,125250,113346.1,592200
165670,166824.3,930650,50140,46749.6,338450,115530,120074.7,592200
151650,168529.7,930650,46070,44146.3,338450,105580,124383.4,592200
137570,145096.1,930650,41990,38312.5,338450,95580,106783.6,592200
123460,132208.4,930650,37900,33865,338450,85560,98343.4,592200
109430,143749.2,930650,33840,34885.6,338450,75590,108863.6,592200
122180,165073.5,930650,41410,41660.2,338450,80770,123413.3,592200
134970,154603.6,930650,49000,35860.5,338450,85970,118743.1,592200
147730,135997.2,930650,56600,34915.3,338450,91130,101081.9,592200
160510,149439.6,930650,64200,55301.8,338450,96310,94137.8,592200
174490,204426.7,930650,72220,85642.2,338450,102270,118784.5,592200
188450,216591.5,930650,80200,85936.3,338450,108250,130655.2,592200
202480,246515.5,930650,88230,106693.9,338450,114250,139821.6,592200
216450,279647.6,930650,96220,126824.7,338450,120230,152822.9,592200
229750,286022.7,930650,103360,140663.1,338450,126390,145359.6,592200
242970,308548.5,930650,110490,147771.4,338450,132480,160777.1,592200
256300,327177.6,930650,117630,153713.3,338450,138670,173464.3,592200
269590,368023,930650,124770,185793.8,338450,144820,182229.2,592200
282430,391906.2,930650,129620,193366.7,338450,152810,198539.5,592200
295210,397917.3,930650,134420,204309.2,338450,160790,193608.1,592200
308050,414671.1,930650,139280,207344.8,338450,168770,207326.3,592200
320880,418917,930650,144110,209059,338450,176770,209858,592200
335000,408925.8,930650,150660,211849.7,338450,184340,197076.1,592200
349120,424020.5,930650,157210,217824.6,338450,191910,206195.9,592200
363260,452806.4,930650,163780,235741.9,338450,199480,217064.5,592200
377420,456087.8,930650,170330,234521.8,338450,207090,221566,592200
389430,467230.9,930650,175230,233093.6,338450,214200,234137.3,592200
401500,478575.2,930650,180130,237104,338450,221370,241471.2,592200
413550,483605.7,930650,185030,231080.9,338450,228520,252524.8,592200
425580,485495.2,930650,189940,232422.6,338450,235640,253072.6,592200
430440,484677.7,930650,190950,236580.5,338450,239490,248097.2,592200
435320,516305.1,930650,191970,255229,338450,243350,261076.1,592200
440130,497289.6,930650,192990,247990.2,338450,247140,249299.4,592200
444990,473170.2,930650,194000,230080.2,338450,250990,243090,592200
452420,489697.3,930650,196900,240317.9,338450,255520,249379.4,592200
459850,498062.3,930650,199820,248245.2,338450,260030,249817.1,592200
467330,498933.8,930650,202750,243759.6,338450,264580,255174.2,592200
474700,522423.9,930650,205650,250814.4,338450,269050,271609.5,592200
480120,548140.6,930650,206860,261806.3,338450,273260,286334.3,592200
485510,567044.4,930650,208090,269577.6,338450,277420,297466.8,592200
490840,571570.4,930650,209300,265734.2,338450,281540,305836.2,592200
496200,575343.6,930650,210520,270286.9,338450,285680,305056.7,592200
500170,559324.1,930650,212030,253999.1,338450,288140,305325,592200
504080,517706.2,930650,213540,224741.6,338450,290540,292964.6,592200
508010,523496,930650,215030,229735.3,338450,292980,293760.7,592200
511950,544375.2,930650,216550,242739.7,338450,295400,301635.5,592200
516250,547092,930650,218960,245240.3,338450,297290,301851.7,592200
520500,544755,930650,221350,242099.9,338450,299150,302655.1,592200
524710,542257.9,930650,223740,236946.8,338450,300970,305311.1,592200
528990,566478.5,930650,226130,256091.8,338450,302860,310386.7,592200
532330,577768.8,930650,227570,266739.9,338450,304760,311028.9,592200
535530,599469.8,930650,229020,273128,338450,306510,326341.8,592200
538870,624277.4,930650,230440,287906,338450,308430,336371.4,592200
542240,621766.4,930650,231920,287938.2,338450,310320,333828.2,592200
548440,622161,930650,234790,291641.3,338450,313650,330519.7,592200
554600,618382.5,930650,237700,288298.6,338450,316900,330083.9,592200
560730,616075.4,930650,240600,288179.7,338450,320130,327895.7,592200
597010,618338,930650,258710,288210.8,338450,338300,330127.2,592200
600670,601298.9,930650,259750,277423.9,338450,340920,323875,592200
604330,605768.6,930650,260780,282254.3,338450,343550,323514.3,592200
608070,594014.9,930650,261830,267313.4,338450,346240,326701.5,592200
611720,599022.3,930650,262850,269521.7,338450,348870,329500.6,592200
616010,612419,930650,264160,277876.5,338450,351850,334542.5,592200
620320,627653.8,930650,265470,283153.7,338450,354850,344500.1,592200
624620,633324.9,930650,266790,286121.7,338450,357830,347203.2,592200
628950,634110.9,930650,268090,285262.3,338450,360860,348848.6,592200
635350,647360.3,930650,270470,288273.5,338450,364880,359086.8,592200
641770,646262.7,930650,272840,293743.8,338450,368930,352518.9,592200
648200,648996.8,930650,275220,299249.6,338450,372980,349747.2,592200
654720,641937,930650,277590,297332,338450,377130,344605,592200
660980,645588.2,930650,279570,296430.2,338450,381410,349158,592200
667290,670247.6,930650,281560,294533.9,338450,385730,375713.7,592200
673500,685117,930650,283520,295161.8,338450,389980,389955.2,592200
679840,690734.4,930650,285510,294762.9,338450,394330,395971.5,592200
686170,686795.9,930650,287320,297511.4,338450,398850,389284.5,592200
692600,680726.2,930650,289170,296779.4,338450,403430,383946.8,592200
698910,696485.2,930650,290980,298904,338450,407930,397581.2,592200
705270,694986.1,930650,292820,297718.7,338450,412450,397267.4,592200
709190,697889.5,930650,293560,298887.3,338450,415630,399002.2,592200
713130,710446.2,930650,294310,299673.8,338450,418820,410772.4,592200
716980,709866,930650,295010,293683.8,338450,421970,416182.2,592200
720950,728585.3,930650,295770,297647.3,338450,425180,430938,592200
725130,734426.9,930650,296620,300957.2,338450,428510,433469.7,592200
729300,731346.7,930650,297450,307864.4,338450,431850,423482.3,592200
733460,739227.2,930650,298300,310248.3,338450,435160,428978.9,592200
737630,742060.8,930650,299140,309094.2,338450,438490,432966.6,592200
740970,758408.2,930650,299740,312183.1,338450,441230,446225.1,592200
744380,774641.1,930650,300360,316201,338450,444020,458440.1,592200
747780,770966.4,930650,300960,314114.7,338450,446820,456851.7,592200
751130,747298.9,930650,301580,309255.6,338450,449550,438043.3,592200
739170,737769.2,930650,297630,303922.6,338450,441540,433846.6,592200
727250,723742.9,930650,293700,297079.4,338450,433550,426663.5,592200
715330,732381.9,930650,289780,278599.1,338450,425550,453782.8,592200
703390,693268.7,930650,285830,267494.4,338450,417560,425774.3,592200
689550,671355.5,930650,281180,260942.6,338450,408370,410412.9,592200
675650,701173.7,930650,276530,291204.2,338450,399120,409969.5,592200
661830,670621.5,930650,271910,279726.2,338450,389920,390895.3,592200
647930,667576.7,930650,267260,276445.7,338450,380670,391131,592200
633230,653139.1,930650,262360,278922,338450,370870,374217.1,592200
618540,647159.8,930650,257460,278613.7,338450,361080,368546.1,592200
603760,632929.1,930650,252560,278955.2,338450,351200,353973.9,592200
589000,598882.2,930650,247650,262285.4,338450,341350,336596.8,592200
575690,612380.5,930650,244120,272314.4,338450,331570,340066.1,592200
562240,615732.9,930650,240590,277882.9,338450,321650,337850,592200
548810,597388.2,930650,237040,267646.6,338450,311770,329741.6,592200
535540,580789.1,930650,233520,265508.1,338450,302020,315281,592200
521680,573899.4,930650,229960,259436.9,338450,291720,314462.5,592200
507950,565598,930650,226410,255187,338450,281540,310411,592200
494130,548402.7,930650,222870,249554.6,338450,271260,298848.1,592200
480360,534448.4,930650,219310,249604.6,338450,261050,284843.8,592200
466040,531537.7,930650,215810,253974.5,338450,250230,277563.2,592200
451730,524935.5,930650,212300,255100.3,338450,239430,269835.2,592200
437430,515879.3,930650,208790,248605,338450,228640,267274.3,592200
423060,509660.5,930650,205280,250029.7,338450,217780,259630.8,592200
413420,511678.6,930650,202890,254348.5,338450,210530,257330.1,592200
403720,532204.8,930650,200480,263531.1,338450,203240,268673.7,592200
394000,554683.3,930650,198060,269041.1,338450,195940,285642.2,592200
384340,569475.8,930650,195680,267674.1,338450,188660,301801.7,592200
374330,566751.4,930650,193320,269896,338450,181010,296855.4,592200
364260,545187.7,930650,190940,264948.1,338450,173320,280239.6,592200
354240,525442.1,930650,188590,251556.8,338450,165650,273885.3,592200
344110,508366.5,930650,186210,238406.9,338450,157900,269959.6,592200
334770,533007.8,930650,183620,253891.1,338450,151150,279116.7,592200
325310,540475.8,930650,181010,260214.7,338450,144300,280261.1,592200
315940,517481.3,930650,178420,260833.4,338450,137520,256647.9,592200
306590,510756.4,930650,175830,253710.2,338450,130760,257046.2,592200
306950,516520.7,930650,175850,254559.2,338450,131100,261961.5,592200
307370,508118.2,930650,175890,258261.2,338450,131480,249857,592200
307710,486514.1,930650,175930,247653.9,338450,131780,238860.2,592200
308100,484479.4,930650,175950,246567,338450,132150,237912.4,592200
308440,483819.1,930650,175640,252020.9,338450,132800,231798.2,592200
308880,485827.6,930650,175330,249729.2,338450,133550,236098.4,592200
309270,486418.2,930650,175000,244184.8,338450,134270,242233.4,592200
309630,486050.7,930650,174660,245985.3,338450,134970,240065.4,592200
310460,505621.3,930650,174390,257270.4,338450,136070,248350.9,592200
311370,504957.5,930650,174130,254025.8,338450,137240,250931.7,592200
312230,485551.3,930650,173850,249660.1,338450,138380,235891.2,592200
313080,481902.2,930650,173550,246623.3,338450,139530,235278.9,592200
309230,483765.4,930650,169830,245351.3,338450,139400,238414.1,592200
305320,473873,930650,166090,243797.6,338450,139230,230075.4,592200
301390,474284.1,930650,162370,244561.6,338450,139020,229722.5,592200
297490,486242.8,930650,158630,248392,338450,138860,237850.8,592200
293270,504495.9,930650,154980,255891.5,338450,138290,248604.4,592200
289050,508256.8,930650,151330,257465.9,338450,137720,250790.9,592200
284870,507725.8,930650,147690,252823.5,338450,137180,254902.3,592200
280620,479916.2,930650,144020,228471.8,338450,136600,251444.4,592200
275130,430175.3,930650,140390,197149,338450,134740,233026.3,592200
269770,396201.6,930650,136800,174514.3,338450,132970,221687.3,592200
264300,355374.1,930650,133160,146516,338450,131140,208858.1,592200
258870,314926.4,930650,129520,125884.8,338450,129350,189041.6,592200
256220,335994.5,930650,126930,137390.7,338450,129290,198603.8,592200
253720,389983.7,930650,124330,177684.2,338450,129390,212299.5,592200
251080,425219.5,930650,121730,196646,338450,129350,228573.5,592200
233660,421928.5,930650,102400,193787.9,338450,131260,228140.6,592200
228540,433446.9,930650,97020,202494.9,338450,131520,230952,592200
223500,434977.4,930650,91680,205281.3,338450,131820,229696.1,592200
218380,398682.7,930650,86310,181629,338450,132070,217053.7,592200
213300,398319.3,930650,80950,181710.9,338450,132350,216608.4,592200
210010,401726.2,930650,77680,187112.5,338450,132330,214613.7,592200
206710,399116.6,930650,74400,191006.5,338450,132310,208110.1,592200
203370,409472.9,930650,71120,197092.3,338450,132250,212380.6,592200
200010,419027,930650,67820,192933.5,338450,132190,226093.5,592200
213290,386480.9,930650,74590,162785.5,338450,138700,223695.4,592200
226500,352961.8,930650,81330,144654.3,338450,145170,208307.5,592200
239750,324459.5,930650,88080,129223.6,338450,151670,195235.9,592200
253050,341449.5,930650,94860,140773.1,338450,158190,200676.4,592200
267000,354645.9,930650,102000,146964.6,338450,165000,207681.3,592200
281020,352715.7,930650,109110,150573.4,338450,171910,202142.3,592200
295040,375645.6,930650,116260,165220.4,338450,178780,210425.2,592200
309060,381622.8,930650,123390,170883.2,338450,185670,210739.6,592200
323250,386802.9,930650,130300,166301.3,338450,192950,220501.6,592200
337340,396245.4,930650,137210,164364.6,338450,200130,231880.8,592200
351560,397791.3,930650,144150,158505.3,338450,207410,239286,592200
365700,407551.5,930650,151050,159850.9,338450,214650,247700.6,592200
382920,443358.5,930650,159050,191254,338450,223870,252104.5,592200
400110,468358.9,930650,167060,206632,338450,233050,261726.9,592200
417300,501503.8,930650,175070,214252.6,338450,242230,287251.2,592200
434520,538321.3,930650,183110,234909.8,338450,251410,303411.5,592200
451030,585361.6,930650,190470,262956.1,338450,260560,322405.5,592200
467640,590905.8,930650,197860,261097.8,338450,269780,329808,592200
484230,612859.9,930650,205250,268981.2,338450,278980,343878.7,592200
500830,629905.7,930650,212620,278994.7,338450,288210,350911,592200
518070,643448.1,930650,220690,291625,338450,297380,351823.1,592200
535380,654922.5,930650,228750,295050.5,338450,306630,359872,592200
552640,655055.5,930650,236790,294488.8,338450,315850,360566.7,592200
569950,670089.2,930650,244860,300247.6,338450,325090,369841.6,592200
580430,676844.8,930650,248220,298112.5,338450,332210,378732.3,592200
591000,670399,930650,251560,298135.3,338450,339440,372263.7,592200
601490,670107.7,930650,254890,298630.3,338450,346600,371477.4,592200
612030,666982.8,930650,258250,295458.1,338450,353780,371524.7,592200
622200,688658.1,930650,261600,297548.5,338450,360600,391109.6,592200
632310,721266.7,930650,264930,301247,338450,367380,420019.7,592200
642370,727125.9,930650,268280,304508.2,338450,374090,422617.7,592200
652560,723963,930650,271650,303055.9,338450,380910,420907.1,592200
662650,729277.1,930650,274990,304771.5,338450,387660,424505.6,592200
672850,726588.1,930650,278330,299876,338450,394520,426712.1,592200
682930,709604.1,930650,281690,299066.4,338450,401240,410537.7,592200
693090,689871.5,930650,285030,293278.8,338450,408060,396592.7,592200
691570,673042.3,930650,284100,288050.2,338450,407470,384992.1,592200
690010,681860.7,930650,283200,288220.7,338450,406810,393640,592200
688440,698541.3,930650,282280,295825.3,338450,406160,402716,592200
686920,697151.2,930650,281340,293089.4,338450,405580,404061.8,592200
684320,706494.7,930650,279620,297836.9,338450,404700,408657.8,592200
681820,707684.5,930650,277890,295492.7,338450,403930,412191.8,592200
679300,734548.3,930650,276190,296491.9,338450,403110,438056.4,592200
676780,705558,930650,274460,284186,338450,402320,421372,592200
672300,682917.3,930650,272130,273791.8,338450,400170,409125.5,592200
667940,658654.1,930650,269780,261081.1,338450,398160,397573,592200
663580,673121.4,930650,267450,282973.1,338450,396130,390148.3,592200
659090,643806.5,930650,265100,271208.7,338450,393990,372597.8,592200
645260,603964.2,930650,260060,250526.6,338450,385200,353437.6,592200
631350,563706.3,930650,255000,237192.5,338450,376350,326513.8,592200
617520,553498.3,930650,249970,234927.7,338450,367550,318570.6,592200
603620,545792.3,930650,244930,232723.4,338450,358690,313068.9,592200
588260,530131.3,930650,238350,228674.1,338450,349910,301457.2,592200
572990,527629.5,930650,231790,218311.1,338450,341200,309318.4,592200
557660,532213.5,930650,225220,210141.5,338450,332440,322072,592200
542310,510339.4,930650,218670,194056,338450,323640,316283.4,592200
526690,486404.4,930650,211800,204425.7,338450,314890,281978.7,592200
511040,460809.2,930650,204930,195593.7,338450,306110,265215.5,592200
495480,436728.1,930650,198060,182700.6,338450,297420,254027.5,592200
479940,415767.9,930650,191210,165658.7,338450,288730,250109.2,592200
474190,432708.4,930650,189910,176108.2,338450,284280,256600.2,592200
468500,433738.5,930650,188620,171285.7,338450,279880,262452.8,592200
462800,429990.6,930650,187360,178300.7,338450,275440,251689.9,592200
457060,376266.4,930650,186080,147302.1,338450,270980,228964.3,592200
451370,365111.6,930650,184370,142386.2,338450,267000,222725.4,592200
445630,403773.4,930650,182670,163951.4,338450,262960,239822,592200
439940,449464.8,930650,180980,190083.9,338450,258960,259380.9,592200
434220,508840.4,930650,179270,216305.1,338450,254950,292535.3,592200
429280,473296,930650,177350,192209.6,338450,251930,281086.4,592200
424310,466480.3,930650,175400,184955.4,338450,248910,281524.9,592200
419270,469636.2,930650,173460,185711.4,338450,245810,283924.8,592200
414300,425938.5,930650,171530,159165,338450,242770,266773.5,592200
408980,412898.6,930650,171340,152639.6,338450,237640,260259,592200
403610,419916.3,930650,171140,151581,338450,232470,268335.3,592200
398280,442316.4,930650,170930,164169.4,338450,227350,278147,592200
392880,421728.3,930650,170730,154657.9,338450,222150,267070.4,592200
386550,473449.1,930650,170030,180589.2,338450,216520,292859.9,592200
380200,501697.7,930650,169350,199457.6,338450,210850,302240.1,592200
373910,491059.6,930650,168680,190716.1,338450,205230,300343.5,592200
367480,469235.3,930650,167970,177333.3,338450,199510,291902,592200
362880,406931.8,930650,167660,138267.8,338450,195220,268664,592200
358180,424755.8,930650,167330,158985.3,338450,190850,265770.5,592200
353540,429784.2,930650,167020,168082.2,338450,186520,261702,592200
348930,431313.7,930650,166730,172662.4,338450,182200,258651.3,592200
348000,441719.5,930650,163970,178351.1,338450,184030,263368.4,592200
347160,418992.5,930650,161230,161528.8,338450,185930,257463.7,592200
346260,383036,930650,158510,146608.7,338450,187750,236427.3,592200
313830,351512.5,930650,107630,133322.8,338450,206200,218189.7,592200
314490,347980.3,930650,104850,124432.5,338450,209640,223547.8,592200
315230,367675.8,930650,102080,132149.1,338450,213150,235526.7,592200
315870,382831.7,930650,99290,138078.9,338450,216580,244752.8,592200
316610,420103.9,930650,96520,159518.8,338450,220090,260585.1,592200
318830,446222.6,930650,94370,172763.4,338450,224460,273459.2,592200
321060,471309.6,930650,92230,184844.3,338450,228830,286465.3,592200
323360,474768.3,930650,90090,174360.6,338450,233270,300407.7,592200
325660,437513.3,930650,87940,136703,338450,237720,300810.3,592200
337070,444470.5,930650,92750,137294.5,338450,244320,307176,592200
348560,455468,930650,97550,142085.7,338450,251010,313382.3,592200
360010,485632.7,930650,102380,166215.2,338450,257630,319417.5,592200
371440,492600.9,930650,107180,170877.5,338450,264260,321723.4,592200
381750,505270.1,930650,111500,176631.7,338450,270250,328638.4,592200
391970,500554.4,930650,115810,169706.9,338450,276160,330847.5,592200
402240,544616.9,930650,120140,196033.6,338450,282100,348583.3,592200
412500,560090.2,930650,124440,206829.8,338450,288060,353260.4,592200
424380,566941.8,930650,129450,211180.8,338450,294930,355761,592200
436320,617096.7,930650,134420,244112.9,338450,301900,372983.8,592200
448250,610889.1,930650,139400,247202.2,338450,308850,363686.9,592200
460110,580218.3,930650,144370,234948.3,338450,315740,345270,592200
467000,594903.9,930650,146830,245285.4,338450,320170,349618.5,592200
474030,611597,930650,149310,253782.3,338450,324720,357814.7,592200
480910,610079.9,930650,151770,238448.3,338450,329140,371631.6,592200
487950,586580,930650,154240,223403.3,338450,333710,363176.7,592200
493140,569897.7,930650,154640,206657.4,338450,338500,363240.3,592200
498240,578481.3,930650,155000,213455.9,338450,343240,365025.4,592200
503420,608009.9,930650,155390,225328.5,338450,348030,382681.4,592200
508730,569495.6,930650,155790,199321.7,338450,352940,370173.9,592200
513330,571738.1,930650,155850,199322.5,338450,357480,372415.6,592200
518050,549564.8,930650,155890,186776.9,338450,362160,362787.9,592200
522680,562820.5,930650,155930,191782.1,338450,366750,371038.4,592200
527330,592609.7,930650,155980,206898.6,338450,371350,385711.1,592200
534440,568411.9,930650,162430,198246.4,338450,372010,370165.5,592200
541490,559688.7,930650,168840,202136.8,338450,372650,357551.9,592200
548630,547588,930650,175280,199002.3,338450,373350,348585.7,592200
555680,544148.5,930650,181700,209777.5,338450,373980,334371,592200
560910,539077.8,930650,187310,204411.9,338450,373600,334665.9,592200
566080,512337.7,930650,192880,188040,338450,373200,324297.7,592200
571340,509874.2,930650,198490,191206.4,338450,372850,318667.8,592200
576510,528039.3,930650,204100,208469.8,338450,372410,319569.5,592200
580940,486004.7,930650,208820,186242.9,338450,372120,299761.8,592200
585370,479302.9,930650,213520,180382,338450,371850,298920.9,592200
589750,461577.7,930650,218210,171945.1,338450,371540,289632.6,592200
594170,459283.5,930650,222920,176793.7,338450,371250,282489.8,592200
593100,439071.2,930650,223840,158042.1,338450,369260,281029.1,592200
592040,434342.2,930650,224760,153929.4,338450,367280,280412.8,592200
590950,453637.3,930650,225660,168899.5,338450,365290,284737.8,592200
589840,428623.4,930650,226570,155946,338450,363270,272677.4,592200
586520,388003.4,930650,225790,133596.1,338450,360730,254407.3,592200
583210,397895.1,930650,225000,134615.4,338450,358210,263279.7,592200
579950,380145.2,930650,224210,123424.7,338450,355740,256720.5,592200
576640,359935.1,930650,223430,113789.6,338450,353210,246145.5,592200
573490,331924.9,930650,222580,103516.3,338450,350910,228408.6,592200
570360,325553.7,930650,221710,98179.3,338450,348650,227374.4,592200
567220,369217,930650,220860,111037.2,338450,346360,258179.8,592200
564050,343838,930650,219970,103908.2,338450,344080,239929.8,592200
544520,327734.2,930650,210580,89941,338450,333940,237793.2,592200
525030,311239.3,930650,201140,85513.8,338450,323890,225725.5,592200
505490,307927.8,930650,191730,86876.2,338450,313760,221051.6,592200
485990,329289.1,930650,182320,100053,338450,303670,229236.1,592200
465960,338288.8,930650,172700,101755.7,338450,293260,236533.1,592200
445900,329581.3,930650,163070,94452,338450,282830,235129.3,592200
425950,311112.6,930650,153440,89096.1,338450,272510,222016.5,592200
405880,301011.9,930650,143810,92554.3,338450,262070,208457.6,592200
389310,302836.4,930650,138790,91355.4,338450,250520,211481,592200
372670,305842.6,930650,133750,86919.5,338450,238920,218923.1,592200
356150,295219.1,930650,128730,76682.6,338450,227420,218536.5,592200
339490,272739.5,930650,123690,68039,338450,215800,204700.5,592200
333700,271881.6,930650,121340,73982.4,338450,212360,197899.2,592200
327950,278058.4,930650,119010,77506.1,338450,208940,200552.3,592200
322130,281844.1,930650,116640,77971.1,338450,205490,203873,592200
316370,276977.4,930650,114320,73636,338450,202050,203341.4,592200
310560,282053.7,930650,111400,76242.8,338450,199160,205810.9,592200
304680,307800.4,930650,108490,87320.8,338450,196190,220479.6,592200
298890,304571.7,930650,105610,82781.7,338450,193280,221790,592200
292970,314372.9,930650,102710,86511.9,338450,190260,227861,592200
287890,337760.7,930650,100300,97228.7,338450,187590,240532,592200
282760,347630.7,930650,97900,101985.9,338450,184860,245644.8,592200
277570,363803.6,930650,95510,110063.8,338450,182060,253739.8,592200
272500,358585.5,930650,93110,106297.3,338450,179390,252288.2,592200
274610,333108.6,930650,92690,93046.5,338450,181920,240062.1,592200
276790,245418.6,930650,92250,62817.6,338450,184540,182601,592200
278950,259613.6,930650,91820,72002.2,338450,187130,187611.4,592200
281100,282474.8,930650,91360,72833.9,338450,189740,209640.9,592200
281900,293072,930650,90670,85844.7,338450,191230,207227.3,592200
282710,278052.7,930650,89950,82164.4,338450,192760,195888.3,592200
283500,283000.7,930650,89190,80754.7,338450,194310,202246,592200
284370,302253.8,930650,88530,72594.2,338450,195840,229659.6,592200
284320,320515.9,930650,87100,83494.7,338450,197220,237021.2,592200
284170,318686.3,930650,85690,78266.3,338450,198480,240420,592200
284140,326313,930650,84290,82638.1,338450,199850,243674.9,592200
284080,310576.6,930650,82880,76210,338450,201200,234366.6,592200
280560,291860.8,930650,81280,63665.6,338450,199280,228195.2,592200
277070,268663.4,930650,79690,56447.5,338450,197380,212215.9,592200
273550,252379.2,930650,78090,49884.9,338450,195460,202494.3,592200
325630,271542.1,930650,66130,41903.2,338450,259500,229638.9,592200
326920,276115.4,930650,66990,36855.3,338450,259930,239260.1,592200
328190,259583,930650,67870,27441.6,338450,260320,232141.4,592200
329460,244076.2,930650,68730,19795.5,338450,260730,224280.7,592200
330700,242667.1,930650,69600,14222.8,338450,261100,228444.3,592200
333090,249598.6,930650,70440,17904.7,338450,262650,231693.9,592200
335550,234027.2,930650,71320,16888.3,338450,264230,217138.9,592200
338040,238372.2,930650,72200,15474.1,338450,265840,222898.1,592200
340420,243550.6,930650,73050,16921.1,338450,267370,226629.5,592200
345070,261109.4,930650,74690,22201.3,338450,270380,238908.1,592200
349650,285797.1,930650,76300,31916.9,338450,273350,253880.2,592200
354200,330002.8,930650,77940,51857.9,338450,276260,278144.9,592200
358820,330234.9,930650,79550,56131.8,338450,279270,274103.1,592200
363520,316610.5,930650,81060,54254,338450,282460,262356.5,592200
368170,324694.8,930650,82560,60875.1,338450,285610,263819.7,592200
372830,318712,930650,84060,62666.1,338450,288770,256045.9,592200
377470,310509.4,930650,85550,56474.3,338450,291920,254035.1,592200
381900,314880.9,930650,87240,56974,338450,294660,257906.9,592200
386260,315059.6,930650,88910,60656.1,338450,297350,254403.5,592200
390580,308353.2,930650,90550,59008.8,338450,300030,249344.4,592200
394990,325797.2,930650,92200,69160.8,338450,302790,256636.4,592200
400350,337398.7,930650,94140,75228.9,338450,306210,262169.8,592200
405700,348419.4,930650,96090,78998.1,338450,309610,269421.3,592200
411080,334963.9,930650,98020,70162.5,338450,313060,264801.4,592200
416430,332425.9,930650,99970,68705.2,338450,316460,263720.7,592200
421150,334541.9,930650,101880,70269.9,338450,319270,264272,592200
425880,345269.2,930650,103770,74531,338450,322110,270738.2,592200
430560,345797.3,930650,105670,73891.8,338450,324890,271905.5,592200
435220,343106.1,930650,107560,78016.9,338450,327660,265089.2,592200
441410,348830.5,930650,109920,86556.2,338450,331490,262274.3,592200
447540,352620.8,930650,112230,92248.8,338450,335310,260372,592200
453690,347660.5,930650,114560,89833,338450,339130,257827.5,592200
459820,350790.2,930650,116890,94052.3,338450,342930,256737.9,592200
458840,336915.8,930650,118840,87040.4,338450,340000,249875.4,592200
457760,338781.8,930650,120780,90106.9,338450,336980,248674.9,592200
456660,335424.4,930650,122720,89130,338450,333940,246294.4,592200
455650,337026.4,930650,124670,87633.8,338450,330980,249392.6,592200
451720,326289.1,930650,125100,85205.5,338450,326620,241083.6,592200
447770,324715.8,930650,125560,87503.4,338450,322210,237212.4,592200
443850,325245.9,930650,125990,79977.6,338450,317860,245268.3,592200
440030,305235.7,930650,126450,68102.8,338450,313580,237132.9,592200
435690,290764.4,930650,126990,57710.5,338450,308700,233053.9,592200
431410,268066,930650,127570,43797.8,338450,303840,224268.2,592200
427120,233345.5,930650,128130,32243.6,338450,298990,201101.9,592200
422800,206448.2,930650,128690,34935.7,338450,294110,171512.5,592200
413870,213375.8,930650,127140,39566.2,338450,286730,173809.6,592200
404860,224922.2,930650,125620,36693.4,338450,279240,188228.8,592200
396000,247965,930650,124070,45656.8,338450,271930,202308.2,592200
387020,258805,930650,122520,50462.8,338450,264500,208342.2,592200
378600,255643.6,930650,121410,51779.2,338450,257190,203864.4,592200
370260,254589.9,930650,120270,51697.8,338450,249990,202892.1,592200
362000,258953.6,930650,119160,50765,338450,242840,208188.6,592200
353620,271890.1,930650,118050,57658.9,338450,235570,214231.2,592200
346330,271001.9,930650,117840,70803.3,338450,228490,200198.6,592200
338990,285489.2,930650,117630,84510,338450,221360,200979.2,592200
331630,301183.8,930650,117430,82750.2,338450,214200,218433.6,592200
324310,275870.8,930650,117250,71594.2,338450,207060,204276.6,592200
322170,262336.6,930650,116940,60374.3,338450,205230,201962.3,592200
320100,242205.2,930650,116640,54227.5,338450,203460,187977.7,592200
317990,263652,930650,116320,64247.2,338450,201670,199404.8,592200
315890,290626.9,930650,116010,76589.9,338450,199880,214037,592200
315580,283290.7,930650,116910,75897.2,338450,198670,207393.5,592200
315280,265023.2,930650,117830,74381.8,338450,197450,190641.4,592200
315020,249158,930650,118740,69907.9,338450,196280,179250.1,592200
314680,210839.4,930650,119670,53276.8,338450,195010,157562.6,592200
313070,193976.7,930650,120180,46573,338450,192890,147403.7,592200
311450,205758.4,930650,120700,50022.7,338450,190750,155735.7,592200
309810,201026.1,930650,121210,42882.4,338450,188600,158143.7,592200
308220,205083.4,930650,121760,51721.4,338450,186460,153362,592200
311210,192674.3,930650,121860,59963.8,338450,189350,132710.5,592200
314280,221955.5,930650,122020,75885.3,338450,192260,146070.2,592200
317360,225029.1,930650,122150,82006.2,338450,195210,143022.9,592200
320410,240998.1,930650,122260,87728.6,338450,198150,153269.5,592200
325880,236591.7,930650,122810,81076.8,338450,203070,155514.9,592200
331500,253052.7,930650,123390,94080,338450,208110,158972.7,592200
337040,301750.1,930650,123930,123983.4,338450,213110,177766.7,592200
342540,299386.1,930650,124480,121422.3,338450,218060,177963.8,592200
349170,299302.7,930650,125950,120258.9,338450,223220,179043.8,592200
355830,295381.3,930650,127400,114059.7,338450,228430,181321.6,592200
362490,351474.5,930650,128880,131024.7,338450,233610,220449.8,592200
369110,345541,930650,130330,136821.7,338450,238780,208719.3,592200
374700,356511.8,930650,130340,142804,338450,244360,213707.8,592200
380260,389085.1,930650,130350,162027.1,338450,249910,227058,592200
385920,367739.1,930650,130370,142210.8,338450,255550,225528.3,592200
391460,408738.1,930650,130390,164927.4,338450,261070,243810.7,592200
397600,443223.4,930650,131790,186578.5,338450,265810,256644.9,592200
403650,473203.9,930650,133190,203317.3,338450,270460,269886.6,592200
409810,458366.6,930650,134590,192639.6,338450,275220,265727,592200
415870,451343,930650,136000,180458.5,338450,279870,270884.5,592200
423150,414997.4,930650,138520,147931.4,338450,284630,267066,592200
430370,388867.2,930650,141040,130421.3,338450,289330,258445.9,592200
437640,398230.4,930650,143560,142110.9,338450,294080,256119.5,592200
444920,396489.2,930650,146100,139277.3,338450,298820,257211.9,592200
446550,395675.5,930650,147270,136093.5,338450,299280,259582,592200
448150,405347.5,930650,148480,139200,338450,299670,266147.5,592200
449740,430308.1,930650,149650,156948.7,338450,300090,273359.4,592200
494840,444418,930650,168420,165000.2,338450,326420,279417.8,592200
498460,450558.9,930650,169640,163776.6,338450,328820,286782.3,592200
502120,455743.7,930650,170920,170042.8,338450,331200,285700.9,592200
505800,458665.4,930650,172180,168317.7,338450,333620,290347.7,592200
509370,445318.6,930650,173420,161585.1,338450,335950,283733.5,592200
514200,443090.4,930650,175540,159046.9,338450,338660,284043.5,592200
518910,450315.1,930650,177660,149949.8,338450,341250,300365.3,592200
523700,409089.7,930650,179770,117456.4,338450,343930,291633.3,592200
528450,413328.2,930650,181890,111616.4,338450,346560,301711.8,592200
517160,428678.9,930650,179530,123819.7,338450,337630,304859.2,592200
505750,437199.6,930650,177170,131200.5,338450,328580,305999.1,592200
494410,444715.9,930650,174830,140760.2,338450,319580,303955.7,592200
483050,441016.5,930650,172490,140109.6,338450,310560,300906.9,592200
471390,419730,930650,170430,133517.3,338450,300960,286212.7,592200
459760,405163.7,930650,168410,141396.2,338450,291350,263767.5,592200
448160,445302.3,930650,166390,165017.4,338450,281770,280284.9,592200
436580,406223.5,930650,164350,153666.9,338450,272230,252556.6,592200
423230,403396.4,930650,162120,163501.9,338450,261110,239894.5,592200
409920,351882.9,930650,159900,126074.8,338450,250020,225808.1,592200
396580,372457.1,930650,157660,144604.4,338450,238920,227852.7,592200
383240,358327.4,930650,155410,137478.3,338450,227830,220849.1,592200
364260,338346.6,930650,149040,131999.4,338450,215220,206347.2,592200
345290,346368.7,930650,142660,144235.1,338450,202630,202133.6,592200
326350,302681.3,930650,136310,112374.8,338450,190040,190306.5,592200
307360,320472.1,930650,129930,127873.6,338450,177430,192598.5,592200
291060,322548.4,930650,125310,130650.1,338450,165750,191898.3,592200
274810,316095.2,930650,120690,123279.2,338450,154120,192816,592200
258540,307750.6,930650,116090,124434.8,338450,142450,183315.8,592200
242270,296818.3,930650,111480,123392.8,338450,130790,173425.5,592200
225990,273197.1,930650,106250,114790.5,338450,119740,158406.6,592200
209750,235618.7,930650,101050,93512.5,338450,108700,142106.2,592200
193490,211770.9,930650,95830,78826.4,338450,97660,132944.5,592200
177230,197206,930650,90620,66317.6,338450,86610,130888.4,592200
165010,175719.6,930650,84090,57696,338450,80920,118023.6,592200
152770,165359.5,930650,77580,52868.6,338450,75190,112490.9,592200
140630,166592.3,930650,71070,51977.4,338450,69560,114614.9,592200
128460,153646.7,930650,64560,42654.6,338450,63900,110992.1,592200
117470,129361.6,930650,58780,32429.6,338450,58690,96932,592200
106450,136790.8,930650,53020,42452.6,338450,53430,94338.2,592200
95510,132259.4,930650,47260,44476,338450,48250,87783.4,592200
84520,111978.7,930650,41520,32065.9,338450,43000,79912.8,592200
73430,99662.6,930650,35790,26397.4,338450,37640,73265.2,592200
62300,90481.1,930650,30090,20213.8,338450,32210,70267.3,592200
51270,85495.3,930650,24380,19176.5,338450,26890,66318.8,592200
40140,79230.5,930650,18660,16554.5,338450,21480,62676,592200
37630,78773,930650,17310,17518,338450,20320,61255,592200
35160,83680.3,930650,15980,21186.6,338450,19180,62493.7,592200
32650,78550.7,930650,14630,17232.4,338450,18020,61318.3,592200
30150,77401.3,930650,13280,16392.1,338450,16870,61009.2,592200
28280,72932.1,930650,12000,13918.5,338450,16280,59013.6,592200
26350,66533.4,930650,10730,10280.8,338450,15620,56252.6,592200
24500,62030.2,930650,9470,7179,338450,15030,54851.2,592200
22580,61918.1,930650,8200,7087,338450,14380,54831.1,592200
20540,58565.4,930650,6820,4236.6,338450,13720,54328.8,592200
18500,58529.2,930650,5470,4026,338450,13030,54503.2,592200
16430,58250.6,930650,4130,3863.5,338450,12300,54387.1,592200
14330,58351.1,930650,2770,3626,338450,11560,54725.1,592200
13810,58474.9,930650,2590,3601,338450,11220,54873.9,592200
13340,58322.1,930650,2400,3601,338450,10940,54721.1,592200
12790,58301,930650,2210,3601,338450,10580,54700,592200
12310,58401.6,930650,2040,3626,338450,10270,54775.6,592200
12170,58937.6,930650,1910,3688.5,338450,10260,55249.1,592200
12090,59225.3,930650,1780,3738.5,338450,10310,55486.8,592200
11880,59613,930650,1630,3801,338450,10250,55812,592200
11820,58104.6,930650,1520,3688.5,338450,10300,54416.1,592200
11750,55261.5,930650,1400,3488.5,338450,10350,51773,592200
11610,55327,930650,1280,3451,338450,10330,51876,592200
11670,55697.7,930650,1170,3538.5,338450,10500,52159.2,592200
11630,59559.5,930650,1020,3880.5,338450,10610,55679,592200
16980,63845.3,930650,2780,5106.9,338450,14200,58738.4,592200
22170,67986.4,930650,4510,6553.8,338450,17660,61432.6,592200
27550,70012.5,930650,6250,7344.2,338450,21300,62668.3,592200
32810,70087.8,930650,7960,8022.8,338450,24850,62065,592200
38360,71466.9,930650,9810,7731.1,338450,28550,63735.8,592200
44000,75148.8,930650,11670,7416.7,338450,32330,67732.1,592200
49550,79601.5,930650,13490,8142,338450,36060,71459.5,592200
55250,84761.7,930650,15350,8546.5,338450,39900,76215.2,592200
60930,87687.1,930650,17260,9087.6,338450,43670,78599.5,592200
66680,91559.6,930650,19150,10212.1,338450,47530,81347.5,592200
72400,95889,930650,21050,10372.3,338450,51350,85516.7,592200
78200,100759.5,930650,22990,12375,338450,55210,88384.5,592200
86340,102989.9,930650,25940,13257.2,338450,60400,89732.7,592200
94580,104807.4,930650,28940,14595,338450,65640,90212.4,592200
102700,112721.3,930650,31890,17905.3,338450,70810,94816,592200
110890,119660.1,930650,34870,18397.9,338450,76020,101262.2,592200
118450,127659.8,930650,37590,19986.7,338450,80860,107673.1,592200
126110,129206.6,930650,40320,19617.8,338450,85790,109588.8,592200
133640,133772.9,930650,43020,18352.8,338450,90620,115420.1,592200
141260,134126.3,930650,45760,18324.3,338450,95500,115802,592200
150720,129736.1,930650,49860,24250.8,338450,100860,105485.3,592200
160190,132242.8,930650,53960,25543.6,338450,106230,106699.2,592200
169590,141981.4,930650,58070,26947.8,338450,111520,115033.6,592200
179120,135387.9,930650,62190,21568.5,338450,116930,113819.4,592200
185060,137216.9,930650,64190,17533.3,338450,120870,119683.6,592200
191070,141189,930650,66200,19048.3,338450,124870,122140.7,592200
197010,154525.4,930650,68190,25983.3,338450,128820,128542.1,592200
148670,166076.1,930650,51610,31487.6,338450,97060,134588.5,592200
155980,178421.6,930650,54890,41017.7,338450,101090,137403.9,592200
163430,194812,930650,58210,50708.6,338450,105220,144103.4,592200
170780,202749.7,930650,61490,52705.5,338450,109290,150044.2,592200
178140,195810.5,930650,64810,45596.5,338450,113330,150214,592200
186850,177303,930650,68990,50536.9,338450,117860,126766.1,592200
195540,196393.9,930650,73150,56700.1,338450,122390,139693.8,592200
204200,225581.5,930650,77350,70781.9,338450,126850,154799.6,592200
212880,256247,930650,81500,92370.9,338450,131380,163876.1,592200
219180,283561.3,930650,87150,110798.9,338450,132030,172762.4,592200
225360,291706.7,930650,92750,116425.6,338450,132610,175281.1,592200
231600,311626.6,930650,98390,127798.8,338450,133210,183827.8,592200
237810,327174.7,930650,104020,140041.8,338450,133790,187132.9,592200
242910,334490.4,930650,109570,142302.5,338450,133340,192187.9,592200
247960,349540.2,930650,115130,141311.1,338450,132830,208229.1,592200
252960,350701.2,930650,120670,150044,338450,132290,200657.2,592200
258060,331065.8,930650,126230,137358.5,338450,131830,193707.3,592200
261640,302442.6,930650,130570,116403.9,338450,131070,186038.7,592200
265450,300209.5,930650,134960,119864.6,338450,130490,180344.9,592200
269070,324736.2,930650,139320,149789.8,338450,129750,174946.4,592200
272770,317760.1,930650,143700,158429.1,338450,129070,159331,592200
270850,280249.4,930650,144840,145074.2,338450,126010,135175.2,592200
268850,273545.5,930650,145950,142312.5,338450,122900,131233,592200
266870,328065.8,930650,147080,187123,338450,119790,140942.8,592200
264930,324368.9,930650,148200,182976.6,338450,116730,141392.3,592200
263370,347070.2,930650,149740,189885.9,338450,113630,157184.3,592200
261850,381171.7,930650,151270,202506.6,338450,110580,178665.1,592200
260310,341979.7,930650,152840,194473.3,338450,107470,147506.4,592200
258840,321398.1,930650,154370,184293.3,338450,104470,137104.8,592200
257970,303614.1,930650,156410,172858,338450,101560,130756.1,592200
257070,310937.6,930650,158460,180851.6,338450,98610,130086,592200
256150,322589.8,930650,160520,191551.7,338450,95630,131038.1,592200
255370,324942.3,930650,162590,189254,338450,92780,135688.3,592200
248850,331253.4,930650,160280,196052.3,338450,88570,135201.1,592200
242340,327161.8,930650,157960,188154.9,338450,84380,139006.9,592200
235900,322510.7,930650,155650,182591,338450,80250,139919.7,592200
229420,299815.5,930650,153330,166730.3,338450,76090,133085.2,592200
222850,311093.8,930650,150570,168672.5,338450,72280,142421.3,592200
216310,311514.4,930650,147790,180838.2,338450,68520,130676.2,592200
209760,311939,930650,145010,184512.9,338450,64750,127426.1,592200
203180,337798.7,930650,142260,193969,338450,60920,143829.7,592200
197520,349646,930650,140100,203381.3,338450,57420,146264.7,592200
191820,340828.8,930650,137990,201193.3,338450,53830,139635.5,592200
186130,322392.1,930650,135870,189920.1,338450,50260,132472,592200
180390,305271.1,930650,133740,183158.9,338450,46650,122112.2,592200
176950,261343.3,930650,132380,159839.2,338450,44570,101504.1,592200
173590,252993.6,930650,131070,160031.9,338450,42520,92961.7,592200
170160,246484.1,930650,129740,158525.2,338450,40420,87958.9,592200
166700,251578.9,930650,128380,164449.4,338450,38320,87129.5,592200
162110,244780.3,930650,126360,164732.8,338450,35750,80047.5,592200
157450,237307,930650,124320,162162.6,338450,33130,75144.4,592200
152860,233901.1,930650,122300,158952.3,338450,30560,74948.8,592200
148190,208313.1,930650,120270,140291.4,338450,27920,68021.7,592200
142230,196545.8,930650,116610,131517.5,338450,25620,65028.3,592200
136230,191507.3,930650,112990,126841.1,338450,23240,64666.2,592200
130210,167144,930650,109300,110781.5,338450,20910,56362.5,592200
124240,153087.2,930650,105660,103187.9,338450,18580,49899.3,592200
126040,152108.9,930650,107760,103425.9,338450,18280,48683,592200
127800,143526.8,930650,109830,98167.3,338450,17970,45359.5,592200
129600,145731.5,930650,111890,101649.8,338450,17710,44081.7,592200
131320,153950.3,930650,113970,109306.7,338450,17350,44643.6,592200
132010,201830.7,930650,114730,144416.1,338450,17280,57414.6,592200
132680,211146.3,930650,115480,150745.5,338450,17200,60400.8,592200
133330,208878.1,930650,116240,149564.4,338450,17090,59313.7,592200
133970,207422.5,930650,116980,148536.3,338450,16990,58886.2,592200
135030,214028.8,930650,117910,154102,338450,17120,59926.8,592200
136070,207849.2,930650,118810,149847.3,338450,17260,58001.9,592200
137100,199926.4,930650,119710,145321.1,338450,17390,54605.3,592200
138130,179264.7,930650,120610,130930.5,338450,17520,48334.2,592200
141330,169668.2,930650,121670,123393.8,338450,19660,46274.4,592200
144620,160738,930650,122750,116375.6,338450,21870,44362.4,592200
147880,168221.6,930650,123810,120136.7,338450,24070,48084.9,592200
151110,171484.7,930650,124870,121430,338450,26240,50054.7,592200
153680,170790.8,930650,125320,119661,338450,28360,51129.8,592200
156200,163199,930650,125750,113443.9,338450,30450,49755.1,592200
158800,149687.4,930650,126220,101162.7,338450,32580,48524.7,592200
161380,111465.5,930650,126650,69925.6,338450,34730,41539.9,592200
162390,95914.8,930650,126260,52510.3,338450,36130,43404.5,592200
163410,104855.2,930650,125860,57487.9,338450,37550,47367.3,592200
164420,98261.9,930650,125460,50927.6,338450,38960,47334.3,592200
165480,86896.4,930650,125050,39788.8,338450,40430,47107.6,592200
159840,77067.4,930650,119550,32452.3,338450,40290,44615.1,592200
154180,73236.9,930650,114060,30277.3,338450,40120,42959.6,592200
148600,67889.3,930650,108540,25728.2,338450,40060,42161.1,592200
142880,65706.2,930650,103000,21892.3,338450,39880,43813.9,592200
138230,70764.2,930650,98330,22320.9,338450,39900,48443.3,592200
133440,72159.6,930650,93610,20057.5,338450,39830,52102.1,592200
128710,74677,930650,88920,18912.6,338450,39790,55764.4,592200
123920,77714.1,930650,84210,19983.1,338450,39710,57731,592200
119060,80653.5,930650,79060,19976.4,338450,40000,60677.1,592200
114170,80944.5,930650,73920,19555,338450,40250,61389.5,592200
109200,84725.5,930650,68770,19717.7,338450,40430,65007.8,592200
104350,87345.8,930650,63640,21432.4,338450,40710,65913.4,592200
101300,87078,930650,61360,23540.5,338450,39940,63537.5,592200
98270,82190.8,930650,59090,21215,338450,39180,60975.8,592200
95290,77555.7,930650,56810,20678.3,338450,38480,56877.4,592200
61350,81223.6,930650,20500,18403.3,338450,40850,62820.3,592200
60280,82331.1,930650,20500,18664.6,338450,39780,63666.5,592200
59200,92061.4,930650,20510,29583,338450,38690,62478.4,592200
58210,86614.9,930650,20530,29125.3,338450,37680,57489.6,592200
57120,80342.9,930650,20540,27425,338450,36580,52917.9,592200
56340,75650.9,930650,20620,25431.1,338450,35720,50219.8,592200
55430,74432.8,930650,20640,24623.3,338450,34790,49809.5,592200
54610,70484.4,930650,20690,22975.3,338450,33920,47509.1,592200
53790,74031.1,930650,20750,25606.7,338450,33040,48424.4,592200
53850,82840.5,930650,21010,30523.7,338450,32840,52316.8,592200
53900,73658.7,930650,21270,24475.6,338450,32630,49183.1,592200
53890,84345.2,930650,21520,31558.8,338450,32370,52786.4,592200
53950,87862.1,930650,21790,33359,338450,32160,54503.1,592200
54000,88464,930650,22050,33355,338450,31950,55109,592200
54100,83720.7,930650,22320,29211.7,338450,31780,54509,592200
54130,78153.6,930650,22590,25160.4,338450,31540,52993.2,592200
54190,79408.3,930650,22840,24619,338450,31350,54789.3,592200
54280,79140.8,930650,23120,24083.6,338450,31160,55057.2,592200
54300,77994.7,930650,23380,22821,338450,30920,55173.7,592200
54410,80427.2,930650,23630,24226.4,338450,30780,56200.8,592200
54460,82999.5,930650,23920,24790.4,338450,30540,58209.1,592200
56020,87481.1,930650,24410,27582.8,338450,31610,59898.3,592200
57650,90867.3,930650,24920,27329.4,338450,32730,63537.9,592200
59210,92303.1,930650,25420,26639.2,338450,33790,65663.9,592200
60810,88400,930650,25930,24523,338450,34880,63877,592200
62370,88870.6,930650,26440,24782.5,338450,35930,64088.1,592200
64040,92427.8,930650,26930,26986.4,338450,37110,65441.4,592200
65580,89281.5,930650,27450,25846.7,338450,38130,63434.8,592200
67310,81768.7,930650,27970,21209.5,338450,39340,60559.2,592200
69000,80051.5,930650,28500,21495,338450,40500,58556.5,592200
70740,88312.8,930650,29030,27173.3,338450,41710,61139.5,592200
72440,87035.1,930650,29590,26979.8,338450,42850,60055.3,592200
74200,82055,930650,30130,23647.7,338450,44070,58407.3,592200
71330,77297,930650,29340,20471.7,338450,41990,56825.3,592200
68550,87606.4,930650,28530,22398.4,338450,40020,65208,592200
65710,100166.3,930650,27730,20503.3,338450,37980,79663,592200
62830,98385,930650,26920,19236.5,338450,35910,79148.5,592200
59920,97801.3,930650,26120,19610.2,338450,33800,78191.1,592200
56970,92077.4,930650,25300,18415.1,338450,31670,73662.3,592200
54030,88453.9,930650,24490,17172.4,338450,29540,71281.5,592200
51100,90384.5,930650,23670,16742.9,338450,27430,73641.6,592200
48020,88077.6,930650,22800,15884,338450,25220,72193.6,592200
44970,86397.2,930650,21970,17384.3,338450,23000,69012.9,592200
41870,82942.3,930650,21120,17074.6,338450,20750,65867.7,592200
38720,77528.5,930650,20250,16236.8,338450,18470,61291.7,592200
35550,71909.2,930650,18640,14149.4,338450,16910,57759.8,592200
32420,72637.6,930650,17060,14305.5,338450,15360,58332.1,592200
29260,74574.8,930650,15470,14981.7,338450,13790,59593.1,592200
26110,76993.4,930650,13860,17869.9,338450,12250,59123.5,592200
23040,79639.1,930650,12280,19926.8,338450,10760,59712.3,592200
20050,81628.3,930650,10720,20915.9,338450,9330,60712.4,592200
17030,58800.8,930650,9170,21557.8,338450,7860,37243,592200
14040,62337.7,930650,7610,16054.6,338450,6430,46283.1,592200
10990,70197.8,930650,6050,14514.2,338450,4940,55683.6,592200
8070,68504.8,930650,4480,13248.1,338450,3590,55256.7,592200
5010,68416.8,930650,2910,12603.9,338450,2100,55812.9,592200
2010,67796.2,930650,1350,12327.4,338450,660,55468.8,592200
2900,64869.2,930650,1690,10304.4,338450,1210,54564.8,592200
3780,63537.6,930650,2020,8677.2,338450,1760,54860.4,592200
4660,62432.5,930650,2370,7975.2,338450,2290,54457.3,592200
5570,64569.5,930650,2700,8935.9,338450,2870,55633.6,592200
6610,59733.5,930650,3070,5652.6,338450,3540,54080.9,592200
7640,59187.1,930650,3420,5444.5,338450,4220,53742.6,592200
8690,60153.1,930650,3790,5785.5,338450,4900,54367.6,592200
9700,63898,930650,4140,7240.7,338450,5560,56657.3,592200
11370,62444.3,930650,4720,6259.6,338450,6650,56184.7,592200
13010,64001.2,930650,5280,7325.5,338450,7730,56675.7,592200
14730,70430.6,930650,5870,11348.6,338450,8860,59082,592200
16360,68999.4,930650,6440,9902.5,338450,9920,59096.9,592200
22250,73277.7,930650,9020,12206.4,338450,13230,61071.3,592200
28110,76689.3,930650,11610,13461,338450,16500,63228.3,592200
33980,81850.5,930650,14180,16041.4,338450,19800,65809.1,592200
39790,86723.3,930650,16730,17746.8,338450,23060,68976.5,592200
44930,94996.6,930650,18980,21243.9,338450,25950,73752.7,592200
49980,100915.5,930650,21220,21972.5,338450,28760,78943,592200
54990,104762.3,930650,23470,21618.4,338450,31520,83143.9,592200
59990,112640.4,930650,25670,26161.6,338450,34320,86478.8,592200
64620,118393,930650,27620,28291.1,338450,37000,90101.9,592200
69200,118564.3,930650,29560,28625.9,338450,39640,89938.4,592200
73720,126392,930650,31490,30041.8,338450,42230,96350.2,592200
78230,134046,930650,33420,33401.4,338450,44810,100644.6,592200
78140,137125,930650,33460,33724.1,338450,44680,103400.9,592200
78050,144105.9,930650,33510,36305.6,338450,44540,107800.3,592200
77910,149441.8,930650,33530,36182,338450,44380,113259.8,592200
77810,161404.2,930650,33570,41228.6,338450,44240,120175.6,592200
77770,161523.3,930650,33730,43665.2,338450,44040,117858.1,592200
77790,160230.2,930650,33880,42942.8,338450,43910,117287.4,592200
77720,147846.8,930650,34050,37713.3,338450,43670,110133.5,592200
77730,150733.7,930650,34210,35678.2,338450,43520,115055.5,592200
78140,117503.4,930650,34600,28169.7,338450,43540,89333.7,592200
78490,121294.6,930650,34930,28474.6,338450,43560,92820,592200
78900,132639.2,930650,35290,33710.2,338450,43610,98929,592200
79270,137546.8,930650,35670,35768.1,338450,43600,101778.7,592200
77320,168698.6,930650,34730,39803,338450,42590,128895.6,592200
75450,158282.4,930650,33810,32578.9,338450,41640,125703.5,592200
73470,160666.7,930650,32870,31033.5,338450,40600,129633.2,592200
75840,157017,930650,22280,28336.1,338450,53560,128680.9,592200
73740,150778.3,930650,22090,28045.4,338450,51650,122732.9,592200
71710,142500.6,930650,21940,23744.4,338450,49770,118756.2,592200
69630,137603,930650,21770,22843,338450,47860,114760,592200
67580,137906,930650,21600,26005.9,338450,45980,111900.1,592200
65550,131569.8,930650,21380,26010.5,338450,44170,105559.3,592200
63490,105378.8,930650,21160,26486.8,338450,42330,78892,592200
61420,105489.1,930650,20930,29118,338450,40490,76371.1,592200
59350,119264.9,930650,20710,31380.4,338450,38640,87884.5,592200
59370,121607.9,930650,21510,34598.8,338450,37860,87009.1,592200
59340,137087.3,930650,22310,39873.9,338450,37030,97213.4,592200
59290,138876.4,930650,23080,39134.9,338450,36210,99741.5,592200
59260,140919.8,930650,23870,39595.1,338450,35390,101324.7,592200
59190,139683.6,930650,24710,37502.1,338450,34480,102181.5,592200
59190,133160,930650,25520,33066.9,338450,33670,100093.1,592200
59060,126078,930650,26350,28779.8,338450,32710,97298.2,592200
59040,127305.2,930650,27180,30367.3,338450,31860,96937.9,592200
59190,127375.9,930650,28210,31749,338450,30980,95626.9,592200
59320,128451.8,930650,29220,33818,338450,30100,94633.8,592200
59490,123896.5,930650,30240,32049.3,338450,29250,91847.2,592200
59740,120181.4,930650,31310,31660.5,338450,28430,88520.9,592200
59830,115419.9,930650,30700,31556.2,338450,29130,83863.7,592200
59940,117819.4,930650,30070,34613.6,338450,29870,83205.8,592200
60150,114959.8,930650,29470,37369,338450,30680,77590.8,592200
60290,109881.1,930650,28870,34306.4,338450,31420,75574.7,592200
60100,108978.2,930650,27970,31300.3,338450,32130,77677.9,592200
59960,111731.7,930650,27100,29732.5,338450,32860,81999.2,592200
59760,112370.1,930650,26200,25329.2,338450,33560,87040.9,592200
59600,116677.6,930650,25320,23439.6,338450,34280,93238,592200
59600,116897.9,930650,24530,24027.8,338450,35070,92870.1,592200
59510,117452.6,930650,23730,23824.6,338450,35780,93628,592200
59540,112764.9,930650,22940,18285.8,338450,36600,94479.1,592200
59480,113054.8,930650,22140,17290.4,338450,37340,95764.4,592200
57770,117637.8,930650,21660,18025,338450,36110,99612.8,592200
56160,125114,930650,21190,18764.3,338450,34970,106349.7,592200
54510,128490.1,930650,20710,21214.5,338450,33800,107275.6,592200
52820,130731.1,930650,20210,25564.1,338450,32610,105167,592200
50820,130336.5,930650,19440,25550.8,338450,31380,104785.7,592200
48750,123312.8,930650,18650,21769,338450,30100,101543.8,592200
46730,122778.3,930650,17860,21935.6,338450,28870,100842.7,592200
44710,126553.7,930650,17080,24155.9,338450,27630,102397.8,592200
42720,123552.1,930650,16440,23021.2,338450,26280,100530.9,592200
40830,108874.6,930650,15830,17602.4,338450,25000,91272.2,592200
38820,106045.9,930650,15190,16363.8,338450,23630,89682.1,592200
36940,98841,930650,14570,13288.9,338450,22370,85552.1,592200
35280,87719,930650,14120,9553.8,338450,21160,78165.2,592200
33580,82915.9,930650,13690,8723,338450,19890,74192.9,592200
31950,82878.6,930650,13270,8144.5,338450,18680,74734.1,592200
30320,83450.2,930650,12840,10089.9,338450,17480,73360.3,592200
28500,78326.7,930650,12130,6414.6,338450,16370,71912.1,592200
26690,83504.8,930650,11460,6618.4,338450,15230,76886.4,592200
24870,79159.7,930650,10760,6342.2,338450,14110,72817.5,592200
23070,77738,930650,10060,6163.5,338450,13010,71574.5,592200
21680,73661.4,930650,9520,5788.5,338450,12160,67872.9,592200
20200,72731.6,930650,8990,5726,338450,11210,67005.6,592200
18780,73696,930650,8430,5838.5,338450,10350,67857.5,592200
17320,71188.3,930650,7900,5726,338450,9420,65462.3,592200
21980,75290.9,930650,10380,6113.5,338450,11600,69177.4,592200
26730,76111.9,930650,12890,6251,338450,13840,69860.9,592200
31340,71252.3,930650,15370,6100.9,338450,15970,65151.4,592200
35990,70765.9,930650,17880,7455.5,338450,18110,63310.4,592200
40840,74820.9,930650,20340,10356.5,338450,20500,64464.4,592200
45610,75874.8,930650,22770,10472.5,338450,22840,65402.3,592200
50470,73063.9,930650,25240,9194.6,338450,25230,63869.3,592200
55270,74629.6,930650,27700,10287.1,338450,27570,64342.5,592200
60580,76558.5,930650,30320,12102.5,338450,30260,64456,592200
65880,81822.5,930650,32910,16357,338450,32970,65465.5,592200
71180,93288,930650,35500,21759,338450,35680,71529,592200
76480,99998.9,930650,38110,25518.9,338450,38370,74480,592200
88210,106497.7,930650,42980,28712.9,338450,45230,77784.8,592200
99980,115173.1,930650,47820,31766.3,338450,52160,83406.8,592200
111800,115210.4,930650,52690,30358.9,338450,59110,84851.5,592200
123500,134250.4,930650,57550,37359.9,338450,65950,96890.5,592200
134950,153639.3,930650,62350,47592.1,338450,72600,106047.2,592200
146360,151979.8,930650,67130,57428.3,338450,79230,94551.5,592200
157710,152714,930650,71950,63100.3,338450,85760,89613.7,592200
169150,156818.4,930650,76710,60366,338450,92440,96452.4,592200
180110,160552.9,930650,81300,65465.2,338450,98810,95087.7,592200
191140,179266.3,930650,85900,66373.1,338450,105240,112893.2,592200
202070,189785.7,930650,90450,73465.2,338450,111620,116320.5,592200
213030,192404,930650,95020,77259.5,338450,118010,115144.5,592200
210060,196970.7,930650,93920,73725.8,338450,116140,123244.9,592200
207090,158992.3,930650,92850,64672.3,338450,114240,94320,592200
204080,168765.1,930650,91730,65735.8,338450,112350,103029.3,592200
201080,187733.1,930650,90630,71353.6,338450,110450,116379.5,592200
197500,175417.9,930650,89390,64162.7,338450,108110,111255.2,592200
193860,165572.1,930650,88120,57880.6,338450,105740,107691.5,592200
190240,164762.4,930650,86890,56988.5,338450,103350,107773.9,592200
186620,176104,930650,85620,61274.2,338450,101000,114829.8,592200
182910,179641.6,930650,84230,63198,338450,98680,116443.6,592200
179250,172423.5,930650,82840,62236,338450,96410,110187.5,592200
175540,192817.1,930650,81460,58665.2,338450,94080,134151.9,592200
171850,183096.8,930650,80070,53783,338450,91780,129313.8,592200
164940,165098.3,930650,76450,43526.8,338450,88490,121571.5,592200
158070,145253.3,930650,72820,32340.5,338450,85250,112912.8,592200
151130,142170.6,930650,69190,31834.7,338450,81940,110335.9,592200
130210,143375.7,930650,59600,34529.7,338450,70610,108846,592200
124040,132058.5,930650,56860,33144.4,338450,67180,98914.1,592200
117940,126668.1,930650,54150,33502.1,338450,63790,93166,592200
111780,124575.3,930650,51380,33787.9,338450,60400,90787.4,592200
105610,130656.5,930650,48640,37496.6,338450,56970,93159.9,592200
100200,127587.8,930650,46200,34956.4,338450,54000,92631.4,592200
94830,128226.6,930650,43780,35670.7,338450,51050,92555.9,592200
89460,128529.7,930650,41350,37155.6,338450,48110,91374.1,592200
84020,136184.6,930650,38910,43125.3,338450,45110,93059.3,592200
81960,134438.1,930650,38050,42395.1,338450,43910,92043,592200
79880,137849.7,930650,37190,44234.1,338450,42690,93615.6,592200
77820,147197.6,930650,36320,52770.3,338450,41500,94427.3,592200
75750,150818.3,930650,35480,55889.8,338450,40270,94928.5,592200
73720,151034.3,930650,34720,55101.9,338450,39000,95932.4,592200
71640,148690.3,930650,33930,52473.3,338450,37710,96217,592200
69650,138952.7,930650,33160,45369.8,338450,36490,93582.9,592200
67620,113925,930650,32390,36888.8,338450,35230,77036.2,592200
64590,99456.9,930650,30830,31710.7,338450,33760,67746.2,592200
61610,100130,930650,29260,27971.7,338450,32350,72158.3,592200
58660,111700.9,930650,27730,23363.6,338450,30930,88337.3,592200
55670,111071,930650,26150,18248.4,338450,29520,92822.6,592200
56770,105819.8,930650,27140,13801.1,338450,29630,92018.7,592200
57830,98882.8,930650,28120,11708,338450,29710,87174.8,592200
58940,101252.1,930650,29110,13068.3,338450,29830,88183.8,592200
60050,108572.4,930650,30120,16960.3,338450,29930,91612.1,592200
62350,118648.1,930650,32100,23547.1,338450,30250,95101,592200
64650,128210.7,930650,34110,30225.8,338450,30540,97984.9,592200
66970,135465.3,930650,36090,34721.2,338450,30880,100744.1,592200
69250,142292.4,930650,38110,39169.1,338450,31140,103123.3,592200
71560,149282.7,930650,39810,42479.6,338450,31750,106803.1,592200
73830,152886.6,930650,41500,44926.5,338450,32330,107960.1,592200
76150,151617.2,930650,43200,45461.5,338450,32950,106155.7,592200
78420,149567.4,930650,44870,42076.5,338450,33550,107490.9,592200
79140,151600.1,930650,45840,41573.1,338450,33300,110027,592200
79760,148182.7,930650,46760,41074.7,338450,33000,107108,592200
80410,149606,930650,47700,39771.2,338450,32710,109834.8,592200
81110,146828.6,930650,48640,37708.9,338450,32470,109119.7,592200
81220,159320.2,930650,49290,45411.7,338450,31930,113908.5,592200
81310,164603.3,930650,49910,49166.3,338450,31400,115437,592200
81470,164786.9,930650,50570,53126.9,338450,30900,111660,592200
81610,168765.3,930650,51220,60842.2,338450,30390,107923.1,592200
81630,156053.4,930650,52000,59759.9,338450,29630,96293.5,592200
81690,166343.3,930650,52780,73267,338450,28910,93076.3,592200
81730,197185.1,930650,53570,97511.6,338450,28160,99673.5,592200
81830,205847.7,930650,54360,103953.1,338450,27470,101894.6,592200
79640,191951.5,930650,53240,97260.8,338450,26400,94690.7,592200
77450,156519.7,930650,52160,73411.4,338450,25290,83108.3,592200
75290,141382.6,930650,51050,64042.4,338450,24240,77340.2,592200
73070,138733.2,930650,49930,62034,338450,23140,76699.2,592200
71180,114510.4,930650,48770,43374.1,338450,22410,71136.3,592200
69270,94597.8,930650,47580,30405.2,338450,21690,64192.6,592200
67340,85636.9,930650,46410,24332.7,338450,20930,61304.2,592200
65460,86685.5,930650,45240,25314.3,338450,20220,61371.2,592200
63970,94544,930650,44110,32284.1,338450,19860,62259.9,592200
62510,86119.8,930650,43010,26740.9,338450,19500,59378.9,592200
61020,91622.5,930650,41890,30725,338450,19130,60897.5,592200
59520,127446.2,930650,40760,56459.2,338450,18760,70987,592200
62970,172402.8,930650,43000,87919.9,338450,19970,84482.9,592200
66450,222885.9,930650,45210,125564.2,338450,21240,97321.7,592200
69840,202510.5,930650,47460,110756,338450,22380,91754.5,592200
73230,178810.3,930650,49680,92669.7,338450,23550,86140.6,592200
76610,145406.3,930650,51890,69581.6,338450,24720,75824.7,592200
79950,135160.4,930650,54060,63155.3,338450,25890,72005.1,592200
83300,139764.3,930650,56280,65765.7,338450,27020,73998.6,592200
86660,149110.9,930650,58450,74236.9,338450,28210,74874,592200
90160,149207.3,930650,60640,74548.4,338450,29520,74658.9,592200
93560,144835.8,930650,62790,72380.7,338450,30770,72455.1,592200
97010,140995.7,930650,64950,70889.6,338450,32060,70106.1,592200
100450,133847.9,930650,67100,65120.1,338450,33350,68727.8,592200
109670,142505.2,930650,71480,68481.3,338450,38190,74023.9,592200
118940,170608.3,930650,75910,85014,338450,43030,85594.3,592200
128170,180974.2,930650,80280,87905.8,338450,47890,93068.4,592200
137460,179853,930650,84700,85530.2,338450,52760,94322.8,592200
146110,162876.3,930650,88430,72717.7,338450,57680,90158.6,592200
154780,179882.6,930650,92200,84326.9,338450,62580,95555.7,592200
163460,197839.1,930650,95930,95354.3,338450,67530,102484.8,592200
172200,208247.6,930650,99700,97563.9,338450,72500,110683.7,592200
180830,195312.2,930650,103680,83948.3,338450,77150,111363.9,592200
189520,216187.8,930650,107680,93050.2,338450,81840,123137.6,592200
198210,223929.6,930650,111670,97971.6,338450,86540,125958,592200
206860,240768,930650,115640,110904,338450,91220,129864,592200
205540,249094.8,930650,114820,114105.6,338450,90720,134989.2,592200
204300,233230.5,930650,114000,103223,338450,90300,130007.5,592200
203020,244223,930650,113180,114461,338450,89840,129762,592200
201760,209300.2,930650,112340,91945.4,338450,89420,117354.8,592200
199490,197223.2,930650,111080,87162.5,338450,88410,110060.7,592200
197210,194020.5,930650,109840,81165.7,338450,87370,112854.8,592200
194940,198766.9,930650,108590,85620.6,338450,86350,113146.3,592200
192680,180027.5,930650,107350,76017.4,338450,85330,104010.1,592200
191170,183527,930650,106650,76935,338450,84520,106592,592200
189710,157550.6,930650,105970,59599,338450,83740,97951.6,592200
188230,158308.5,930650,105260,60559.9,338450,82970,97748.6,592200
186790,145954.3,930650,104590,51877.8,338450,82200,94076.5,592200
181740,149288.8,930650,101990,59656.2,338450,79750,89632.6,592200
176790,155934.1,930650,99420,64299.6,338450,77370,91634.5,592200
171760,145134.9,930650,96850,55123.3,338450,74910,90011.6,592200
141810,136930.8,930650,76250,49767.7,338450,65560,87163.1,592200
134380,129174.4,930650,72180,46473.7,338450,62200,82700.7,592200
127030,130039,930650,68090,45619,338450,58940,84420,592200
119600,116023,930650,64050,35616.9,338450,55550,80406.1,592200
112240,112176.6,930650,59980,36200.7,338450,52260,75975.9,592200
104820,118652.3,930650,55710,42312.2,338450,49110,76340.1,592200
97340,106371.2,930650,51430,35130.5,338450,45910,71240.7,592200
89870,98173,930650,47120,30899.6,338450,42750,67273.4,592200
82500,103410.4,930650,42840,33460.2,338450,39660,69950.2,592200
82310,102413,930650,42760,35757.1,338450,39550,66655.9,592200
82210,106717.2,930650,42670,36292.1,338450,39540,70425.1,592200
82040,114244.8,930650,42600,40089.5,338450,39440,74155.3,592200
81920,117593.8,930650,42520,43091.6,338450,39400,74502.2,592200
81430,122652.4,930650,42030,46655.9,338450,39400,75996.5,592200
80850,130463.3,930650,41530,50085,338450,39320,80378.3,592200
80350,145858.5,930650,41060,60185.9,338450,39290,85672.6,592200
79810,162002.5,930650,40580,73555.5,338450,39230,88447,592200
79860,153493.3,930650,40610,65500.5,338450,39250,87992.8,592200
79930,141420.5,930650,40640,57745.2,338450,39290,83675.3,592200
80050,135730.9,930650,40690,53928.1,338450,39360,81802.8,592200
80090,133500,930650,40710,54086.7,338450,39380,79413.3,592200
78500,135432.8,930650,39520,56559.2,338450,38980,78873.6,592200
76950,138346.4,930650,38310,59945.6,338450,38640,78400.8,592200
75430,130262.9,930650,37110,54598,338450,38320,75664.9,592200
73880,134662.8,930650,35920,59499,338450,37960,75163.8,592200
72570,135891,930650,35650,61389.5,338450,36920,74501.5,592200
71350,126790.5,930650,35400,54977.4,338450,35950,71813.1,592200
70120,119207,930650,35150,50236.2,338450,34970,68970.8,592200
68870,114435.3,930650,34890,46055.4,338450,33980,68379.9,592200
67590,111252.3,930650,34360,42443,338450,33230,68809.3,592200
66420,113416.9,930650,33810,41405.9,338450,32610,72011,592200
65160,119369.6,930650,33270,43888.8,338450,31890,75480.8,592200
63900,115607.2,930650,32750,41162.5,338450,31150,74444.7,592200
63410,111319,930650,32930,41507,338450,30480,69812,592200
62870,101065.4,930650,33130,35382.4,338450,29740,65683,592200
62320,104513.4,930650,33290,38692.4,338450,29030,65821,592200
61810,92114.5,930650,33490,29895.2,338450,28320,62219.3,592200
61230,91876.8,930650,33280,29921.6,338450,27950,61955.2,592200
60670,111098,930650,33090,43719.9,338450,27580,67378.1,592200
60070,140754.2,930650,32890,65191.9,338450,27180,75562.3,592200
59480,156234.2,930650,32690,76005,338450,26790,80229.2,592200
56620,149910.5,930650,31780,70627.1,338450,24840,79283.4,592200
53720,152055.3,930650,30870,71534.8,338450,22850,80520.5,592200
50890,170169.3,930650,29980,82081,338450,20910,88088.3,592200
47970,170985.8,930650,29110,89580.8,338450,18860,81405,592200
50700,197916.6,930650,30780,108944,338450,19920,88972.6,592200
53490,214275.3,930650,32460,120925.3,338450,21030,93350,592200
56300,211094.5,930650,34180,119008.7,338450,22120,92085.8,592200
59040,191182.4,930650,35860,104421.1,338450,23180,86761.3,592200
62120,161469,930650,37830,82450.6,338450,24290,79018.4,592200
65190,131612.7,930650,39790,62599.3,338450,25400,69013.4,592200
68360,115580.4,930650,41760,51238,338450,26600,64342.4,592200
71390,101931.6,930650,43690,41838.2,338450,27700,60093.4,592200
75270,98380.8,930650,46250,37910.2,338450,29020,60470.6,592200
78990,98026.2,930650,48740,36472.5,338450,30250,61553.7,592200
82770,100556.7,930650,51290,38998.6,338450,31480,61558.1,592200
86580,103093,930650,53810,42262.4,338450,32770,60830.6,592200
93470,112745.9,930650,57460,49456.6,338450,36010,63289.3,592200
100240,120786.2,930650,61080,53245.1,338450,39160,67541.1,592200
107120,142311.6,930650,64750,57731.1,338450,42370,84580.5,592200
113970,129489.1,930650,68390,59326.3,338450,45580,70162.8,592200
120540,128842,930650,71970,57291,338450,48570,71551,592200
127170,138238.6,930650,75580,59652.2,338450,51590,78586.4,592200
133750,153391.4,930650,79170,67181.3,338450,54580,86210.1,592200
140410,169087.7,930650,82750,77537.6,338450,57660,91550.1,592200
147650,188625.5,930650,86760,90938.4,338450,60890,97687.1,592200
154860,178867.9,930650,90740,87362.6,338450,64120,91505.3,592200
162110,192922.9,930650,94740,91043.8,338450,67370,101879.1,592200
169320,202219.5,930650,98740,97026.7,338450,70580,105192.8,592200
177810,217028.5,930650,102750,114780.5,338450,75060,102248,592200
186350,237830.5,930650,106770,125306.3,338450,79580,112524.2,592200
194870,274828.2,930650,110770,146507.8,338450,84100,128320.4,592200
203370,294255,930650,114780,159712,338450,88590,134543,592200
211100,292966,930650,117950,160484.4,338450,93150,132481.6,592200
218880,319962.4,930650,121150,175583.7,338450,97730,144378.7,592200
226690,342779.7,930650,124310,189701.6,338450,102380,153078.1,592200
234390,344624.8,930650,127510,195142.3,338450,106880,149482.5,592200
244840,342585.8,930650,133740,193290.1,338450,111100,149295.7,592200
255440,337097.6,930650,140010,189285.3,338450,115430,147812.3,592200
265960,340956.7,930650,146290,187468.3,338450,119670,153488.4,592200
276500,336345.8,930650,152530,180780.9,338450,123970,155564.9,592200
278380,332355.2,930650,152700,176669.8,338450,125680,155685.4,592200
280270,324792.9,930650,152870,168351.9,338450,127400,156441,592200
282170,328182.3,930650,153020,169702.5,338450,129150,158479.8,592200
284030,323690.1,930650,153190,176291.7,338450,130840,147398.4,592200
286500,324005.5,930650,153490,178622.5,338450,133010,145383,592200
288980,316923.2,930650,153760,174334.4,338450,135220,142588.8,592200
291410,304652.6,930650,154050,158224.2,338450,137360,146428.4,592200
293890,304496.6,930650,154330,168452.2,338450,139560,136044.4,592200
296580,328999.8,930650,155100,185838.6,338450,141480,143161.2,592200
299260,364350.2,930650,155870,188432.1,338450,143390,175918.1,592200
302000,344357.8,930650,156640,173081.7,338450,145360,171276.1,592200
304700,343351,930650,157440,173263.5,338450,147260,170087.5,592200
306900,353171.6,930650,157850,176603.6,338450,149050,176568,592200
309000,364614.8,930650,158250,176486.1,338450,150750,188128.7,592200
311190,387155.8,930650,158650,188173.6,338450,152540,198982.2,592200
350540,380874.5,930650,171100,187222.2,338450,179440,193652.3,592200
351770,360800,930650,170720,181221.9,338450,181050,179578.1,592200
352970,371698.1,930650,170370,185880.8,338450,182600,185817.3,592200
354180,397399.3,930650,170010,200343.4,338450,184170,197055.9,592200
355410,415721,930650,169630,211588.2,338450,185780,204132.8,592200
356490,429971.6,930650,169450,212684.2,338450,187040,217287.4,592200
357600,438604.7,930650,169260,214729.9,338450,188340,223874.8,592200
358790,463029.9,930650,169080,222695.7,338450,189710,240334.2,592200
359920,444959.4,930650,168930,209422.7,338450,190990,235536.7,592200
360730,459799.6,930650,168890,213048,338450,191840,246751.6,592200
361640,440739.6,930650,168870,196922.7,338450,192770,243816.9,592200
362540,436565.4,930650,168870,192854.9,338450,193670,243710.5,592200
363370,425445.6,930650,168860,190348.8,338450,194510,235096.8,592200
364130,454901.3,930650,168840,197947.9,338450,195290,256953.4,592200
364880,490713.5,930650,168840,226282.8,338450,196040,264430.7,592200
365660,525642,930650,168850,244950,338450,196810,280692,592200
366470,557093.5,930650,168840,267042.5,338450,197630,290051,592200
367800,533479.6,930650,169160,262361.9,338450,198640,271117.7,592200
369190,545498.6,930650,169480,264475.3,338450,199710,281023.3,592200
370470,544789.4,930650,169770,261797.9,338450,200700,282991.5,592200
371830,508929.9,930650,170110,251461.1,338450,201720,257468.8,592200
374890,533416.2,930650,171980,266210.4,338450,202910,267205.8,592200
377870,529253.1,930650,173860,261126.3,338450,204010,268126.8,592200
380960,521584.7,930650,175760,263449.4,338450,205200,258135.3,592200
383940,515169.8,930650,177620,263221.3,338450,206320,251948.5,592200
387660,509445.2,930650,180020,260869.9,338450,207640,248575.3,592200
391430,516301.9,930650,182390,262559.6,338450,209040,253742.3,592200
395090,523643.6,930650,184770,261987.9,338450,210320,261655.7,592200
398800,533876.1,930650,187150,268699.2,338450,211650,265176.9,592200
400840,518870.3,930650,188780,264088.8,338450,212060,254781.5,592200
402810,518537.1,930650,190410,260306.7,338450,212400,258230.4,592200
404850,508326.1,930650,192070,256688.3,338450,212780,251637.8,592200
406820,500064.9,930650,193690,250925.4,338450,213130,249139.5,592200
406250,469174.9,930650,192540,236470.1,338450,213710,232704.8,592200
405670,447891,930650,191390,222337.8,338450,214280,225553.2,592200
405030,439581.4,930650,190250,224174.2,338450,214780,215407.2,592200
404510,435547.7,930650,189100,219708.6,338450,215410,215839.1,592200
403430,436801.6,930650,187810,220451.5,338450,215620,216350.1,592200
402360,437855.1,930650,186510,216480,338450,215850,221375.1,592200
401260,419501.5,930650,185230,210279.1,338450,216030,209222.4,592200
400160,446188.6,930650,183930,215964.3,338450,216230,230224.3,592200
399730,433401.1,930650,183110,203353.2,338450,216620,230047.9,592200
399310,412279.9,930650,182300,194959.6,338450,217010,217320.3,592200
398880,409504.6,930650,181490,197662.9,338450,217390,211841.7,592200
398460,389349.5,930650,180690,188119.3,338450,217770,201230.2,592200
392620,379023.7,930650,177400,182421.1,338450,215220,196602.6,592200
386860,375897.7,930650,174150,180727.3,338450,212710,195170.4,592200
381020,378292.1,930650,170860,182228.9,338450,210160,196063.2,592200
375330,359710.7,930650,167630,171554.7,338450,207700,188156,592200
370130,352533.3,930650,164740,171342.3,338450,205390,181191,592200
364950,351305.4,930650,161870,171958.5,338450,203080,179346.9,592200
359780,319629.6,930650,159000,153473.7,338450,200780,166155.9,592200
354650,307347.6,930650,156130,146159.2,338450,198520,161188.4,592200
349490,297584.5,930650,153130,141600.7,338450,196360,155983.8,592200
344280,292793,930650,150160,139151.5,338450,194120,153641.5,592200
339100,300052.2,930650,147130,143271,338450,191970,156781.2,592200
333850,275478.1,930650,144120,136978.1,338450,189730,138500,592200
340550,281794.1,930650,147310,137909.8,338450,193240,143884.3,592200
347300,295204.4,930650,150510,143904.2,338450,196790,151300.2,592200
353980,335245.9,930650,153690,156662.1,338450,200290,178583.8,592200
360660,325304.3,930650,156870,162154.3,338450,203790,163150,592200
367280,321527.9,930650,159870,156291.5,338450,207410,165236.4,592200
373900,314287.3,930650,162860,153870.4,338450,211040,160416.9,592200
380510,322333.3,930650,165840,156546.8,338450,214670,165786.5,592200
387130,344335.9,930650,168860,167156.9,338450,218270,177179,592200
394180,343586.4,930650,171790,165662.6,338450,222390,177923.8,592200
401190,375814.4,930650,174700,178727.3,338450,226490,197087.1,592200
408230,395097.6,930650,177630,190497.8,338450,230600,204599.8,592200
415280,403981.7,930650,180550,193890.3,338450,234730,210091.4,592200
419410,423435.8,930650,183240,209965.6,338450,236170,213470.2,592200
423490,426409.2,930650,185890,208465.5,338450,237600,217943.7,592200
427630,378469.8,930650,188580,175168.5,338450,239050,203301.3,592200
431700,377163,930650,191250,174762.4,338450,240450,202400.6,592200
434590,408546.8,930650,193470,191579.4,338450,241120,216967.4,592200
437500,428246.6,930650,195700,197110.8,338450,241800,231135.8,592200
440430,453892.7,930650,197940,222004.6,338450,242490,231888.1,592200
443340,435350.5,930650,200190,210492.6,338450,243150,224857.9,592200
446010,475689,930650,201390,231597.5,338450,244620,244091.5,592200
448760,469424.6,930650,202600,228201.7,338450,246160,241222.9,592200
451470,460690.1,930650,203830,224395.6,338450,247640,236294.5,592200
454180,462287.7,930650,205020,234868.5,338450,249160,227419.2,592200
450040,407731.4,930650,203960,195271.9,338450,246080,212459.5,592200
445870,398373.2,930650,202900,191197.5,338450,242970,207175.7,592200
441710,397956,930650,201830,194192,338450,239880,203764,592200
437610,311986,930650,200780,133789.2,338450,236830,178196.8,592200
430830,384269.6,930650,198150,186352.7,338450,232680,197916.9,592200
424100,298834.6,930650,195550,127083.5,338450,228550,171751.1,592200
417330,431688.5,930650,192940,227692.4,338450,224390,203996.1,592200
410650,369807.9,930650,190340,182514.8,338450,220310,187293.1,592200
405150,273250.8,930650,189270,119270.3,338450,215880,153980.5,592200
399660,293043.8,930650,188220,139257.8,338450,211440,153786,592200
394190,362860.7,930650,187170,196382.4,338450,207020,166478.3,592200
388720,390348.2,930650,186120,215395.9,338450,202600,174952.3,592200
388610,281207.3,930650,189540,133418.6,338450,199070,147788.7,592200
388490,313410.1,930650,192980,152737.7,338450,195510,160672.4,592200
388370,351351.4,930650,196400,175132.8,338450,191970,176218.6,592200
393490,308544.4,930650,183460,137495.7,338450,210030,171048.7,592200
391540,279914.3,930650,183720,111972.9,338450,207820,167941.4,592200
389760,356723.7,930650,183990,168060.3,338450,205770,188663.4,592200
387980,362706.6,930650,184280,174226.4,338450,203700,188480.2,592200
386120,389428.3,930650,184540,194668.9,338450,201580,194759.4,592200
386890,381853.6,930650,187060,194926.4,338450,199830,186927.2,592200
387630,385841.1,930650,189600,195103.2,338450,198030,190737.9,592200
388390,422720.4,930650,192110,215293.6,338450,196280,207426.8,592200
389170,364370.5,930650,194630,169659.7,338450,194540,194710.8,592200
391580,344072,930650,197270,164783.5,338450,194310,179288.5,592200
393870,221323.9,930650,199860,75332.4,338450,194010,145991.5,592200
396280,275484.2,930650,202490,112101.8,338450,193790,163382.4,592200
398600,384791.8,930650,205070,194183.2,338450,193530,190608.6,592200
400410,400735.5,930650,206120,200367.6,338450,194290,200367.9,592200
402220,445136.2,930650,207160,227335.7,338450,195060,217800.5,592200
404050,451127.7,930650,208200,239660.7,338450,195850,211467,592200
405850,432162.9,930650,209230,226622.3,338450,196620,205540.6,592200
406940,413240.4,930650,210050,223534.1,338450,196890,189706.3,592200
407920,416804.8,930650,210840,225558.3,338450,197080,191246.5,592200
408990,430476.4,930650,211670,216691.6,338450,197320,213784.8,592200
410060,381250.3,930650,212460,204815.3,338450,197600,176435,592200
409290,392782.5,930650,213140,221051.5,338450,196150,171731,592200
408550,403291.3,930650,213850,222987.4,338450,194700,180303.9,592200
407770,371688.9,930650,214560,198404.6,338450,193210,173284.3,592200
407030,379879.5,930650,215270,207385.6,338450,191760,172493.9,592200
406680,389925.4,930650,216150,214443.9,338450,190530,175481.5,592200
406200,406670.3,930650,217000,216974.7,338450,189200,189695.6,592200
405840,393869.2,930650,217860,216196.3,338450,187980,177672.9,592200
405410,417558.2,930650,218720,218635.9,338450,186690,198922.3,592200
405160,428850.6,930650,219580,221541.8,338450,185580,207308.8,592200
404900,420675.8,930650,220460,221776.5,338450,184440,198899.3,592200
404610,430633.2,930650,221350,219382.5,338450,183260,211250.7,592200
404290,413018.7,930650,222220,211566.4,338450,182070,201452.3,592200
404370,396347.6,930650,221670,206729.4,338450,182700,189618.2,592200
404440,420670.8,930650,221140,220053.8,338450,183300,200617,592200
404540,427161.1,930650,220600,214552.5,338450,183940,212608.6,592200
404610,417408.3,930650,220040,205692.5,338450,184570,211715.8,592200
406900,407122.7,930650,221700,206289.9,338450,185200,200832.8,592200
409230,379666.3,930650,223350,206024.9,338450,185880,173641.4,592200
411460,376493.1,930650,224990,205957.6,338450,186470,170535.5,592200
413810,380844.8,930650,226630,214401.7,338450,187180,166443.1,592200
414860,366874.4,930650,227120,213153.7,338450,187740,153720.7,592200
415890,359809.4,930650,227590,217415,338450,188300,142394.4,592200
416960,369854.6,930650,228050,217633.1,338450,188910,152221.5,592200
418040,380632.4,930650,228530,217746.1,338450,189510,162886.3,592200
416520,394103,930650,225480,212236.7,338450,191040,181866.3,592200
414950,400933.1,930650,222400,212128.5,338450,192550,188804.6,592200
413400,388878.5,930650,219350,211761.8,338450,194050,177116.7,592200
411810,358244.9,930650,216280,190008.6,338450,195530,168236.3,592200
413630,403272.1,930650,214610,211132.2,338450,199020,192139.9,592200
415480,377243.1,930650,212950,199732.4,338450,202530,177510.7,592200
417310,370879.4,930650,211300,188379.1,338450,206010,182500.3,592200
419120,260174.2,930650,209630,119370.8,338450,209490,140803.4,592200
419410,249777.7,930650,207450,101925.8,338450,211960,147851.9,592200
419670,263059.2,930650,205240,117412.3,338450,214430,145646.9,592200
420050,243875.9,930650,203070,108752.5,338450,216980,135123.4,592200
420330,262172.8,930650,200890,113963.1,338450,219440,148209.7,592200
414230,313271.1,930650,199410,140658.5,338450,214820,172612.6,592200
408150,409125.4,930650,197960,199725.4,338450,210190,209400,592200
402140,440293.8,930650,196520,204519.3,338450,205620,235774.5,592200
396040,443332.6,930650,195040,204554,338450,201000,238778.6,592200
389900,490017.2,930650,193300,233621.8,338450,196600,256395.4,592200
383790,455334.5,930650,191560,206508.2,338450,192230,248826.3,592200
377650,383354.5,930650,189820,171258.3,338450,187830,212096.2,592200
371540,392039.9,930650,188070,162569.5,338450,183470,229470.4,592200
364960,416808.9,930650,186410,183860.5,338450,178550,232948.4,592200
358500,392159,930650,184740,167891.2,338450,173760,224267.8,592200
352030,430853.6,930650,183090,204413.7,338450,168940,226439.9,592200
345550,379425.1,930650,181430,188685.7,338450,164120,190739.4,592200
339400,322789,930650,179070,152951.9,338450,160330,169837.1,592200
333360,235627.8,930650,176710,99430.1,338450,156650,136197.7,592200
327180,197499.7,930650,174350,75447.1,338450,152830,122052.6,592200
321070,187904.5,930650,171990,68845.6,338450,149080,119058.9,592200
315710,186255.9,930650,170310,64499.8,338450,145400,121756.1,592200
310390,202049.5,930650,168630,64024.3,338450,141760,138025.2,592200
305070,232263.5,930650,166950,89388,338450,138120,142875.5,592200
299690,278826.8,930650,165270,118855.1,338450,134420,159971.7,592200
297940,303721.8,930650,166500,142131,338450,131440,161590.8,592200
296230,297935.2,930650,167770,143644,338450,128460,154291.2,592200
294520,273293.6,930650,169010,130860.3,338450,125510,142433.3,592200
292820,334131.4,930650,170270,171478.8,338450,122550,162652.6,592200
286190,378700.5,930650,165440,193594.8,338450,120750,185105.7,592200
279670,300175,930650,160660,130633.2,338450,119010,169541.8,592200
273100,258349.2,930650,155810,93672,338450,117290,164677.2,592200
266550,239021.5,930650,150980,81413.1,338450,115570,157608.4,592200
260420,263211.4,930650,147050,92773.9,338450,113370,170437.5,592200
254380,286869.3,930650,143140,109516.1,338450,111240,177353.2,592200
248330,310898.6,930650,139200,126722.8,338450,109130,184175.8,592200
242250,275801.5,930650,135260,105237.1,338450,106990,170564.4,592200
237580,243113.5,930650,132730,81945.1,338450,104850,161168.4,592200
232840,225181.3,930650,130190,67520.5,338450,102650,157660.8,592200
228120,250275.4,930650,127660,81625.3,338450,100460,168650.1,592200
223410,317281.4,930650,125130,134995.3,338450,98280,182286.1,592200
217290,205767.5,930650,121050,54846.1,338450,96240,150921.4,592200
211180,278125,930650,116930,108586.5,338450,94250,169538.5,592200
205030,283606.1,930650,112860,113905.8,338450,92170,169700.3,592200
226850,256319.6,930650,122800,92225.5,338450,104050,164094.1,592200
219960,248542.2,930650,117690,89622.3,338450,102270,158919.9,592200
213010,249861.6,930650,112590,92702.5,338450,100420,157159.1,592200
206140,194454,930650,107490,67023,338450,98650,127431,592200
199170,196542.6,930650,102370,56125.7,338450,96800,140416.9,592200
192230,210235,930650,97510,53834.5,338450,94720,156400.5,592200
185310,202604.3,930650,92680,56115.7,338450,92630,146488.6,592200
178370,196071.7,930650,87830,58375.8,338450,90540,137695.9,592200
171370,186208.6,930650,82960,65072,338450,88410,121136.6,592200
166350,216943,930650,79830,69881.8,338450,86520,147061.2,592200
161250,232952.7,930650,76650,81944.4,338450,84600,151008.3,592200
156290,200000,930650,73490,81944.4,338450,82800,135000,592200
151160,186208.6,930650,70300,65072,338450,80860,121136.6,592200
144360,216160.9,930650,65470,69266.1,338450,78890,146894.8,592200
137560,232952.7,930650,60640,81944.4,338450,76920,151008.3,592200
130740,228197.8,930650,55800,75725.7,338450,74940,152472.1,592200
123920,163954.6,930650,50970,32083.4,338450,72950,131871.2,592200
118570,156505.9,930650,47600,22315.4,338450,70970,134190.5,592200
113170,157977.9,930650,44200,20490.5,338450,68970,137487.4,592200
107800,190430.9,930650,40830,41582.5,338450,66970,148848.4,592200
102500,265323.6,930650,37460,95670.2,338450,65040,169653.4,592200
97350,282122.8,930650,35530,107148.4,338450,61820,174974.4,592200
92270,260142,930650,33630,93945.4,338450,58640,166196.6,592200
87140,264638.7,930650,31710,98280.6,338450,55430,166358.1,592200
82080,234169.4,930650,29820,77774.2,338450,52260,156395.2,592200
79030,158646.6,930650,29880,28726.7,338450,49150,129919.9,592200
75970,145321.5,930650,29950,18364.1,338450,46020,126957.4,592200
72880,135141.1,930650,30010,17078.8,338450,42870,118062.3,592200
69770,125074.4,930650,30070,17385.7,338450,39700,107688.7,592200
65590,118107,930650,28890,20939.3,338450,36700,97167.7,592200
61440,134049.7,930650,27720,36086.1,338450,33720,97963.6,592200
57280,125707.1,930650,26530,32028.2,338450,30750,93678.9,592200
53090,116592.9,930650,25340,26597.9,338450,27750,89995,592200
50230,117111,930650,24080,28851.5,338450,26150,88259.5,592200
47460,118887.3,930650,22830,34360.4,338450,24630,84526.9,592200
44580,114993.5,930650,21580,33286.4,338450,23000,81707.1,592200
41720,104175.8,930650,20310,27572.9,338450,21410,76602.9,592200
39860,97279.2,930650,19970,23568.7,338450,19890,73710.5,592200
37910,95459.5,930650,19600,23032.9,338450,18310,72426.6,592200
35990,91068.4,930650,19270,20683.2,338450,16720,70385.2,592200
34040,91104.6,930650,18930,21263,338450,15110,69841.6,592200
32670,77595.5,930650,19010,20680.5,338450,13660,56915,592200
31420,73355.5,930650,19100,27034.7,338450,12320,46320.8,592200
30180,79784.5,930650,19220,31030.4,338450,10960,48754.1,592200
28900,83537.9,930650,19310,34733.2,338450,9590,48804.7,592200
34750,89090.3,930650,24640,40647.1,338450,10110,48443.2,592200
40580,99171.2,930650,29960,49355.6,338450,10620,49815.6,592200
46410,99054,930650,35300,52655.4,338450,11110,46398.6,592200
52320,99236.8,930650,40610,53606.1,338450,11710,45630.7,592200
58190,105775.8,930650,46170,60011.6,338450,12020,45764.2,592200
64060,112636.3,930650,51720,64551.2,338450,12340,48085.1,592200
70000,132613.8,930650,57270,78327.5,338450,12730,54286.3,592200
75930,146063.6,930650,62830,88815.4,338450,13100,57248.2,592200
81190,153014.3,930650,67410,95342.3,338450,13780,57672,592200
86410,156211.7,930650,71980,98620.3,338450,14430,57591.4,592200
91670,162905.7,930650,76560,103523,338450,15110,59382.7,592200
96900,164327.1,930650,81130,104698.9,338450,15770,59628.2,592200
103400,172609.7,930650,86350,112260.8,338450,17050,60348.9,592200
109850,191425,930650,91570,126669.5,338450,18280,64755.5,592200
116350,213782.2,930650,96780,143044,338450,19570,70738.2,592200
122850,227939,930650,101990,152772.5,338450,20860,75166.5,592200
127650,234808.6,930650,105600,158534.9,338450,22050,76273.7,592200
132440,241636.4,930650,109180,163258.2,338450,23260,78378.2,592200
137210,244085.6,930650,112780,164724.3,338450,24430,79361.3,592200
142060,248216.4,930650,116380,166580.1,338450,25680,81636.3,592200
146400,259130.4,930650,119860,175188.2,338450,26540,83942.2,592200
150790,260711.8,930650,123390,177912.1,338450,27400,82799.7,592200
155200,246230.4,930650,126900,169641.5,338450,28300,76588.9,592200
159520,240030.3,930650,130380,165209.2,338450,29140,74821.1,592200
163560,235998.5,930650,130460,162656,338450,33100,73342.5,592200
167600,230736.7,930650,130570,156914.4,338450,37030,73822.3,592200
171530,230142.4,930650,130650,153510.2,338450,40880,76632.2,592200
175500,241461.9,930650,130730,160424.1,338450,44770,81037.8,592200
180890,244070.8,930650,131790,159117.6,338450,49100,84953.2,592200
186330,243615.7,930650,132830,155330.3,338450,53500,88285.4,592200
191690,226690.7,930650,133870,155664.5,338450,57820,71026.2,592200
197100,224282.2,930650,134900,150674.6,338450,62200,73607.6,592200
202600,241229.8,930650,135910,155886.3,338450,66690,85343.5,592200
207960,262906.4,930650,136910,165911.1,338450,71050,96995.3,592200
213500,273465.6,930650,137940,170484.7,338450,75560,102980.9,592200
218940,283655,930650,138920,174355.2,338450,80020,109299.8,592200
226670,310148.6,930650,139820,188988.6,338450,86850,121160,592200
234380,338181.1,930650,140710,205051.6,338450,93670,133129.5,592200
242060,356751.5,930650,141580,214772.8,338450,100480,141978.7,592200
249830,353663.1,930650,142490,209514.1,338450,107340,144149,592200
257850,355959.5,930650,143740,207397.9,338450,114110,148561.6,592200
265890,355996.7,930650,144990,205061.3,338450,120900,150935.4,592200
273960,383034.5,930650,146280,224194.5,338450,127680,158840,592200
282010,411872.6,930650,147530,243177.7,338450,134480,168694.9,592200
288950,402001.5,930650,147680,233228.7,338450,141270,168772.8,592200
295950,410989.5,930650,147820,234284.6,338450,148130,176704.9,592200
302920,422292,930650,147970,239610.9,338450,154950,182681.1,592200
309850,420349.1,930650,148100,235802.5,338450,161750,184546.6,592200
316010,443074.1,930650,149880,246174.6,338450,166130,196899.5,592200
322180,413286.9,930650,151650,214205.4,338450,170530,199081.5,592200
328320,386887.2,930650,153440,186985,338450,174880,199902.2,592200
334480,359236.8,930650,155230,162446.4,338450,179250,196790.4,592200
340230,378457.3,930650,156900,171056.9,338450,183330,207400.4,592200
346050,376026.5,930650,158550,169439.8,338450,187500,206586.7,592200
351830,397563.6,930650,160200,178480.3,338450,191630,219083.3,592200
380210,440032.3,930650,174450,206215.8,338450,205760,233816.5,592200
385090,466058.3,930650,175400,216298.7,338450,209690,249759.6,592200
389940,473202.3,930650,176350,221588.7,338450,213590,251613.6,592200
394850,496508.6,930650,177290,236122.8,338450,217560,260385.8,592200
399720,482679.9,930650,178230,231015.8,338450,221490,251664.1,592200
402490,497396.8,930650,178490,239927.9,338450,224000,257468.9,592200
405300,494023.6,930650,178730,236714.5,338450,226570,257309.1,592200
408040,499534.8,930650,178940,240614.6,338450,229100,258920.2,592200
410850,518404.3,930650,179190,249022.7,338450,231660,269381.6,592200
414410,513402.6,930650,179760,231341.2,338450,234650,282061.4,592200
418050,497894.9,930650,180370,222880,338450,237680,275014.9,592200
421620,484924.3,930650,180930,214092.7,338450,240690,270831.6,592200
425250,501146.9,930650,181530,231349.6,338450,243720,269797.3,592200
429060,529855.2,930650,182900,253923,338450,246160,275932.2,592200
432870,513381.3,930650,184280,249292.5,338450,248590,264088.8,592200
436740,498177.4,930650,185690,245713.5,338450,251050,252463.9,592200
440570,521456.8,930650,187080,260285.9,338450,253490,261170.9,592200
437050,522726.8,930650,184950,260884.9,338450,252100,261841.9,592200
433630,501799.3,930650,182860,249212.7,338450,250770,252586.6,592200
430160,444990.1,930650,180730,212916.6,338450,249430,232073.5,592200
426710,404844.5,930650,178620,187775.8,338450,248090,217068.7,592200
425090,472769,930650,178380,224299.8,338450,246710,248469.2,592200
423450,535345.5,930650,178160,264475.4,338450,245290,270870.1,592200
421820,512785.7,930650,177900,248815.9,338450,243920,263969.8,592200
420170,513445.2,930650,177660,250410.1,338450,242510,263035.1,592200
417880,475718.2,930650,176230,229123.9,338450,241650,246594.3,592200
415540,422588.3,930650,174750,198659.2,338450,240790,223929.1,592200
413120,422746.7,930650,173290,191847.1,338450,239830,230899.6,592200
410820,425070.8,930650,171820,192876.5,338450,239000,232194.3,592200
413080,424741.5,930650,173970,192147.6,338450,239110,232593.9,592200
415420,390207,930650,176150,173386.2,338450,239270,216820.8,592200
417730,386766.5,930650,178310,169668.2,338450,239420,217098.3,592200
420060,380882.4,930650,180470,168979.4,338450,239590,211903,592200
421080,381443.9,930650,181330,169046.3,338450,239750,212397.6,592200
422050,389117.4,930650,182210,180693.7,338450,239840,208423.7,592200
423050,409124.7,930650,183070,194794.9,338450,239980,214329.8,592200
424060,403960,930650,183930,203370.5,338450,240130,200589.5,592200
425880,398737.8,930650,185240,206842.5,338450,240640,191895.3,592200
427640,378353.6,930650,186540,196769.9,338450,241100,181583.7,592200
429490,378556.9,930650,187840,193268.7,338450,241650,185288.2,592200
431230,380955.4,930650,189120,193656.4,338450,242110,187299,592200
435130,403396.3,930650,191350,200021.4,338450,243780,203374.9,592200
439030,423495.5,930650,193580,210560.5,338450,245450,212935,592200
442890,430204.6,930650,195830,215333.4,338450,247060,214871.2,592200
446800,406979.3,930650,198050,201935,338450,248750,205044.3,592200
449950,395430.6,930650,199550,196247.1,338450,250400,199183.5,592200
453150,380816.6,930650,201050,187282,338450,252100,193534.6,592200
456350,340544.7,930650,202540,157682.5,338450,253810,182862.2,592200
459570,341635.8,930650,204070,159543.5,338450,255500,182092.3,592200
462560,371527.2,930650,205720,184675.7,338450,256840,186851.5,592200
465730,369625.6,930650,207390,185434.6,338450,258340,184191,592200
468790,392460.7,930650,209050,195536,338450,259740,196924.7,592200
471840,405061.3,930650,210720,205414.9,338450,261120,199646.4,592200
471770,397148.7,930650,210380,201081,338450,261390,196067.7,592200
471550,393999.4,930650,210000,199036.1,338450,261550,194963.3,592200
471450,431000.4,930650,209660,224272.5,338450,261790,206727.9,592200
471250,449636,930650,209310,237056.1,338450,261940,212579.9,592200
471380,412604.5,930650,208960,211528.4,338450,262420,201076.1,592200
471560,409131.1,930650,208650,207950,338450,262910,201181.1,592200
471720,427664.8,930650,208300,219051,338450,263420,208613.8,592200
471850,439976,930650,207980,225842.5,338450,263870,214133.5,592200
470960,436230.8,930650,206990,224691.4,338450,263970,211539.4,592200
470150,439197.3,930650,206010,225312.8,338450,264140,213884.5,592200
469230,436945.6,930650,205030,220766.7,338450,264200,216178.9,592200
468420,437970.1,930650,204060,218186.2,338450,264360,219783.9,592200
469830,454358.3,930650,203730,229979.1,338450,266100,224379.2,592200
471320,457897,930650,203400,228812,338450,267920,229085,592200
472820,443836.8,930650,203090,216925.3,338450,269730,226911.5,592200
474230,446501.1,930650,202760,215467.9,338450,271470,231033.2,592200
475650,462360.8,930650,202070,222030.3,338450,273580,240330.5,592200
477080,519747.8,930650,201350,253834,338450,275730,265913.8,592200
478390,530975.4,930650,200610,251952.8,338450,277780,279022.6,592200
479810,502867,930650,199900,230053.4,338450,279910,272813.6,592200
481950,499879.8,930650,199780,212753.9,338450,282170,287125.9,592200
483930,496956.6,930650,199600,201949.4,338450,284330,295007.2,592200
486020,486004.1,930650,199440,188112.6,338450,286580,297891.5,592200
488050,445833.3,930650,199300,163483.9,338450,288750,282349.4,592200
484720,413020.2,930650,195960,142458.7,338450,288760,270561.5,592200
481290,403744.6,930650,192590,140166.1,338450,288700,263578.5,592200
477910,408825.6,930650,189270,145031.8,338450,288640,263793.8,592200
474520,407832.5,930650,185910,144724.7,338450,288610,263107.8,592200
469060,417572.8,930650,180150,148413.7,338450,288910,269159.1,592200
463590,422171.5,930650,174380,149878.6,338450,289210,272292.9,592200
458120,404136.4,930650,168610,147865.5,338450,289510,256270.9,592200
452700,407469.4,930650,162830,141903.3,338450,289870,265566.1,592200
451490,399928.5,930650,161240,130317.9,338450,290250,269610.6,592200
450310,410653.8,930650,159660,137470.4,338450,290650,273183.4,592200
449100,427213.4,930650,158040,150335.7,338450,291060,276877.7,592200
447910,418760.4,930650,156460,142885.6,338450,291450,275874.8,592200
440980,404244.3,930650,152830,132328.7,338450,288150,271915.6,592200
433970,413501,930650,149160,137403.3,338450,284810,276097.7,592200
427070,444574,930650,145500,152663.7,338450,281570,291910.3,592200
420020,456608.5,930650,141860,163022,338450,278160,293586.5,592200
412890,450205.3,930650,138620,155530.4,338450,274270,294674.9,592200
405590,426840.7,930650,135360,140774.6,338450,270230,286066.1,592200
398440,439308.1,930650,132100,154626.4,338450,266340,284681.7,592200
404320,434545,930650,124330,156913.7,338450,279990,277631.3,592200
399050,431380.4,930650,123160,154928,338450,275890,276452.4,592200
393750,426130,930650,122020,147121.9,338450,271730,279008.1,592200
388420,443919.6,930650,120850,161501.3,338450,267570,282418.3,592200
383130,410799.2,930650,119690,145833.3,338450,263440,264965.9,592200
369870,382201.4,930650,114290,126838,338450,255580,255363.4,592200
356580,391645.6,930650,108890,125859.1,338450,247690,265786.5,592200
343300,398260.7,930650,103490,130523.1,338450,239810,267737.6,592200
330070,388309.5,930650,98090,126588.4,338450,231980,261721.1,592200
318060,408382.7,930650,93560,126048.2,338450,224500,282334.5,592200
306010,378080.4,930650,89050,110004.8,338450,216960,268075.6,592200
293950,367939.7,930650,84540,93314.9,338450,209410,274624.8,592200
281960,373131.8,930650,80010,100242.9,338450,201950,272888.9,592200
270200,367070.1,930650,75850,101728.1,338450,194350,265342,592200
258470,362179.4,930650,71700,95621.4,338450,186770,266558,592200
246670,354550.2,930650,67540,93252.8,338450,179130,261297.4,592200
234960,345731.3,930650,63420,93227.6,338450,171540,252503.7,592200
225200,325902.5,930650,60790,89437.6,338450,164410,236464.9,592200
215440,302334.9,930650,58190,71056.5,338450,157250,231278.4,592200
205690,302124,930650,55580,71915.1,338450,150110,230208.9,592200
195950,294207.3,930650,52960,72475.1,338450,142990,221732.2,592200
186310,273974,930650,50600,65844.8,338450,135710,208129.2,592200
176680,251161.6,930650,48220,54218.5,338450,128460,196943.1,592200
167040,241017.2,930650,45860,52536.1,338450,121180,188481.1,592200
157490,220101.8,930650,43500,47194.3,338450,113990,172907.5,592200
148110,206092.1,930650,40990,46734,338450,107120,159358.1,592200
138770,189802,930650,38480,37727,338450,100290,152075,592200
129370,179577.2,930650,35990,34687.1,338450,93380,144890.1,592200
120060,172240.6,930650,33480,32199,338450,86580,140041.6,592200
116810,171545.9,930650,32550,37227.3,338450,84260,134318.6,592200
113410,158576.2,930650,31590,30072,338450,81820,128504.2,592200
110180,145879.9,930650,30650,25958.3,338450,79530,119921.6,592200
106830,148825.9,930650,29700,27655.8,338450,77130,121170.1,592200
103970,156699.1,930650,28970,31275.5,338450,75000,125423.6,592200
101040,163150.3,930650,28250,39130.1,338450,72790,124020.2,592200
98230,170877.5,930650,27530,44349.2,338450,70700,126528.3,592200
95310,154876.7,930650,26810,34823.5,338450,68500,120053.2,592200
93040,145002.4,930650,26110,36040,338450,66930,108962.4,592200
90770,161696.8,930650,25420,51146.2,338450,65350,110550.6,592200
88580,171500.9,930650,24740,56844.3,338450,63840,114656.6,592200
86340,144970.1,930650,24060,36548.8,338450,62280,108421.3,592200
86390,159463.8,930650,23770,45040.4,338450,62620,114423.4,592200
86480,168680.3,930650,23500,47633.8,338450,62980,121046.5,592200
86560,173426,930650,23200,53170.1,338450,63360,120255.9,592200
86590,178434.2,930650,22930,57992.6,338450,63660,120441.6,592200
86250,162042.7,930650,22470,50234.4,338450,63780,111808.3,592200
85890,182400.6,930650,22010,65671.9,338450,63880,116728.7,592200
85530,180023.7,930650,21580,63837.9,338450,63950,116185.8,592200
85200,189502.2,930650,21130,68286.6,338450,64070,121215.6,592200
84880,192219.5,930650,20760,67644.7,338450,64120,124574.8,592200
84480,179984.9,930650,20400,60885.7,338450,64080,119099.2,592200
84160,171149.1,930650,20020,57790.3,338450,64140,113358.8,592200
83840,176588.5,930650,19670,59863.7,338450,64170,116724.8,592200
83520,187264.3,930650,20820,62479.1,338450,62700,124785.2,592200
83300,195523.2,930650,21960,54070.1,338450,61340,141453.1,592200
83080,150199.6,930650,23130,46442,338450,59950,103757.6,592200
82880,144097.5,930650,24300,43514.2,338450,58580,100583.3,592200
82760,159702.2,930650,25540,44725.5,338450,57220,114976.7,592200
82630,154900.5,930650,26760,43482.6,338450,55870,111417.9,592200
82480,144175.1,930650,28000,38571.5,338450,54480,105603.6,592200
82350,141246.5,930650,29230,35171.8,338450,53120,106074.7,592200
82140,145698.1,930650,30470,40359.7,338450,51670,105338.4,592200
81970,147670.4,930650,31710,44531.3,338450,50260,103139.1,592200
81720,147543.1,930650,32910,45575.8,338450,48810,101967.3,592200
81500,147050.7,930650,34160,45107.1,338450,47340,101943.6,592200
82290,148187.3,930650,34190,44774.1,338450,48100,103413.2,592200
83120,143875.8,930650,34290,42423.1,338450,48830,101452.7,592200
83920,150173,930650,34350,45318.4,338450,49570,104854.6,592200
84790,151911.9,930650,34430,45638.7,338450,50360,106273.2,592200
86340,151879,930650,34740,43466.3,338450,51600,108412.7,592200
87840,152548.4,930650,35030,44273.6,338450,52810,108274.8,592200
89340,147591.7,930650,35340,40466.2,338450,54000,107125.5,592200
90890,155704.5,930650,35620,46343.1,338450,55270,109361.4,592200
92520,160676,930650,36080,48851.1,338450,56440,111824.9,592200
94210,168848.8,930650,36550,51055.5,338450,57660,117793.3,592200
95900,172699.6,930650,37020,53057.3,338450,58880,119642.3,592200
97600,175336,930650,37500,55046.3,338450,60100,120289.7,592200
101280,169028.1,930650,39390,53382.1,338450,61890,115646,592200
104960,171278.2,930650,41310,56595,338450,63650,114683.2,592200
108680,157217.5,930650,43230,46524.5,338450,65450,110693,592200
112340,154252.7,930650,45140,41905.5,338450,67200,112347.2,592200
116190,180138.3,930650,47350,59054.3,338450,68840,121084,592200
120060,187609.8,930650,49570,61821.8,338450,70490,125788,592200
123910,205189.7,930650,51770,71739.1,338450,72140,133450.6,592200
127750,194925.4,930650,53990,64571.8,338450,73760,130353.6,592200
132240,184910.5,930650,56350,56704.2,338450,75890,128206.3,592200
136800,197240.1,930650,58740,64264.2,338450,78060,132975.9,592200
141290,210542.6,930650,61080,75429.4,338450,80210,135113.2,592200
145770,221280,930650,63440,81058.5,338450,82330,140221.5,592200
153310,196856.2,930650,68250,81370.5,338450,85060,115485.7,592200
160830,201536.2,930650,73030,79741.9,338450,87800,121794.3,592200
168410,190117.5,930650,77820,71954.3,338450,90590,118163.2,592200
175960,208201.4,930650,82630,80293.8,338450,93330,127907.6,592200
183590,218644.8,930650,87230,95940,338450,96360,122704.8,592200
191270,216504.9,930650,91840,92111.7,338450,99430,124393.2,592200
198890,206605.1,930650,96470,88073.6,338450,102420,118531.5,592200
204360,209336.1,930650,106620,95594.2,338450,97740,113741.9,592200
214420,217076.6,930650,112340,102640,338450,102080,114436.6,592200
224490,217514.9,930650,118080,102259.3,338450,106410,115255.6,592200
234440,264226.5,930650,123780,129074,338450,110660,135152.5,592200
244520,245164.8,930650,129500,117127.9,338450,115020,128036.9,592200
248720,219708.4,930650,130940,99350.5,338450,117780,120357.9,592200
252860,205106.7,930650,132360,90330.4,338450,120500,114776.3,592200
257060,199708.4,930650,133800,85502.9,338450,123260,114205.5,592200
261240,224915,930650,135250,98503.2,338450,125990,126411.8,592200
265130,276827.2,930650,136500,137604.8,338450,128630,139222.4,592200
268970,299210,930650,137760,151360.5,338450,131210,147849.5,592200
272900,295939.4,930650,139030,145100.6,338450,133870,150838.8,592200
276700,305400.9,930650,140250,147132,338450,136450,158268.9,592200
281610,315805.9,930650,142150,154366.7,338450,139460,161439.2,592200
286310,301855.1,930650,144020,146768.3,338450,142290,155086.8,592200
291090,330065.5,930650,145890,163473.3,338450,145200,166592.2,592200
295900,360590.7,930650,147770,179152,338450,148130,181438.7,592200
303660,363753.3,930650,152030,176526.6,338450,151630,187226.7,592200
311440,372308.1,930650,156270,183370.4,338450,155170,188937.7,592200
319130,410994.7,930650,160520,210406.9,338450,158610,200587.8,592200
326890,418997.8,930650,164780,213814.3,338450,162110,205183.5,592200
334410,367488.6,930650,168860,178022,338450,165550,189466.6,592200
341870,335455.9,930650,172950,153581.8,338450,168920,181874.1,592200
349390,369031.6,930650,177020,182584.5,338450,172370,186447.1,592200
356860,365105,930650,181090,183479.5,338450,175770,181625.5,592200
364400,367746.6,930650,184860,186146.3,338450,179540,181600.3,592200
372030,364801.9,930650,188590,181692.2,338450,183440,183109.7,592200
379590,434067.5,930650,192340,229267.3,338450,187250,204800.2,592200
387190,444198.8,930650,196090,236763.1,338450,191100,207435.7,592200
388300,429593.5,930650,197370,225975.2,338450,190930,203618.3,592200
389320,393176.3,930650,198620,198954,338450,190700,194222.3,592200
390410,356595.3,930650,199900,163074.1,338450,190510,193521.2,592200
391490,368721.4,930650,201150,161003,338450,190340,207718.4,592200
391910,389889.8,930650,202260,181970.9,338450,189650,207918.9,592200
392470,399358.9,930650,203380,193174.2,338450,189090,206184.7,592200
392920,411048.1,930650,204490,203884,338450,188430,207164.1,592200
393490,423212.9,930650,205630,217730.2,338450,187860,205482.7,592200
392690,407804,930650,206730,218128.6,338450,185960,189675.4,592200
391900,392449.2,930650,207830,213742.4,338450,184070,178706.8,592200
391120,351721,930650,208950,187791.6,338450,182170,163929.4,592200
390310,332116.3,930650,210040,176354.3,338450,180270,155762,592200
385210,343783.6,930650,208250,184070.1,338450,176960,159713.5,592200
380080,385798.8,930650,206450,202790.9,338450,173630,183007.9,592200
374960,391909.8,930650,204660,204444.1,338450,170300,187465.7,592200
369780,389540.7,930650,202840,194924.3,338450,166940,194616.4,592200
369410,369534.6,930650,201530,181196.4,338450,167880,188338.2,592200
369060,386988.8,930650,200200,186845.9,338450,168860,200142.9,592200
368660,400607.2,930650,198920,190521.1,338450,169740,210086.1,592200
368320,421533.5,930650,197590,199059.7,338450,170730,222473.8,592200
366650,444340.9,930650,196360,210496.4,338450,170290,233844.5,592200
364980,442310.1,930650,195120,207722.4,338450,169860,234587.7,592200
363360,435416.2,930650,193900,214965,338450,169460,220451.2,592200
361750,421529.3,930650,192670,208379,338450,169080,213150.3,592200
360670,417525.7,930650,192400,214247.6,338450,168270,203278.1,592200
359650,415197.1,930650,192120,217146.5,338450,167530,198050.6,592200
358600,431249,930650,191860,225675.6,338450,166740,205573.4,592200
357540,445993.2,930650,191570,229949.5,338450,165970,216043.7,592200
356300,464182.3,930650,190010,235068.3,338450,166290,229114,592200
355080,479726.9,930650,188440,234291.6,338450,166640,245435.3,592200
353830,459386.7,930650,186890,223614.9,338450,166940,235771.8,592200
352600,451035.1,930650,185330,213615.8,338450,167270,237419.3,592200
353180,448987.3,930650,184400,211447.8,338450,168780,237539.5,592200
353830,445466,930650,183540,213138.8,338450,170290,232327.2,592200
354480,451612.9,930650,182620,212800,338450,171860,238812.9,592200
355080,433077.5,930650,181700,202787.4,338450,173380,230290.1,592200
368190,422359.9,930650,186110,205864.1,338450,182080,216495.8,592200
381300,412863.4,930650,190530,207427.5,338450,190770,205435.9,592200
394450,432217.5,930650,194930,210050.3,338450,199520,222167.2,592200
407580,452822.9,930650,199360,212848,338450,208220,239974.9,592200
421480,472627.5,930650,204620,220171.6,338450,216860,252455.9,592200
435430,493960.2,930650,209900,230273.8,338450,225530,263686.4,592200
449370,518207.2,930650,215170,239028.6,338450,234200,279178.6,592200
463250,526979.8,930650,220430,239373.1,338450,242820,287606.7,592200
477200,533868.4,930650,225050,249906.2,338450,252150,283962.2,592200
491130,532664.1,930650,229650,247394.5,338450,261480,285269.6,592200
505040,516985.1,930650,234240,237509.7,338450,270800,279475.4,592200
519020,526324.3,930650,238860,239156.9,338450,280160,287167.4,592200
521690,547798.2,930650,239970,242194.5,338450,281720,305603.7,592200
524440,561042.3,930650,241100,244312,338450,283340,316730.3,592200
527170,580993.8,930650,242230,250411.1,338450,284940,330582.7,592200
529920,593298.7,930650,243370,263578.3,338450,286550,329720.4,592200
531720,584459.1,930650,244060,260574.2,338450,287660,323884.9,592200
533470,571491,930650,244740,257177.4,338450,288730,314313.6,592200
535230,564738,930650,245400,260765.2,338450,289830,303972.8,592200
537060,585334.7,930650,246100,270487,338450,290960,314847.7,592200
539240,611844.1,930650,247520,277926.3,338450,291720,333917.8,592200
541470,620288.7,930650,248990,285283,338450,292480,335005.7,592200
543730,623962.6,930650,250430,289038.9,338450,293300,334923.7,592200
545970,629959.6,930650,251860,290708.9,338450,294110,339250.7,592200
546320,633188.2,930650,252600,286837.4,338450,293720,346350.8,592200
546650,630468.5,930650,253300,286911.5,338450,293350,343557,592200
546870,613932.9,930650,254000,275646.7,338450,292870,338286.2,592200
547220,604132.1,930650,254730,270755.6,338450,292490,333376.5,592200
547280,596048.7,930650,255130,266579.5,338450,292150,329469.2,592200
547330,597210.5,930650,255580,270980,338450,291750,326230.5,592200
547420,601793.1,930650,256010,278215.3,338450,291410,323577.8,592200
604260,598407.3,930650,269170,279254.6,338450,335090,319152.7,592200
604280,590810.8,930650,269360,277456.9,338450,334920,313353.9,592200
604410,592221.2,930650,269560,276686.5,338450,334850,315534.7,592200
604470,599424.5,930650,269740,279580.1,338450,334730,319844.4,592200
604520,580573,930650,269930,278139.7,338450,334590,302433.3,592200
607750,581615,930650,270580,278997.5,338450,337170,302617.5,592200
611020,580462.1,930650,271260,273422.5,338450,339760,307039.6,592200
614210,584072.7,930650,271930,279123.7,338450,342280,304949,592200
617530,588767,930650,272600,284532.9,338450,344930,304234.1,592200
620800,588912.4,930650,273190,284740.1,338450,347610,304172.3,592200
624100,591679.6,930650,273820,287904.2,338450,350280,303775.4,592200
627390,604591,930650,274450,289453.3,338450,352940,315137.7,592200
630660,612944.9,930650,275050,287967.2,338450,355610,324977.7,592200
633920,627362.3,930650,275800,288136.8,338450,358120,339225.5,592200
637200,632139.1,930650,276540,285491.1,338450,360660,346648,592200
640440,611434.9,930650,277270,284326.9,338450,363170,327108,592200
643690,595005.7,930650,278030,281034.3,338450,365660,313971.4,592200
650700,611485.9,930650,279450,285922.3,338450,371250,325563.6,592200
657760,628995.3,930650,280880,285426.9,338450,376880,343568.4,592200
664730,639413.8,930650,282310,283178.1,338450,382420,356235.7,592200
671820,641945.3,930650,283750,279541,338450,388070,362404.3,592200
679390,653487.8,930650,285160,285131.1,338450,394230,368356.7,592200
686980,683062.3,930650,286570,293837,338450,400410,389225.3,592200
694550,693581.6,930650,287990,291499.1,338450,406560,402082.5,592200
702100,702203.2,930650,289370,289608.1,338450,412730,412595.1,592200
709220,704265,930650,290800,285352.6,338450,418420,418912.4,592200
716230,724234.4,930650,292210,293690.6,338450,424020,430543.8,592200
723320,730243.2,930650,293650,299993.7,338450,429670,430249.5,592200
730440,734712.1,930650,295070,302550.3,338450,435370,432161.8,592200
725790,751957,930650,289940,304871.4,338450,435850,447085.6,592200
721020,748701.7,930650,284800,306587.9,338450,436220,442113.8,592200
716320,747768.9,930650,279670,305164.7,338450,436650,442604.2,592200
711660,758473.5,930650,274540,306022.3,338450,437120,452451.2,592200
706390,768220.7,930650,269140,305829.5,338450,437250,462391.2,592200
701190,763370,930650,263740,306407.9,338450,437450,456962.1,592200
696000,751490.9,930650,258350,305457.6,338450,437650,446033.3,592200
690700,750274.9,930650,252940,295396.8,338450,437760,454878.1,592200
682130,663182,930650,244120,231489.2,338450,438010,431692.8,592200
673490,618874.2,930650,235290,195752.7,338450,438200,423121.5,592200
664930,576762.6,930650,226510,170880.9,338450,438420,405881.7,592200
656330,569742.9,930650,217670,168833.4,338450,438660,400909.5,592200
651250,649492.7,930650,217160,228057.2,338450,434090,421435.5,592200
646180,705795.3,930650,216650,262798.2,338450,429530,442997.1,592200
641080,680258.5,930650,216110,250100.6,338450,424970,430157.9,592200
636040,661105.7,930650,215610,247161.3,338450,420430,413944.4,592200
628430,622571.2,930650,213980,235031.8,338450,414450,387539.4,592200
620850,571722.4,930650,212360,208186.5,338450,408490,363535.9,592200
613240,574012.6,930650,210740,211028,338450,402500,362984.6,592200
605690,583305.8,930650,209130,222582.4,338450,396560,360723.4,592200
598030,547028.4,930650,207600,219831.5,338450,390430,327196.9,592200
590500,551789.9,930650,206090,237404.1,338450,384410,314385.8,592200
582980,558916.6,930650,204590,256197.9,338450,378390,302718.7,592200
575380,595459.5,930650,203100,271388.3,338450,372280,324071.2,592200
570230,563676.1,930650,201980,252059.6,338450,368250,311616.5,592200
565020,568233.8,930650,200850,242707.4,338450,364170,325526.4,592200
559920,524080.8,930650,199740,197075.9,338450,360180,327004.9,592200
554660,548891.4,930650,198640,226586.7,338450,356020,322304.7,592200
554080,581097.8,930650,200530,241271.1,338450,353550,339826.7,592200
553570,572063.8,930650,202430,248634.1,338450,351140,323429.7,592200
553020,592484.8,930650,204350,254260.7,338450,348670,338224.1,592200
552420,560791.5,930650,206220,239116,338450,346200,321675.5,592200
550680,588525.1,930650,205980,239137.7,338450,344700,349387.4,592200
548980,634511.3,930650,205750,261163.5,338450,343230,373347.8,592200
547250,630224.7,930650,205500,262955.9,338450,341750,367268.8,592200
545480,592602.3,930650,205260,250564.9,338450,340220,342037.4,592200
548280,518779.1,930650,207380,208950.4,338450,340900,309828.7,592200
551150,483536.1,930650,209560,181605.1,338450,341590,301931,592200
553960,493619,930650,211680,179193.2,338450,342280,314425.8,592200
556760,561909.1,930650,213830,218181.1,338450,342930,343728,592200
560220,622340.2,930650,216000,255313.1,338450,344220,367027.1,592200
563600,668957.2,930650,218170,258918.8,338450,345430,410038.4,592200
567060,668361.1,930650,220360,251831,338450,346700,416530.1,592200
570460,699516.4,930650,222510,277988.7,338450,347950,421527.7,592200
573660,657874.6,930650,224110,280948.3,338450,349550,376926.3,592200
576930,646282.4,930650,225660,281426.8,338450,351270,364855.6,592200
580150,659120.8,930650,227230,288580.3,338450,352920,370540.5,592200
583350,647071.1,930650,228800,283643.5,338450,354550,363427.6,592200
584270,661183.1,930650,228980,278964.5,338450,355290,382218.6,592200
585130,661845.9,930650,229180,277581,338450,355950,384264.9,592200
585940,659892,930650,229360,277533.5,338450,356580,382358.5,592200
586850,653125.1,930650,229550,270080,338450,357300,383045.1,592200
586620,664566.1,930650,229180,267332,338450,357440,397234.1,592200
586480,663231.5,930650,228860,266376.7,338450,357620,396854.8,592200
586260,677873,930650,228500,279966,338450,357760,397907,592200
586110,658258.1,930650,228150,264262,338450,357960,393996.1,592200
585300,645189.1,930650,227360,242910,338450,357940,402279.1,592200
584440,628066,930650,226560,250764.6,338450,357880,377301.4,592200
583620,598316.5,930650,225780,239266.7,338450,357840,359049.8,592200
582750,591502.9,930650,224990,230803.7,338450,357760,360699.2,592200
586020,603081.8,930650,226630,229370.4,338450,359390,373711.4,592200
589290,595293.2,930650,228250,220876.5,338450,361040,374416.7,592200
592550,611733.9,930650,229890,234570.8,338450,362660,377163.1,592200
595820,628164.8,930650,231550,245448.3,338450,364270,382716.5,592200
599820,662012.2,930650,233380,266230.4,338450,366440,395781.8,592200
603850,666122.1,930650,235250,269455.8,338450,368600,396666.3,592200
607910,665997,930650,237090,275162.3,338450,370820,390834.7,592200
714310,677958.8,930650,281450,284221.7,338450,432860,393737.1,592200
716420,692021.4,930650,282540,283922.2,338450,433880,408099.2,592200
718460,695300.9,930650,283600,279262.7,338450,434860,416038.2,592200
720580,682355,930650,284690,264519.1,338450,435890,417835.9,592200
722580,676567.7,930650,285730,264152.9,338450,436850,412414.8,592200
725190,683972.3,930650,286280,269647.9,338450,438910,414324.4,592200
727680,693774.6,930650,286790,270365.9,338450,440890,423408.7,592200
730230,718196.7,930650,287320,270738.8,338450,442910,447457.9,592200
732800,724791.1,930650,287850,273185.1,338450,444950,451606,592200
735870,728229.8,930650,288720,283130.7,338450,447150,445099.1,592200
738970,720887.9,930650,289600,283037.6,338450,449370,437850.3,592200
741980,719669.2,930650,290460,292881.2,338450,451520,426788,592200
745050,733422.5,930650,291330,293849.1,338450,453720,439573.4,592200
747470,735100.4,930650,291840,292572.1,338450,455630,442528.3,592200
749880,702704.1,930650,292310,287892.3,338450,457570,414811.8,592200
752290,672857.7,930650,292810,273760.4,338450,459480,399097.3,592200
754730,696366.3,930650,293270,283197.7,338450,461460,413168.6,592200
756220,718381.5,930650,294100,295993.7,338450,462120,422387.8,592200
757610,735052,930650,294860,302172.2,338450,462750,432879.8,592200
759060,725891,930650,295700,299997.6,338450,463360,425893.4,592200
760510,725652.7,930650,296500,295583.2,338450,464010,430069.5,592200
760980,723878,930650,296790,295659,338450,464190,428219,592200
761460,732081.7,930650,297090,304133.6,338450,464370,427948.1,592200
761940,734594.2,930650,297370,299621.4,338450,464570,434972.8,592200
762440,735256.1,930650,297700,296904.8,338450,464740,438351.3,592200
762220,737327.2,930650,297510,296066.2,338450,464710,441261,592200
762050,726704.2,930650,297320,288870.3,338450,464730,437833.9,592200
761870,723709.2,930650,297140,285177.7,338450,464730,438531.5,592200
761630,733730.6,930650,296940,285323.2,338450,464690,448407.4,592200
760880,731574.3,930650,296360,280428.4,338450,464520,451145.9,592200
760090,729212.6,930650,295760,267663.5,338450,464330,461549.1,592200
759330,738864.6,930650,295160,267170.4,338450,464170,471694.2,592200
758570,737037.6,930650,294580,273529.3,338450,463990,463508.3,592200
757890,724607,930650,293650,273382.6,338450,464240,451224.4,592200
757160,741705.6,930650,292720,291110.4,338450,464440,450595.2,592200
756520,734747.8,930650,291800,292669.9,338450,464720,442077.9,592200
755800,744997,930650,290860,296876.7,338450,464940,448120.3,592200
756720,749361.1,930650,291550,299813.5,338450,465170,449547.6,592200
757600,741433,930650,292260,295996.1,338450,465340,445436.9,592200
758520,723952.5,930650,292970,290384.4,338450,465550,433568.1,592200
759400,712279.1,930650,293670,291268.5,338450,465730,421010.6,592200
753240,696182.1,930650,290120,287888.1,338450,463120,408294,592200
747230,672502.6,930650,286580,273625.6,338450,460650,398877,592200
741170,672039.6,930650,283040,271879.3,338450,458130,400160.3,592200
735150,675291.9,930650,279480,269799,338450,455670,405492.9,592200
731560,682795.4,930650,278310,271895,338450,453250,410900.4,592200
728030,682484.7,930650,277100,273662.4,338450,450930,408822.3,592200
724490,673671.4,930650,275930,269463.2,338450,448560,404208.2,592200
720950,646844.6,930650,274730,256239.4,338450,446220,390605.2,592200
716660,637842.1,930650,272750,246114.6,338450,443910,391727.5,592200
712280,635324.3,930650,270730,259347.8,338450,441550,375976.5,592200
707920,654047.5,930650,268740,264842,338450,439180,389205.5,592200
703660,653907.8,930650,266740,252292.5,338450,436920,401615.3,592200
688180,673267.1,930650,260230,265999,338450,427950,407268.1,592200
672790,648394.7,930650,253720,264854.4,338450,419070,383540.3,592200
657450,616097.7,930650,247230,247677.4,338450,410220,368420.3,592200
642020,600191,930650,240720,238372,338450,401300,361819,592200
626430,572607.4,930650,234250,232570.2,338450,392180,340037.2,592200
610900,552251.2,930650,227790,223429.6,338450,383110,328821.6,592200
595340,581818.8,930650,221330,241733.1,338450,374010,340085.7,592200
579720,575324.6,930650,214870,235631.5,338450,364850,339693.1,592200
560850,537970.7,930650,207400,222805.3,338450,353450,315165.4,592200
541910,550987.6,930650,199940,235188.9,338450,341970,315798.7,592200
523040,535114.3,930650,192480,236342.1,338450,330560,298772.2,592200
504080,526937.7,930650,185000,242286.8,338450,319080,284650.9,592200
496420,512914.9,930650,184240,237881.2,338450,312180,275033.7,592200
488660,512049.9,930650,183450,240619.1,338450,305210,271430.8,592200
480950,506486.2,930650,182670,239085.3,338450,298280,267400.9,592200
473190,520354.4,930650,181890,245572.1,338450,291300,274782.3,592200
467780,504777,930650,180710,232006.2,338450,287070,272770.8,592200
462360,492680.6,930650,179520,229814.4,338450,282840,262866.2,592200
456960,499118.7,930650,178340,216823.8,338450,278620,282294.9,592200
451500,491635.8,930650,177160,216682,338450,274340,274953.8,592200
448980,466588.6,930650,178360,204488.5,338450,270620,262100.1,592200
446430,451983,930650,179540,204229.7,338450,266890,247753.3,592200
443850,411040.5,930650,180780,186074.1,338450,263070,224966.4,592200
441330,452250.8,930650,182000,209975.7,338450,259330,242275.1,592200
451170,451499.1,930650,185150,209130.7,338450,266020,242368.4,592200
460940,477878.9,930650,188290,217454.3,338450,272650,260424.6,592200
470740,531016.9,930650,191470,226859.2,338450,279270,304157.7,592200
480570,548508.3,930650,194620,232440.2,338450,285950,316068.1,592200
490460,539508.9,930650,197170,223798.6,338450,293290,315710.3,592200
500410,552937.8,930650,199720,229810.1,338450,300690,323127.7,592200
510260,569623.2,930650,202280,234652.2,338450,307980,334971,592200
520200,577175.3,930650,204830,238717.2,338450,315370,338458.1,592200
530100,572230.4,930650,208320,234889.6,338450,321780,337340.8,592200
540060,619719.2,930650,211780,252624.6,338450,328280,367094.6,592200
550000,640160.4,930650,215270,265748.5,338450,334730,374411.9,592200
559940,634310.6,930650,218730,264964.8,338450,341210,369345.8,592200
562070,595401.5,930650,219620,242832.8,338450,342450,352568.7,592200
564170,593300.8,930650,220540,237634.5,338450,343630,355666.3,592200
566220,567508.3,930650,221440,223734.5,338450,344780,343773.8,592200
568330,541718,930650,222320,200744,338450,346010,340974,592200
571430,521551,930650,223670,185048.5,338450,347760,336502.5,592200
574580,484711,930650,225010,167770.3,338450,349570,316940.7,592200
577760,472401.6,930650,226380,167276.5,338450,351380,305125.1,592200
606610,495971.9,930650,246560,186652.7,338450,360050,309319.2,592200
601090,520932.4,930650,245140,221070.9,338450,355950,299861.5,592200
595550,529420.9,930650,243710,231959.2,338450,351840,297461.7,592200
589950,506021.8,930650,242280,218388.7,338450,347670,287633.1,592200
584380,474926.1,930650,240850,203268.6,338450,343530,271657.5,592200
577600,480692.5,930650,238670,201747.8,338450,338930,278944.7,592200
570790,486377.2,930650,236530,204324,338450,334260,282053.2,592200
563930,442850.2,930650,234350,189221.3,338450,329580,253628.9,592200
557140,445158.6,930650,232180,196762.1,338450,324960,248396.5,592200
551370,412957.2,930650,230980,178321,338450,320390,234636.2,592200
545680,396510.3,930650,229770,180099,338450,315910,216411.3,592200
539960,422238,930650,228570,196855.3,338450,311390,225382.7,592200
534240,443941.8,930650,227370,209358.4,338450,306870,234583.4,592200
526760,482245.6,930650,224190,230487.7,338450,302570,251757.9,592200
519260,448587.7,930650,221010,212958.9,338450,298250,235628.8,592200
511710,447447.5,930650,217810,204785.3,338450,293900,242662.2,592200
504170,456655.6,930650,214640,206765.9,338450,289530,249889.7,592200
500350,453508.7,930650,213370,212098.4,338450,286980,241410.3,592200
496410,422179.8,930650,212090,189895,338450,284320,232284.8,592200
492520,459250,930650,210820,222683.3,338450,281700,236566.7,592200
488600,474728.6,930650,209530,229174.2,338450,279070,245554.4,592200
483700,459340,930650,208290,208421.3,338450,275410,250918.7,592200
478760,444341,930650,207030,190794.6,338450,271730,253546.4,592200
473790,403088,930650,205780,164039.2,338450,268010,239048.8,592200
468920,401310,930650,204540,163284.3,338450,264380,238025.7,592200
463000,404021.3,930650,202930,169699.3,338450,260070,234322,592200
457000,439737.2,930650,201290,201993.1,338450,255710,237744.1,592200
451080,475136.8,930650,199720,235766.5,338450,251360,239370.3,592200
445180,478573.7,930650,198120,238155.4,338450,247060,240418.3,592200
446340,478707,930650,199440,239274.2,338450,246900,239432.8,592200
447500,458543.7,930650,200810,229034.9,338450,246690,229508.8,592200
448620,366953.2,930650,202170,157006.4,338450,246450,209946.8,592200
449760,388025.3,930650,203520,169197.8,338450,246240,218827.5,592200
451350,372023.4,930650,205130,167035.4,338450,246220,204988,592200
452950,323523.3,930650,206750,144335.1,338450,246200,179188.2,592200
454500,324089.2,930650,208360,137756.7,338450,246140,186332.5,592200
456150,264824.5,930650,210000,95555.9,338450,246150,169268.6,592200
456080,266091.6,930650,210900,91697.8,338450,245180,174393.8,592200
456030,234364.6,930650,211800,81559.8,338450,244230,152804.8,592200
455970,240401.4,930650,212670,75386.4,338450,243300,165015,592200
455860,289064,930650,213580,108073.6,338450,242280,180990.4,592200
459050,326679.9,930650,215620,144017.7,338450,243430,182662.2,592200
462220,291492.2,930650,217630,130032.5,338450,244590,161459.7,592200
465430,233476.4,930650,219660,84940.1,338450,245770,148536.3,592200
468540,240371.3,930650,221670,78400.2,338450,246870,161971.1,592200
470670,235692.4,930650,223470,54759.4,338450,247200,180933,592200
472760,260303.1,930650,225290,72563.6,338450,247470,187739.5,592200
474830,342776.7,930650,227080,114153.8,338450,247750,228622.9,592200
476990,407419.3,930650,228910,155982.1,338450,248080,251437.2,592200
479620,448362.6,930650,230550,191233.4,338450,249070,257129.2,592200
482300,516110.6,930650,232200,228121.5,338450,250100,287989.1,592200
484940,541549.4,930650,233870,244414.5,338450,251070,297134.9,592200
487630,558363.3,930650,235530,243980.3,338450,252100,314383,592200
484210,586465.2,930650,233200,245769.8,338450,251010,340695.4,592200
480830,594872.4,930650,230860,256538.7,338450,249970,338333.7,592200
477460,608623.5,930650,228540,271025.6,338450,248920,337597.9,592200
474050,608156,930650,226230,270507,338450,247820,337649,592200
470240,592756.5,930650,224580,273755.6,338450,245660,319000.9,592200
466440,553507.5,930650,222930,260305.2,338450,243510,293202.3,592200
462580,543602.8,930650,221270,250533.9,338450,241310,293068.9,592200
458730,511537.1,930650,219620,231920.2,338450,239110,279616.9,592200
455260,483130.3,930650,218060,230024.4,338450,237200,253105.9,592200
451790,474553.3,930650,216490,232137.9,338450,235300,242415.4,592200
448310,463440.9,930650,214910,233797.1,338450,233400,229643.8,592200
444790,458276.8,930650,213350,234271.5,338450,231440,224005.3,592200
442500,437185.5,930650,211440,223882.4,338450,231060,213303.1,592200
440270,408363.1,930650,209530,215914.2,338450,230740,192448.9,592200
438020,408066.7,930650,207650,217617.7,338450,230370,190449,592200
435640,409287,930650,205710,214504.7,338450,229930,194782.3,592200
433800,409356.7,930650,203560,211257.7,338450,230240,198099,592200
431920,389771.9,930650,201380,191745.4,338450,230540,198026.5,592200
430140,371199.4,930650,199230,173623.1,338450,230910,197576.3,592200
428310,382869.4,930650,197060,180710.8,338450,231250,202158.6,592200
428830,389310.5,930650,196290,184999.9,338450,232540,204310.6,592200
429330,360317.6,930650,195490,173065.4,338450,233840,187252.2,592200
429850,342016.9,930650,194710,165371.1,338450,235140,176645.8,592200
430390,358306.3,930650,193930,172038.9,338450,236460,186267.4,592200
426570,334082.1,930650,192470,148089.1,338450,234100,185993,592200
422650,334940,930650,190950,141995.5,338450,231700,192944.5,592200
418890,324916.7,930650,189480,135584.7,338450,229410,189332,592200
415080,328751,930650,188010,136673.4,338450,227070,192077.6,592200
409390,329962.7,930650,185100,128376.5,338450,224290,201586.2,592200
403730,338079.7,930650,182220,131120.6,338450,221510,206959.1,592200
398150,341575.6,930650,179330,144047.5,338450,218820,197528.1,592200
392500,362544.6,930650,176430,159071.7,338450,216070,203472.9,592200
388420,340980.2,930650,175620,151754.9,338450,212800,189225.3,592200
384320,379707.2,930650,174810,181159.3,338450,209510,198547.9,592200
380290,380202.3,930650,174000,190473.5,338450,206290,189728.8,592200
376180,347883.9,930650,173200,163059.6,338450,202980,184824.3,592200
374520,334211.8,930650,172460,160450.1,338450,202060,173761.7,592200
372830,370289.8,930650,171760,178542.5,338450,201070,191747.3,592200
371230,345707.3,930650,171060,172393.9,338450,200170,173313.4,592200
369490,291407.4,930650,170340,137758.8,338450,199150,153648.6,592200
366990,297156.5,930650,168850,143214.3,338450,198140,153942.2,592200
364380,299234.4,930650,167330,144792,338450,197050,154442.4,592200
361790,267355.7,930650,165800,129506.8,338450,195990,137848.9,592200
286680,195780.8,930650,144260,72118.9,338450,142420,123661.9,592200
279090,168704.4,930650,141500,54242,338450,137590,114462.4,592200
271500,181991.8,930650,138770,63952.8,338450,132730,118039,592200
263940,267544.9,930650,136020,125664.7,338450,127920,141880.2,592200
256310,266870.3,930650,133260,123453,338450,123050,143417.3,592200
256940,292680,930650,131890,138287,338450,125050,154393,592200
257640,295578.6,930650,130530,143328.7,338450,127110,152249.9,592200
258270,282844.5,930650,129150,136070.9,338450,129120,146773.6,592200
258960,266335.3,930650,127780,123823.8,338450,131180,142511.5,592200
258110,247474.4,930650,125430,108979.5,338450,132680,138494.9,592200
257330,246263.9,930650,123070,107754.7,338450,134260,138509.2,592200
256540,223491.1,930650,120720,96615.1,338450,135820,126876,592200
255750,196818.9,930650,118340,80358.4,338450,137410,116460.5,592200
255020,189142.1,930650,115620,74720.4,338450,139400,114421.7,592200
254210,192872.2,930650,112890,72194.3,338450,141320,120677.9,592200
253480,198837.4,930650,110140,74030.7,338450,143340,124806.7,592200
252740,211650.1,930650,107430,76679.4,338450,145310,134970.7,592200
262430,199741.1,930650,111750,63486.1,338450,150680,136255,592200
272040,200189.5,930650,116040,63757.1,338450,156000,136432.4,592200
281680,242075.4,930650,120370,94161.5,338450,161310,147913.9,592200
291380,266573.2,930650,124710,110527.5,338450,166670,156045.7,592200
299520,285995.3,930650,128280,125625.5,338450,171240,160369.8,592200
307620,278897.6,930650,131840,127248,338450,175780,151649.6,592200
315860,267895.1,930650,135410,118424.4,338450,180450,149470.7,592200
323990,265384.3,930650,138970,107613.7,338450,185020,157770.6,592200
332650,258131.4,930650,142830,100698.8,338450,189820,157432.6,592200
341310,230737.9,930650,146690,83816.9,338450,194620,146921,592200
350000,220410,930650,150540,76224.4,338450,199460,144185.6,592200
358630,250035.4,930650,154370,92046,338450,204260,157989.4,592200
366460,276901.8,930650,158270,108084.7,338450,208190,168817.1,592200
374240,270367.5,930650,162130,106856.2,338450,212110,163511.3,592200
382000,278430.9,930650,166010,115510.3,338450,215990,162920.6,592200
389830,314150.3,930650,169860,139992.5,338450,219970,174157.8,592200
398830,311769.2,930650,174850,123950.7,338450,223980,187818.5,592200
407930,300080.3,930650,179820,120446.9,338450,228110,179633.4,592200
417030,330376.8,930650,184780,131442.1,338450,232250,198934.7,592200
426060,345666.3,930650,189750,145252.6,338450,236310,200413.7,592200
434860,341596.8,930650,194390,142949.6,338450,240470,198647.2,592200
443710,363870.8,930650,199080,149973.7,338450,244630,213897.1,592200
452500,365415.5,930650,203730,141204.3,338450,248770,224211.2,592200
461330,350617.7,930650,208410,142539.9,338450,252920,208077.8,592200
477680,408518.2,930650,215150,179127.1,338450,262530,229391.1,592200
493990,399161.8,930650,221900,165565.6,338450,272090,233596.2,592200
510340,501750.6,930650,228640,219924.5,338450,281700,281826.1,592200
526660,532059.1,930650,235370,239950.9,338450,291290,292108.2,592200
543480,541370.2,930650,242650,244754.2,338450,300830,296616,592200
560230,559513.1,930650,249930,250583.2,338450,310300,308929.9,592200
577080,584788.5,930650,257220,267940.9,338450,319860,316847.6,592200
593840,593255.6,930650,264490,273395.7,338450,329350,319859.9,592200
611170,604504.4,930650,270920,273325.6,338450,340250,331178.8,592200
628490,594264.7,930650,277370,253610.7,338450,351120,340654,592200
645820,584606.1,930650,283770,252621.4,338450,362050,331984.7,592200
663170,609587.7,930650,290220,265383.8,338450,372950,344203.9,592200
659470,635737.7,930650,285190,282642.8,338450,374280,353094.9,592200
655690,657107.1,930650,280170,289876.2,338450,375520,367230.9,592200
652040,665176.4,930650,275150,288191.3,338450,376890,376985.1,592200
648280,685999.1,930650,270140,294356.5,338450,378140,391642.6,592200
642540,730663.1,930650,264840,297913.5,338450,377700,432749.6,592200
636650,746764.1,930650,259530,290879.1,338450,377120,455885,592200
630900,679964.9,930650,254220,245910.4,338450,376680,434054.5,592200
625150,650210.4,930650,248920,219147.4,338450,376230,431063,592200
618550,596628.1,930650,244070,205074.5,338450,374480,391553.6,592200
611890,714215.4,930650,239250,278084.9,338450,372640,436130.5,592200
605240,733933.2,930650,234410,294739.1,338450,370830,439194.1,592200
598680,702779,930650,229590,279443,338450,369090,423336,592200
592850,638001.1,930650,231270,240422.8,338450,361580,397578.3,592200
587020,613918.7,930650,232960,241206.7,338450,354060,372712,592200
581180,619028.6,930650,234630,252094.8,338450,346550,366933.8,592200
575460,637924.7,930650,236330,271158.6,338450,339130,366766.1,592200
569120,643225.7,930650,237960,278334.7,338450,331160,364891,592200
562830,644082.2,930650,239610,281030.5,338450,323220,363051.7,592200
556570,609601.8,930650,241250,265290.4,338450,315320,344311.4,592200
550280,606630.3,930650,242870,268138.9,338450,307410,338491.4,592200
546630,632486.3,930650,246260,283370.7,338450,300370,349115.6,592200
542990,638782.2,930650,249630,288096.8,338450,293360,350685.4,592200
539350,627064.8,930650,253010,287871.4,338450,286340,339193.4,592200
535710,623152.8,930650,256380,288649.3,338450,279330,334503.5,592200
540280,597213.5,930650,256690,278634.6,338450,283590,318578.9,592200
544920,595654.3,930650,257010,275105.5,338450,287910,320548.8,592200
549480,626626.2,930650,257300,288740.4,338450,292180,337885.8,592200
554040,635150.5,930650,257620,291111.1,338450,296420,344039.4,592200
558760,642334.3,930650,257660,290718.2,338450,301100,351616.1,592200
563600,657365.6,930650,257770,293172.5,338450,305830,364193.1,592200
568340,660596.6,930650,257820,295405.5,338450,310520,365191.1,592200
573100,632531.6,930650,257910,285019.7,338450,315190,347511.9,592200
577870,639077,930650,258030,282502.8,338450,319840,356574.2,592200
582550,642826.4,930650,258120,279963.9,338450,324430,362862.5,592200
587290,597226.3,930650,258250,253024.4,338450,329040,344201.9,592200
592050,588218.4,930650,258360,251464.5,338450,333690,336753.9,592200
589060,565018.1,930650,255600,241157,338450,333460,323861.1,592200
586120,552175.2,930650,252810,240221.8,338450,333310,311953.4,592200
583190,523981.1,930650,250020,219389.9,338450,333170,304591.2,592200
580300,527635.9,930650,247250,223879.3,338450,333050,303756.6,592200
576240,531702.2,930650,243760,223935.7,338450,332480,307766.5,592200
572230,531994.7,930650,240260,226633.6,338450,331970,305361.1,592200
568180,538758.1,930650,236760,223175.4,338450,331420,315582.7,592200
539400,513135.5,930650,222360,205281.1,338450,317040,307854.4,592200
532340,507599.4,930650,218030,210387.1,338450,314310,297212.3,592200
525380,506432.6,930650,213730,210549.9,338450,311650,295882.7,592200
518380,497560.2,930650,209400,202484.9,338450,308980,295075.3,592200
511380,481294.1,930650,205100,188032.2,338450,306280,293261.9,592200
504180,483282,930650,201340,187931.5,338450,302840,295350.5,592200
496950,505436.9,930650,197580,198146.7,338450,299370,307290.2,592200
489800,511195.4,930650,193840,197790.3,338450,295960,313405.1,592200
482630,493401,930650,190070,193511.1,338450,292560,299889.9,592200
475110,475149.4,930650,185970,194818.8,338450,289140,280330.6,592200
467630,463994.2,930650,181890,183984.9,338450,285740,280009.3,592200
460170,494849.7,930650,177800,204439.3,338450,282370,290410.4,592200
452630,489987.5,930650,173730,199679.2,338450,278900,290308.3,592200
444780,508920.2,930650,169670,204074.7,338450,275110,304845.5,592200
436860,487912,930650,165600,190886.2,338450,271260,297025.8,592200
428950,432315,930650,161550,160393.3,338450,267400,271921.7,592200
421090,428672.9,930650,157500,156103.3,338450,263590,272569.6,592200
411980,393063.5,930650,153750,134197.1,338450,258230,258866.4,592200
402900,373734.2,930650,149980,123706.1,338450,252920,250028.1,592200
393740,332780.3,930650,146210,110159.6,338450,247530,222620.7,592200
384680,319982.7,930650,142460,114745.8,338450,242220,205236.9,592200
376560,297953.8,930650,139610,103166.5,338450,236950,194787.3,592200
368460,258785.7,930650,136770,81268.3,338450,231690,177517.4,592200
360380,237698.4,930650,133930,75593.8,338450,226450,162104.6,592200
352330,212447.8,930650,131090,59665.8,338450,221240,152782,592200
343970,196884.2,930650,128100,51460.1,338450,215870,145424.1,592200
335720,205058.7,930650,125130,53457.1,338450,210590,151601.6,592200
327400,200709.7,930650,122160,49531,338450,205240,151178.7,592200
319090,188841.4,930650,119170,44584,338450,199920,144257.4,592200
311310,173172.9,930650,115620,37400,338450,195690,135772.9,592200
303550,184700.6,930650,112090,47108.1,338450,191460,137592.5,592200
295780,193435.2,930650,108540,60329,338450,187240,133106.2,592200
287980,163416.5,930650,105000,39950.7,338450,182980,123465.8,592200
282500,163955,930650,103760,38008.3,338450,178740,125946.7,592200
276900,171012,930650,102530,43116.2,338450,174370,127895.8,592200
271310,219402.2,930650,101300,77346.5,338450,170010,142055.7,592200
265780,228222.6,930650,100070,82747.2,338450,165710,145475.4,592200
259120,177052,930650,97500,52374.8,338450,161620,124677.2,592200
252380,151379.8,930650,94910,35493.9,338450,157470,115885.9,592200
245660,137694.3,930650,92350,35707.7,338450,153310,101986.6,592200
238950,144279.8,930650,89770,30117.7,338450,149180,114162.1,592200
235850,141642.1,930650,89650,27603,338450,146200,114039.1,592200
232690,217280.7,930650,89530,84944.3,338450,143160,132336.4,592200
229600,256428.2,930650,89400,114983.4,338450,140200,141444.8,592200
226390,229597,930650,89240,99158.6,338450,137150,130438.4,592200
222840,223551.5,930650,88390,89970.1,338450,134450,133581.4,592200
219320,187460.6,930650,87540,66395.6,338450,131780,121065,592200
215680,126185.7,930650,86660,31333,338450,129020,94852.7,592200
212190,144611.9,930650,85830,39792.4,338450,126360,104819.5,592200
211860,197101.7,930650,88090,82798,338450,123770,114303.7,592200
211460,206613.2,930650,90310,86476.1,338450,121150,120137.1,592200
211140,214477.6,930650,92590,97021.6,338450,118550,117456,592200
210800,206195.8,930650,94860,92898.5,338450,115940,113297.3,592200
209700,178040.5,930650,96100,75882.4,338450,113600,102158.1,592200
208550,180939.3,930650,97350,71598.1,338450,111200,109341.2,592200
207490,167172.7,930650,98610,65949.5,338450,108880,101223.2,592200
206380,167405.1,930650,99840,68516.1,338450,106540,98889,592200
205300,169066.5,930650,100760,69167.3,338450,104540,99899.2,592200
204180,126908.8,930650,101650,44297.7,338450,102530,82611.1,592200
203100,177521.7,930650,102570,82545.2,338450,100530,94976.5,592200
202030,204805.3,930650,103470,101935.4,338450,98560,102869.9,592200
201260,151402.7,930650,104410,60179.5,338450,96850,91223.2,592200
200600,207085.7,930650,105340,101185.2,338450,95260,105900.5,592200
199810,237714.7,930650,106260,119367.3,338450,93550,118347.4,592200
199150,175246.3,930650,107210,77964.3,338450,91940,97282,592200
198600,163670.5,930650,107600,69414.8,338450,91000,94255.7,592200
198150,200221.8,930650,108020,91301.1,338450,90130,108920.7,592200
197690,278728.5,930650,108430,149042.4,338450,89260,129686.1,592200
197220,186092.9,930650,108860,83647.8,338450,88360,102445.1,592200
196680,204327.1,930650,109410,97016.3,338450,87270,107310.8,592200
196180,232963.9,930650,109970,118077.7,338450,86210,114886.2,592200
195670,300633.6,930650,110510,172735.1,338450,85160,127898.5,592200
195230,222453.7,930650,111100,113902.4,338450,84130,108551.3,592200
193020,224335.6,930650,109930,128591.9,338450,83090,95743.7,592200
190910,272105.8,930650,108780,149968.5,338450,82130,122137.3,592200
188750,269560.4,930650,107650,148985.2,338450,81100,120575.2,592200
186610,253355.2,930650,106490,138180.2,338450,80120,115175,592200
184010,250378.9,930650,104600,136677,338450,79410,113701.9,592200
181460,230207.6,930650,102670,119647,338450,78790,110560.6,592200
178890,208283.2,930650,100760,97113.2,338450,78130,111170,592200
176260,189211.5,930650,98840,83532.7,338450,77420,105678.8,592200
172720,184292.6,930650,96210,92191.4,338450,76510,92101.2,592200
169110,173622.5,930650,93540,69580.2,338450,75570,104042.3,592200
165520,236383.8,930650,90900,128441.6,338450,74620,107942.2,592200
161840,224326.2,930650,88240,116504.6,338450,73600,107821.6,592200
158590,209929.6,930650,86280,98021.1,338450,72310,111908.5,592200
155360,220624.5,930650,84340,108860.4,338450,71020,111764.1,592200
152160,205073.4,930650,82390,91649.7,338450,69770,113423.7,592200
148860,206369.6,930650,80440,91842.9,338450,68420,114526.7,592200
147950,163447,930650,80100,74875.1,338450,67850,88571.9,592200
146950,166085.5,930650,79740,71193.1,338450,67210,94892.4,592200
145980,181899.3,930650,79380,94581.6,338450,66600,87317.7,592200
145030,156224.9,930650,79060,74598.4,338450,65970,81626.5,592200
143830,220582,930650,78330,109145.4,338450,65500,111436.6,592200
142580,175714.5,930650,77610,82595.9,338450,64970,93118.6,592200
141400,152465.9,930650,76900,67216.5,338450,64500,85249.4,592200
160800,138634.2,930650,85660,55199,338450,75140,83435.2,592200
162480,129580.3,930650,85630,47544,338450,76850,82036.3,592200
164200,172237.2,930650,85610,77442.2,338450,78590,94795,592200
165890,187686.3,930650,85600,87101.6,338450,80290,100584.7,592200
167700,161791.8,930650,85580,66911,338450,82120,94880.8,592200
166240,184801.6,930650,85750,81359.5,338450,80490,103442.1,592200
164900,186167.6,930650,85940,82387.2,338450,78960,103780.4,592200
163440,180051.9,930650,86130,76775.5,338450,77310,103276.4,592200
162020,183927.4,930650,86300,79481.3,338450,75720,104446.1,592200
158890,166784.8,930650,84960,68052.1,338450,73930,98732.7,592200
155880,184133.4,930650,83610,80355.3,338450,72270,103778.1,592200
152730,205267.3,930650,82250,93640.9,338450,70480,111626.4,592200
149670,235133.7,930650,80920,115636.6,338450,68750,119497.1,592200
146900,206084.8,930650,79930,92571.1,338450,66970,113513.7,592200
144030,196916.8,930650,78970,75182.1,338450,65060,121734.7,592200
141240,221295.9,930650,77980,98759.2,338450,63260,122536.7,592200
138440,141060.7,930650,77000,31225,338450,61440,109835.7,592200
135260,159758.6,930650,74860,50616.9,338450,60400,109141.7,592200
132090,198419.6,930650,72670,84129.7,338450,59420,114289.9,592200
128940,237353.3,930650,70520,109680.8,338450,58420,127672.5,592200
125790,231153.9,930650,68340,113613.3,338450,57450,117540.6,592200
123300,238417,930650,66890,106550.4,338450,56410,131866.6,592200
120830,201932.3,930650,65420,89660.5,338450,55410,112271.8,592200
118350,195556.2,930650,63970,81725.9,338450,54380,113830.3,592200
115850,196593.7,930650,62520,78243,338450,53330,118350.7,592200
113330,176488.9,930650,61090,63649.4,338450,52240,112839.5,592200
110830,160288.8,930650,59640,53908.5,338450,51190,106380.3,592200
108340,164663.8,930650,58240,61394,338450,50100,103269.8,592200
105860,154242.8,930650,56820,57197.4,338450,49040,97045.4,592200
105570,144481.5,930650,57730,52973.7,338450,47840,91507.8,592200
105310,141489.1,930650,58670,52959.8,338450,46640,88529.3,592200
105030,137226.6,930650,59600,49567.4,338450,45430,87659.2,592200
104690,131536,930650,60530,46429.3,338450,44160,85106.7,592200
104660,130762.7,930650,61400,46725.4,338450,43260,84037.3,592200
104480,135287.6,930650,62280,51475.6,338450,42200,83812,592200
104350,145142.7,930650,63140,57231.1,338450,41210,87911.6,592200
104220,136760.2,930650,64000,51421.1,338450,40220,85339.1,592200
105580,133541.7,930650,65810,50865.2,338450,39770,82676.5,592200
106800,132505.5,930650,67600,59679,338450,39200,72826.5,592200
108100,161376.3,930650,69400,77583.4,338450,38700,83792.9,592200
109410,194644.9,930650,71180,93217.2,338450,38230,101427.7,592200
117650,197942.9,930650,75800,96548.1,338450,41850,101394.8,592200
125830,204803.1,930650,80430,102857.2,338450,45400,101945.9,592200
134110,234472.9,930650,85040,126213.4,338450,49070,108259.5,592200
142280,238179,930650,89650,128669.6,338450,52630,109509.4,592200
149950,243023,930650,93620,129951.7,338450,56330,113071.3,592200
157720,243613.7,930650,97570,131330.8,338450,60150,112282.9,592200
165400,263974.7,930650,101520,142552.5,338450,63880,121422.2,592200
173070,283872.6,930650,105460,155088.8,338450,67610,128783.8,592200
181360,259194.9,930650,109780,147135,338450,71580,112059.9,592200
189590,258531.3,930650,114120,150563.2,338450,75470,107968.1,592200
197770,330943.8,930650,118430,180717.4,338450,79340,150226.4,592200
206020,346053.1,930650,122760,192149.2,338450,83260,153903.9,592200
219070,349477.3,930650,128160,189351.4,338450,90910,160125.9,592200
232080,324176.6,930650,133560,183798.6,338450,98520,140378,592200
245160,332068.9,930650,138990,181756.2,338450,106170,150312.7,592200
258150,338743.1,930650,144370,187776.9,338450,113780,150966.2,592200
271180,344599.1,930650,149510,188337.7,338450,121670,156261.4,592200
284140,364196.2,930650,154630,190547.8,338450,129510,173648.4,592200
297120,368905.6,930650,159760,194272.6,338450,137360,174633,592200
310080,395931.6,930650,164880,208254.5,338450,145200,187677.1,592200
323980,423645.3,930650,170730,221285.7,338450,153250,202359.6,592200
337900,432464.1,930650,176600,226543.6,338450,161300,205920.5,592200
351860,449165.2,930650,182470,245253.5,338450,169390,203911.7,592200
365670,462783.3,930650,188310,248723.8,338450,177360,214059.5,592200
375240,446005.3,930650,192150,233996,338450,183090,212009.3,592200
384880,453573.6,930650,195990,237161.8,338450,188890,216411.8,592200
394370,473583.8,930650,199810,244485.6,338450,194560,229098.2,592200
403980,488078.4,930650,203670,243587.1,338450,200310,244491.3,592200
414120,498830,930650,208040,247257,338450,206080,251573,592200
424180,512637.5,930650,212390,254256.6,338450,211790,258380.9,592200
434310,518965.4,930650,216760,257806.3,338450,217550,261159.1,592200
444400,519548,930650,221120,257607.4,338450,223280,261940.6,592200
455400,532941.4,930650,226100,262054.9,338450,229300,270886.5,592200
466430,541274.6,930650,231070,264303.2,338450,235360,276971.4,592200
477530,548984,930650,236060,267205.4,338450,241470,281778.6,592200
488590,566275,930650,241040,276145,338450,247550,290130,592200
494570,571598.4,930650,242190,275172.7,338450,252380,296425.7,592200
500640,594602.4,930650,243370,281224.9,338450,257270,313377.5,592200
506770,604155.9,930650,244540,281326.3,338450,262230,322829.6,592200
512880,615770.5,930650,245710,284312.8,338450,267170,331457.7,592200
518080,619852.5,930650,246100,284100.2,338450,271980,335752.3,592200
523340,633719.2,930650,246500,285641.9,338450,276840,348077.3,592200
528640,638519,930650,246920,286762,338450,281720,351757,592200
533940,633927.8,930650,247320,286255.2,338450,286620,347672.6,592200
538470,636137.5,930650,247610,286920.8,338450,290860,349216.7,592200
543040,631942.9,930650,247900,282617.2,338450,295140,349325.7,592200
547560,633472.4,930650,248200,280379.7,338450,299360,353092.7,592200
552110,630176.3,930650,248470,281710,338450,303640,348466.3,592200
547770,635583.5,930650,245680,282673.8,338450,302090,352909.7,592200
543370,637697.9,930650,242880,284660.1,338450,300490,353037.8,592200
539030,637505.9,930650,240090,286311.6,338450,298940,351194.3,592200
534640,641267.9,930650,237280,285667.9,338450,297360,355600,592200
530530,639633.5,930650,234300,282600.6,338450,296230,357032.9,592200
526310,622937.8,930650,231300,283011.3,338450,295010,339926.5,592200
522120,596705.1,930650,228320,271336.3,338450,293800,325368.8,592200
547990,597290.8,930650,228300,271065,338450,319690,326225.8,592200
539220,593087.5,930650,224310,268565.6,338450,314910,324521.9,592200
530470,578504.3,930650,220290,261366,338450,310180,317138.3,592200
521710,551452.1,930650,216320,245425.8,338450,305390,306026.3,592200
513050,516373.3,930650,212330,225750.3,338450,300720,290623,592200
501830,491436.9,930650,208220,211618.8,338450,293610,279818.1,592200
490720,473983.3,930650,204120,201492.8,338450,286600,272490.5,592200
479550,463859.4,930650,200020,198901,338450,279530,264958.4,592200
468420,466425.1,930650,195930,204186.4,338450,272490,262238.7,592200
457930,456079.7,930650,192220,200383.6,338450,265710,255696.1,592200
447430,436722.5,930650,188520,188194.1,338450,258910,248528.4,592200
436890,432386.5,930650,184820,188179.9,338450,252070,244206.6,592200
426390,420813.3,930650,181100,183777.1,338450,245290,237036.2,592200
416080,403476.8,930650,177220,178068.3,338450,238860,225408.5,592200
405900,371236.9,930650,173360,156481.9,338450,232540,214755,592200
395680,364148.5,930650,169490,155516.2,338450,226190,208632.3,592200
385450,375956.9,930650,165610,164405.6,338450,219840,211551.3,592200
376820,373102,930650,162370,165425.5,338450,214450,207676.5,592200
368200,367912.3,930650,159100,165673.7,338450,209100,202238.6,592200
359580,364173.9,930650,155850,167524.4,338450,203730,196649.5,592200
351000,356501.8,930650,152580,166920.1,338450,198420,189581.7,592200
342430,340963.4,930650,149580,160094.1,338450,192850,180869.3,592200
333900,339548,930650,146560,162333.9,338450,187340,177214.1,592200
325370,349645.4,930650,143560,166858.6,338450,181810,182786.8,592200
316780,351524.9,930650,140540,166183,338450,176240,185341.9,592200
308250,335508.8,930650,137460,162289.9,338450,170790,173218.9,592200
299730,324397.8,930650,134420,150851.7,338450,165310,173546.1,592200
291160,311120.1,930650,131350,139124.8,338450,159810,171995.3,592200
282650,271921.8,930650,128270,126356.8,338450,154380,145565,592200
280010,271416.9,930650,128040,127135.2,338450,151970,144281.7,592200
277410,253261.5,930650,127820,117062.2,338450,149590,136199.3,592200
274710,224389.5,930650,127580,97976.9,338450,147130,126412.6,592200
272140,212933.8,930650,127360,92625.2,338450,144780,120308.6,592200
269300,202747.9,930650,126440,83397.3,338450,142860,119350.6,592200
266470,198222.5,930650,125500,81844.9,338450,140970,116377.6,592200
263750,223062.5,930650,124580,90937.2,338450,139170,132125.3,592200
261000,225106.6,930650,123660,94982.2,338450,137340,130124.4,592200
258420,233987,930650,123380,91709,338450,135040,142278,592200
255880,214794.4,930650,123100,88348.5,338450,132780,126445.9,592200
253320,205153.9,930650,122830,85262.6,338450,130490,119891.3,592200
250750,203728.6,930650,122550,79555.7,338450,128200,124172.9,592200
253530,214546.9,930650,123450,88044.2,338450,130080,126502.7,592200
256270,247621.6,930650,124380,108698.5,338450,131890,138923.1,592200
259060,265107.7,930650,125290,120067.6,338450,133770,145040.1,592200
261800,277429,930650,126220,127667,338450,135580,149762,592200
263680,272412.5,930650,126700,124430.9,338450,136980,147981.6,592200
265560,289222.9,930650,127190,133621.5,338450,138370,155601.4,592200
267500,350641.1,930650,127690,167347.1,338450,139810,183294,592200
269340,367790.8,930650,128170,181157.5,338450,141170,186633.3,592200
272960,371614.4,930650,129580,185816.7,338450,143380,185797.7,592200
276590,381696.8,930650,131030,194480.6,338450,145560,187216.2,592200
280150,381809.5,930650,132410,184557.1,338450,147740,197252.4,592200
283720,384946.6,930650,133820,184003.5,338450,149900,200943.1,592200
281460,360826.4,930650,132290,164872.7,338450,149170,195953.7,592200
279290,328061.8,930650,130770,140124.9,338450,148520,187936.9,592200
277030,331274.1,930650,129270,147034.7,338450,147760,184239.4,592200
274770,359626.4,930650,127760,170346.1,338450,147010,189280.3,592200
274160,356545.1,930650,128080,163400,338450,146080,193145.1,592200
273560,383501.9,930650,128420,172804.1,338450,145140,210697.8,592200
273010,385606.5,930650,128760,169127.9,338450,144250,216478.6,592200
272420,390960.8,930650,129090,174230.5,338450,143330,216730.3,592200
270810,356672.3,930650,129180,160935.3,338450,141630,195737,592200
269200,331037.4,930650,129300,149191.5,338450,139900,181845.9,592200
267620,352186.7,930650,129400,148188.5,338450,138220,203998.2,592200
266050,336244.5,930650,129500,145581.9,338450,136550,190662.6,592200
274020,353498.6,930650,133870,158246.2,338450,140150,195252.4,592200
282000,370335.2,930650,138230,163955.5,338450,143770,206379.7,592200
289940,379386,930650,142570,162128.4,338450,147370,217257.6,592200
297910,378048.1,930650,146920,167951.2,338450,150990,210096.9,592200
306220,376714.9,930650,151350,169406,338450,154870,207308.9,592200
314510,381796.1,930650,155730,167790.7,338450,158780,214005.4,592200
322830,387518.4,930650,160130,167181.4,338450,162700,220337,592200
331160,398507.4,930650,164530,175868.2,338450,166630,222639.2,592200
339180,390785.6,930650,168420,170540.4,338450,170760,220245.2,592200
347190,420850.9,930650,172300,181578.7,338450,174890,239272.2,592200
355160,444701.2,930650,176200,195881.7,338450,178960,248819.5,592200
363200,461073.7,930650,180070,198933.3,338450,183130,262140.4,592200
366280,461647.8,930650,180900,208554.9,338450,185380,253092.9,592200
369390,459231,930650,181720,211938.9,338450,187670,247292.1,592200
372520,451815.5,930650,182540,210264.3,338450,189980,241551.2,592200
375640,457690.6,930650,183350,213202.6,338450,192290,244488,592200
380300,475726.8,930650,186040,228625.3,338450,194260,247101.5,592200
384920,480240.6,930650,188730,230159.1,338450,196190,250081.5,592200
389560,507714,930650,191410,231946,338450,198150,275768,592200
394230,515759,930650,194100,234294.3,338450,200130,281464.7,592200
396540,521593.9,930650,195050,250383.5,338450,201490,271210.4,592200
398920,529957.1,930650,196000,255406.8,338450,202920,274550.3,592200
401280,510355.6,930650,196960,249284.3,338450,204320,261071.3,592200
403610,526597.8,930650,197920,243956.6,338450,205690,282641.2,592200
397900,563783.1,930650,195770,244181.1,338450,202130,319602,592200
392140,589695.5,930650,193610,253053.2,338450,198530,336642.3,592200
386470,549756.9,930650,191480,251271,338450,194990,298485.9,592200
380730,543111.1,930650,189310,255982.7,338450,191420,287128.4,592200
374540,533360.5,930650,186730,256992.4,338450,187810,276368.1,592200
368350,517416.8,930650,184120,251862,338450,184230,265554.8,592200
362250,501906.4,930650,181550,254468.9,338450,180700,247437.5,592200
442630,493028.6,930650,211300,253281.9,338450,231330,239746.7,592200
444490,486787.4,930650,212410,246376,338450,232080,240411.4,592200
446380,479471.1,930650,213540,247286.9,338450,232840,232184.2,592200
448220,502239.3,930650,214650,249135.9,338450,233570,253103.4,592200
450110,486601.8,930650,215750,249265.2,338450,234360,237336.6,592200
449130,477410.3,930650,216090,240927.8,338450,233040,236482.5,592200
448340,498108.5,930650,216450,255490.5,338450,231890,242618,592200
447440,500180.2,930650,216810,256582.6,338450,230630,243597.6,592200
446510,485691.7,930650,217170,249238.5,338450,229340,236453.2,592200
446700,463926,930650,218470,247453.1,338450,228230,216472.9,592200
446950,469908.3,930650,219780,238958.6,338450,227170,230949.7,592200
447100,459804.2,930650,221100,232842.4,338450,226000,226961.8,592200
447320,452599.1,930650,222420,235015.8,338450,224900,217583.3,592200
446640,470499.5,930650,222990,242573.9,338450,223650,227925.6,592200
445990,455583.7,930650,223580,242956.9,338450,222410,212626.8,592200
445430,450344.6,930650,224200,241048.2,338450,221230,209296.4,592200
444740,450974.3,930650,224770,240805.1,338450,219970,210169.2,592200
444770,456339.8,930650,224630,240884.2,338450,220140,215455.6,592200
444840,459892,930650,224490,239450.4,338450,220350,220441.6,592200
444830,460017.2,930650,224330,240600.5,338450,220500,219416.7,592200
444900,467565.5,930650,224180,239283,338450,220720,228282.5,592200
446190,462084,930650,223820,235442.6,338450,222370,226641.4,592200
447430,472768.4,930650,223410,235964.4,338450,224020,236804,592200
448800,455007.9,930650,223050,234591.9,338450,225750,220416,592200
449950,442741.7,930650,222660,234584.6,338450,227290,208157.1,592200
450780,449796.7,930650,222460,238007.3,338450,228320,211789.4,592200
451510,463550.7,930650,222300,239491.8,338450,229210,224058.9,592200
452240,481838,930650,222100,246681.9,338450,230140,235156.1,592200
453030,477497.1,930650,221920,244682.9,338450,231110,232814.2,592200
450480,483179.1,930650,220160,249799.8,338450,230320,233379.3,592200
447980,480624.3,930650,218400,244822.3,338450,229580,235802,592200
445480,470389.9,930650,216670,238008.3,338450,228810,232381.6,592200
442930,460447.1,930650,214920,232439.9,338450,228010,228007.2,592200
440110,455010.6,930650,213190,230788.6,338450,226920,224222,592200
437270,448392.7,930650,211460,229050.1,338450,225810,219342.6,592200
434380,437581.5,930650,209740,228259.6,338450,224640,209321.9,592200
431560,431593.5,930650,208020,230519.9,338450,223540,201073.6,592200
427600,396777.6,930650,206280,219909.3,338450,221320,176868.3,592200
423610,390145.4,930650,204570,211995.3,338450,219040,178150.1,592200
419640,396739.7,930650,202820,210957.7,338450,216820,185782,592200
415730,396073.7,930650,201120,208960.9,338450,214610,187112.8,592200
413300,386269,930650,199470,207148.6,338450,213830,179120.4,592200
410800,346772.3,930650,197790,187882.6,338450,213010,158889.7,592200
408360,334506.2,930650,196130,184519,338450,212230,149987.2,592200
405880,343216.3,930650,194460,189972.5,338450,211420,153243.8,592200
403260,337530.2,930650,192300,187762.4,338450,210960,149767.8,592200
400600,393095.6,930650,190100,210792.7,338450,210500,182302.9,592200
398050,379887.7,930650,187910,187305.5,338450,210140,192582.2,592200
395370,345757.7,930650,185750,175266.9,338450,209620,170490.8,592200
393580,339014.4,930650,183770,172670.3,338450,209810,166344.1,592200
391650,304665.4,930650,181770,152806.9,338450,209880,151858.5,592200
389810,302941.3,930650,179800,150757.2,338450,210010,152184.1,592200
387990,307389.2,930650,177820,158599.7,338450,210170,148789.5,592200
378470,282473.4,930650,174550,141715.4,338450,203920,140758,592200
369020,268178,930650,171260,137768.4,338450,197760,130409.6,592200
359510,263138.5,930650,167970,134803.6,338450,191540,128334.9,592200
350100,283535,930650,164710,139190.3,338450,185390,144344.7,592200
339730,316083,930650,160870,149745.4,338450,178860,166337.6,592200
329520,315716.7,930650,157040,155385.5,338450,172480,160331.2,592200
319210,306061,930650,153210,147157.5,338450,166000,158903.5,592200
308900,292119.4,930650,149370,140132.9,338450,159530,151986.5,592200
298900,276864.9,930650,145470,135952.4,338450,153430,140912.5,592200
288880,252109.6,930650,141610,121710.3,338450,147270,130399.3,592200
278870,251309.8,930650,137700,121440.8,338450,141170,129869,592200
268820,259926.9,930650,133830,127948.3,338450,134990,131978.6,592200
264260,251750.4,930650,132020,120856.1,338450,132240,130894.3,592200
259710,248576.5,930650,130190,103117.1,338450,129520,145459.4,592200
255090,239455.8,930650,128380,100102,338450,126710,139353.8,592200
250490,203737.5,930650,126560,86263.1,338450,123930,117474.4,592200
244920,169495.8,930650,123730,75211,338450,121190,94284.8,592200
239360,172625.9,930650,120940,74219.7,338450,118420,98406.2,592200
233820,211257.1,930650,118110,91564,338450,115710,119693.1,592200
228240,218503.7,930650,115290,93036.2,338450,112950,125467.5,592200
221930,232777.1,930650,112120,104489.2,338450,109810,128287.9,592200
215520,252240.2,930650,108880,113797.2,338450,106640,138443,592200
209230,232109.3,930650,105690,99313.4,338450,103540,132795.9,592200
202870,234053.9,930650,102500,101412.5,338450,100370,132641.4,592200
194330,244727.3,930650,97490,109846,338450,96840,134881.3,592200
185780,234559.5,930650,92480,101472.7,338450,93300,133086.8,592200
177180,231860.5,930650,87470,97064.3,338450,89710,134796.2,592200
168650,225109.1,930650,82480,90098.8,338450,86170,135010.3,592200
161500,200737.5,930650,78160,71756.8,338450,83340,128980.7,592200
154420,190314.1,930650,73830,65474.9,338450,80590,124839.2,592200
147230,176438,930650,69540,54157.2,338450,77690,122280.8,592200
140070,170914.3,930650,65220,48856.5,338450,74850,122057.8,592200
132510,165010.4,930650,60630,55782.2,338450,71880,109228.2,592200
124850,153800.3,930650,56050,51953.5,338450,68800,101846.8,592200
117380,142617.4,930650,51480,45261.6,338450,65900,97355.8,592200
109740,148738.6,930650,46880,43319.5,338450,62860,105419.1,592200
106420,136196.7,930650,45110,40741.1,338450,61310,95455.6,592200
102990,134978,930650,43300,42430.4,338450,59690,92547.6,592200
99620,142071.8,930650,41510,48187,338450,58110,93884.8,592200
96260,133337.8,930650,39760,44981.2,338450,56500,88356.6,592200
93240,130389.6,930650,38040,40713.1,338450,55200,89676.5,592200
90230,137445.5,930650,36350,41683.7,338450,53880,95761.8,592200
87130,165144.2,930650,34650,46857.5,338450,52480,118286.7,592200
104810,162606.5,930650,45320,47546.6,338450,59490,115059.9,592200
101350,162997.1,930650,43270,49208.4,338450,58080,113788.7,592200
97940,165672.4,930650,41260,50319.9,338450,56680,115352.5,592200
94600,157017.5,930650,39240,45038.6,338450,55360,111978.9,592200
91130,149007.8,930650,37230,38832,338450,53900,110175.8,592200
91930,149815.7,930650,37720,41244.9,338450,54210,108570.8,592200
92690,152684,930650,38260,45050.9,338450,54430,107633.1,592200
93460,157127.6,930650,38760,49618.8,338450,54700,107508.8,592200
94250,142444.3,930650,39290,40029.7,338450,54960,102414.6,592200
96120,149292.9,930650,41140,46373.2,338450,54980,102919.7,592200
98110,163880.8,930650,43040,58576.2,338450,55070,105304.6,592200
100010,181727.5,930650,44870,70977.6,338450,55140,110749.9,592200
101950,202654,930650,46760,86211.4,338450,55190,116442.6,592200
101330,189811.4,930650,46400,77837,338450,54930,111974.4,592200
100690,169022.9,930650,46020,62256.7,338450,54670,106766.2,592200
100080,177151.8,930650,45630,68338.6,338450,54450,108813.2,592200
99460,198089.2,930650,45260,83404.6,338450,54200,114684.6,592200
102170,204325.7,930650,47270,88033.8,338450,54900,116291.9,592200
104830,191957.2,930650,49280,79365.4,338450,55550,112591.8,592200
107570,200145.7,930650,51300,85870.5,338450,56270,114275.2,592200
110180,231855.3,930650,53300,107286.2,338450,56880,124569.1,592200
112560,196598.8,930650,55590,83990.8,338450,56970,112608,592200
114960,200933,930650,57910,88581.5,338450,57050,112351.5,592200
117310,176100.9,930650,60170,75118.6,338450,57140,100982.3,592200
119710,138982.7,930650,62510,51548.4,338450,57200,87434.3,592200
121610,147321.9,930650,64280,56964.2,338450,57330,90357.7,592200
123570,156457.2,930650,66050,63029.3,338450,57520,93427.9,592200
125480,167108,930650,67850,70427.5,338450,57630,96680.5,592200
127470,161899.2,930650,69630,65599.7,338450,57840,96299.5,592200
131260,147990.2,930650,72150,56625.8,338450,59110,91364.4,592200
135120,148653.7,930650,74680,57664,338450,60440,90989.7,592200
138880,155946.8,930650,77180,61062.1,338450,61700,94884.7,592200
142700,152793.8,930650,79700,56047,338450,63000,96746.8,592200
148390,160437.9,930650,83430,61494.7,338450,64960,98943.2,592200
154070,150630,930650,87180,64406.7,338450,66890,86223.3,592200
159710,148826.1,930650,90890,65496.5,338450,68820,83329.6,592200
165350,171876.3,930650,94640,71696.1,338450,70710,100180.2,592200
169650,179729.9,930650,97270,77236.1,338450,72380,102493.8,592200
173800,210321.1,930650,99880,98196.4,338450,73920,112124.7,592200
178060,252198.2,930650,102510,122216.6,338450,75550,129981.6,592200
182290,240806.9,930650,105150,124098.8,338450,77140,116708.1,592200
183530,253292.6,930650,106060,132362.6,338450,77470,120930,592200
184760,274468.9,930650,106980,142994.7,338450,77780,131474.2,592200
185900,270572.5,930650,107860,143306.1,338450,78040,127266.4,592200
187140,237457.1,930650,108760,120981.9,338450,78380,116475.2,592200
188580,234573.9,930650,109590,116192.9,338450,78990,118381,592200
190060,251494.2,930650,110400,124499.5,338450,79660,126994.7,592200
191490,294029,930650,111190,143267.5,338450,80300,150761.5,592200
192920,294897.9,930650,111980,146069.4,338450,80940,148828.5,592200
194320,278599.5,930650,113180,138492.6,338450,81140,140106.9,592200
195680,276584.2,930650,114410,126308.7,338450,81270,150275.5,592200
197020,273142.7,930650,115620,119668.2,338450,81400,153474.5,592200
198370,286360,930650,116830,129776.4,338450,81540,156583.6,592200
195190,340183.1,930650,112940,157988.3,338450,82250,182194.8,592200
192080,358914.8,930650,109040,180534,338450,83040,178380.8,592200
188790,366237.4,930650,105110,193995.1,338450,83680,172242.3,592200
185620,363681.7,930650,101230,180760.5,338450,84390,182921.2,592200
182980,347359.5,930650,98040,161002.2,338450,84940,186357.3,592200
180390,306563,930650,94840,141992.4,338450,85550,164570.6,592200
177790,313080.7,930650,91640,148090.7,338450,86150,164990,592200
175070,313450.5,930650,88450,148870.4,338450,86620,164580.1,592200
172680,315148.7,930650,85040,144237.8,338450,87640,170910.9,592200
170230,327569.3,930650,81610,144077.1,338450,88620,183492.2,592200
167790,356752,930650,78170,161746.8,338450,89620,195005.2,592200
165330,366501.1,930650,74760,161016.5,338450,90570,205484.6,592200
172840,332912.2,930650,77250,141154.7,338450,95590,191757.5,592200
180440,316864.9,930650,79780,130985.4,338450,100660,185879.5,592200
187940,336261.7,930650,82250,142253.5,338450,105690,194008.2,592200
195490,326057.6,930650,84760,139521.5,338450,110730,186536.1,592200
201180,291970.7,930650,85040,125817.2,338450,116140,166153.5,592200
206880,285848,930650,85340,113701.9,338450,121540,172146.1,592200
212560,271493.9,930650,85620,101154.9,338450,126940,170339,592200
218220,282617.7,930650,85900,100295.9,338450,132320,182321.8,592200
226610,292808.9,930650,88250,105237.9,338450,138360,187571,592200
235020,308916.5,930650,90620,112758.2,338450,144400,196158.3,592200
243380,340161.5,930650,92950,119857.4,338450,150430,220304.1,592200
251780,318328.3,930650,95300,119267.3,338450,156480,199061,592200
253940,317357.7,930650,96900,119810.3,338450,157040,197547.4,592200
256020,324589.3,930650,98460,129366.8,338450,157560,195222.5,592200
258140,342427.4,930650,100040,145542.7,338450,158100,196884.7,592200
260300,365329,930650,101640,154473.1,338450,158660,210855.9,592200
260760,336177.2,930650,101220,133670.5,338450,159540,202506.7,592200
261210,348980.5,930650,100790,138844.7,338450,160420,210135.8,592200
261630,354632,930650,100350,137103.4,338450,161280,217528.6,592200
262080,367677.7,930650,99960,142845.7,338450,162120,224832,592200
263610,403892.7,930650,100430,159160.9,338450,163180,244731.8,592200
265180,405479.6,930650,100920,162081.4,338450,164260,243398.2,592200
266690,376083.2,930650,101430,136543.5,338450,165260,239539.7,592200
268230,384796.3,930650,101900,134002.8,338450,166330,250793.5,592200
269020,352671.7,930650,103710,120717.9,338450,165310,231953.8,592200
269770,357274.9,930650,105520,133882.1,338450,164250,223392.8,592200
270520,368010,930650,107320,143741.8,338450,163200,224268.2,592200
271240,339731.3,930650,109120,128558.8,338450,162120,211172.5,592200
271940,306469.2,930650,111220,111624.6,338450,160720,194844.6,592200
272600,311107,930650,113370,117502.9,338450,159230,193604.1,592200
273280,332282.7,930650,115500,129869.7,338450,157780,202413,592200
315360,347409.3,930650,121030,130925.5,338450,194330,216483.8,592200
315240,332603.3,930650,121780,118657.7,338450,193460,213945.6,592200
315150,347648.4,930650,122510,128018.2,338450,192640,219630.2,592200
314990,318649.3,930650,123250,117422.5,338450,191740,201226.8,592200
314860,320653.5,930650,123980,125251.4,338450,190880,195402.1,592200
316610,309662.5,930650,125790,122687,338450,190820,186975.5,592200
318300,305623.7,930650,127610,122105.3,338450,190690,183518.4,592200
320040,295209.6,930650,129410,114379.2,338450,190630,180830.4,592200
321760,299885.5,930650,131220,120164.9,338450,190540,179720.6,592200
324710,343278.8,930650,132860,140283.3,338450,191850,202995.5,592200
327730,341126.1,930650,134530,141958.8,338450,193200,199167.3,592200
330690,333522.1,930650,136190,141234.1,338450,194500,192288,592200
333740,327268.9,930650,137860,129956.1,338450,195880,197312.8,592200
336140,318028.7,930650,138630,120525.7,338450,197510,197503,592200
338600,325807.2,930650,139440,125312.7,338450,199160,200494.5,592200
341100,347811.9,930650,140220,134693.6,338450,200880,213118.3,592200
343630,306201.3,930650,141030,104735.5,338450,202600,201465.8,592200
341000,291368.1,930650,140420,88489,338450,200580,202879.1,592200
338380,284890.8,930650,139820,79302.2,338450,198560,205588.6,592200
335850,296134.6,930650,139230,95696.6,338450,196620,200438,592200
333270,329112.3,930650,138650,122049.4,338450,194620,207062.9,592200
330510,353507,930650,138330,129878.6,338450,192180,223628.4,592200
327720,351586.1,930650,138020,125949.5,338450,189700,225636.6,592200
325010,325629.2,930650,137730,101052.2,338450,187280,224577,592200
322240,318661,930650,137410,99754.1,338450,184830,218906.9,592200
319430,322006.5,930650,137310,107699.2,338450,182120,214307.3,592200
316660,356634.8,930650,137160,123994,338450,179500,232640.8,592200
313840,380919.6,930650,137040,133616.7,338450,176800,247302.9,592200
311080,378647.8,930650,136930,137350.2,338450,174150,241297.6,592200
314030,322341.1,930650,138920,120164.6,338450,175110,202176.5,592200
317070,328351,930650,140910,124970.7,338450,176160,203380.3,592200
320060,312804.2,930650,142920,122673.7,338450,177140,190130.5,592200
323090,307358.2,930650,144910,121580,338450,178180,185778.2,592200
326440,337594.2,930650,146520,121992.6,338450,179920,215601.6,592200
329850,343059.6,930650,148130,125208,338450,181720,217851.6,592200
333240,329756.4,930650,149750,121391,338450,183490,208365.4,592200
336630,331835,930650,151350,126580.8,338450,185280,205254.2,592200
340280,318205.3,930650,153100,115516,338450,187180,202689.3,592200
343900,293203.6,930650,154830,98060.3,338450,189070,195143.3,592200
347630,282347,930650,156580,95247.4,338450,191050,187099.6,592200
351220,281511.1,930650,158310,100036.4,338450,192910,181474.7,592200
360950,280874.9,930650,161560,116976.6,338450,199390,163898.3,592200
370720,266611.9,930650,164790,116684.1,338450,205930,149927.8,592200
380420,280827.7,930650,168070,118944.2,338450,212350,161883.5,592200
390160,277913.2,930650,171310,127333.9,338450,218850,150579.3,592200
396370,292547,930650,171810,133698.3,338450,224560,158848.7,592200
402560,289327.3,930650,172310,124423.1,338450,230250,164904.2,592200
408850,282868.6,930650,172810,119903.3,338450,236040,162965.3,592200
415030,302063.4,930650,173340,122263.6,338450,241690,179799.8,592200
422790,316984.5,930650,174350,130168.5,338450,248440,186816,592200
430480,303379.7,930650,175370,128866.9,338450,255110,174512.8,592200
438130,289372.9,930650,176380,119062.3,338450,261750,170310.6,592200
445880,279622.5,930650,177380,115701.2,338450,268500,163921.3,592200
444970,265763.5,930650,175260,108439.3,338450,269710,157324.2,592200
444080,270520.9,930650,173140,103112.1,338450,270940,167408.8,592200
443150,301772.8,930650,171000,105052.8,338450,272150,196720,592200
442250,297798.2,930650,168880,100454.4,338450,273370,197343.8,592200
440700,272693.1,930650,166560,87861.6,338450,274140,184831.5,592200
439110,246341.9,930650,164240,77378.3,338450,274870,168963.6,592200
437560,237576.2,930650,161930,81020.4,338450,275630,156555.8,592200
435980,254464.4,930650,159610,95065.8,338450,276370,159398.6,592200
436370,231779.3,930650,160270,84236.8,338450,276100,147542.5,592200
436830,226945.3,930650,160930,75910.4,338450,275900,151034.9,592200
437260,258617.2,930650,161600,79005.6,338450,275660,179611.6,592200
437660,275857.3,930650,162270,99318,338450,275390,176539.3,592200
436330,304315.6,930650,160290,116701.8,338450,276040,187613.8,592200
434900,320036.3,930650,158330,124837.8,338450,276570,195198.5,592200
433490,305277.1,930650,156360,107957.2,338450,277130,197319.9,592200
432120,272559.9,930650,154400,93547.2,338450,277720,179012.7,592200
434270,266616.3,930650,154170,88138.1,338450,280100,178478.2,592200
436470,279082.2,930650,153950,87211.8,338450,282520,191870.4,592200
438620,290529.9,930650,153730,87993.8,338450,284890,202536.1,592200
440780,315283.2,930650,153510,103297.7,338450,287270,211985.5,592200
442050,302541.9,930650,152840,87313.3,338450,289210,215228.6,592200
443330,279502.3,930650,152150,64192.6,338450,291180,215309.7,592200
444600,296500.8,930650,151490,77535,338450,293110,218965.8,592200
445870,315577.3,930650,150830,86090.4,338450,295040,229486.9,592200
438800,350121,930650,149240,97488,338450,289560,252633,592200
431760,351284.7,930650,147670,93487.1,338450,284090,257797.6,592200
424700,346472.5,930650,146100,90780.3,338450,278600,255692.2,592200
417610,366219.8,930650,144490,103807.1,338450,273120,262412.7,592200
412870,414851.8,930650,145400,137429.1,338450,267470,277422.7,592200
408120,408124.3,930650,146280,140492.4,338450,261840,267631.9,592200
403380,390912.6,930650,147180,114983.3,338450,256200,275929.3,592200
398600,420548.9,930650,148100,115213.7,338450,250500,305335.2,592200
390330,427591.3,930650,145800,127463.2,338450,244530,300128.1,592200
382110,407320.4,930650,143490,113719.2,338450,238620,293601.2,592200
373790,368505.6,930650,141170,92912.1,338450,232620,275593.5,592200
365540,347002.8,930650,138890,85356.6,338450,226650,261646.2,592200
358800,353942.8,930650,137060,95469.6,338450,221740,258473.2,592200
352070,354953.3,930650,135280,95871,338450,216790,259082.3,592200
345270,377651.8,930650,133460,104000.1,338450,211810,273651.7,592200
338490,431807.7,930650,131650,149984.4,338450,206840,281823.3,592200
330590,388163,930650,129140,132208.7,338450,201450,255954.3,592200
322650,354154.9,930650,126620,115423.2,338450,196030,238731.7,592200
314690,341047.8,930650,124100,114728.2,338450,190590,226319.6,592200
237430,326563.2,930650,86510,106960.6,338450,150920,219602.6,592200
226470,296975.6,930650,84700,89003,338450,141770,207972.6,592200
215480,278437,930650,82900,84465.8,338450,132580,193971.2,592200
204530,264021.8,930650,81070,91279.5,338450,123460,172742.3,592200
193550,259376.2,930650,79260,92216.2,338450,114290,167160,592200
185460,241538.6,930650,75950,77155.5,338450,109510,164383.1,592200
177340,238591.5,930650,72630,76525,338450,104710,162066.5,592200
169210,235274.6,930650,69300,66107.4,338450,99910,169167.2,592200
161150,219667.1,930650,66000,60568.6,338450,95150,159098.5,592200
152700,201218,930650,62490,61866.2,338450,90210,139351.8,592200
144260,193689.7,930650,59000,69207.1,338450,85260,124482.6,592200
135820,195302.9,930650,55490,70979.9,338450,80330,124323,592200
127310,180175.7,930650,52000,58443.5,338450,75310,121732.2,592200
118490,176418.6,930650,48110,58316.4,338450,70380,118102.2,592200
109650,179918.3,930650,44250,57486.4,338450,65400,122431.9,592200
100840,206495.6,930650,40370,55902.8,338450,60470,150592.8,592200
92010,186202.5,930650,36510,57790.7,338450,55500,128411.8,592200
89030,183937.6,930650,34990,54792.2,338450,54040,129145.4,592200
86140,197533.4,930650,33450,57550.8,338450,52690,139982.6,592200
83350,170763.2,930650,31970,55909.2,338450,51380,114854,592200
80460,172109,930650,30450,56050.1,338450,50010,116058.9,592200
77420,165811,930650,28650,53079.6,338450,48770,112731.4,592200
74290,173546.7,930650,26830,50428.4,338450,47460,123118.3,592200
71190,162018.8,930650,25040,46191,338450,46150,115827.8,592200
68120,152445,930650,23200,41316.3,338450,44920,111128.7,592200
65180,151189.5,930650,21390,40641.9,338450,43790,110547.6,592200
62090,151624.4,930650,19560,40371.3,338450,42530,111253.1,592200
59060,153593,930650,17710,40515,338450,41350,113078,592200
56040,169175.1,930650,15890,47458.9,338450,40150,121716.2,592200
54070,170038,930650,15410,49037,338450,38660,121001,592200
52080,166109,930650,14930,50014.7,338450,37150,116094.3,592200
50080,152102.3,930650,14420,45244.8,338450,35660,106857.5,592200
48080,139016.5,930650,13940,47414.4,338450,34140,91602.1,592200
46190,140535.9,930650,13430,42912,338450,32760,97623.9,592200
44240,135959.9,930650,12880,39608.4,338450,31360,96351.5,592200
42300,137503.9,930650,12340,34431.5,338450,29960,103072.4,592200
40350,136622,930650,11820,35248.5,338450,28530,101373.5,592200
39170,139056.8,930650,11900,39020.8,338450,27270,100036,592200
37970,131138.2,930650,12000,37697.7,338450,25970,93440.5,592200
36680,120586,930650,12060,33669.2,338450,24620,86916.8,592200
35480,114090.2,930650,12160,30613.9,338450,23320,83476.3,592200
34710,110924.7,930650,12280,29419.6,338450,22430,81505.1,592200
33860,115976.7,930650,12420,34852.7,338450,21440,81124,592200
33080,112038.9,930650,12570,34252.3,338450,20510,77786.6,592200
32260,113230.9,930650,12680,35113.6,338450,19580,78117.3,592200
30400,99091.9,930650,12150,25628,338450,18250,73463.9,592200
28590,99125.6,930650,11590,25623.7,338450,17000,73501.9,592200
26730,98287,930650,11050,25148.3,338450,15680,73138.7,592200
24950,95099.1,930650,10520,22429.9,338450,14430,72669.2,592200
23410,98517.3,930650,10110,24482.6,338450,13300,74034.7,592200
21930,99510.5,930650,9700,24009.3,338450,12230,75501.2,592200
20450,101186.1,930650,9310,23543.3,338450,11140,77642.8,592200
18950,106548.6,930650,8900,26922.1,338450,10050,79626.5,592200
19560,103136.6,930650,9770,23912.8,338450,9790,79223.8,592200
20200,99334.6,930650,10640,21335.4,338450,9560,77999.2,592200
20790,105305,930650,11480,25263.1,338450,9310,80041.9,592200
21410,103606.6,930650,12340,25788.2,338450,9070,77818.4,592200
21570,110202.4,930650,12360,25597,338450,9210,84605.4,592200
21780,117414.6,930650,12410,28591.9,338450,9370,88822.7,592200
22010,125036.5,930650,12430,35011.7,338450,9580,90024.8,592200
22200,124819.4,930650,12470,34097.6,338450,9730,90721.8,592200
21450,117614.9,930650,11690,37110.8,338450,9760,80504.1,592200
20610,136444.6,930650,10910,38642.1,338450,9700,97802.5,592200
19830,109258.6,930650,10120,35733.2,338450,9710,73525.4,592200
19090,129911.2,930650,9350,39177.1,338450,9740,90734.1,592200
20860,146026.5,930650,9860,41049.6,338450,11000,104976.9,592200
22620,143173.2,930650,10330,40243.4,338450,12290,102929.8,592200
24410,139497.5,930650,10830,42866,338450,13580,96631.5,592200
26220,136825.1,930650,11310,42435.3,338450,14910,94389.8,592200
28660,141725.6,930650,12560,39746,338450,16100,101979.6,592200
31140,125370.9,930650,13800,34573.8,338450,17340,90797.1,592200
33600,123253.8,930650,15030,33825.2,338450,18570,89428.6,592200
36080,122412.6,930650,16280,35026.3,338450,19800,87386.3,592200
37590,148967.1,930650,16900,35952.5,338450,20690,113014.6,592200
39190,141005.1,930650,17530,35921.2,338450,21660,105083.9,592200
40710,130943.1,930650,18150,35545.7,338450,22560,95397.4,592200
42270,130003.3,930650,18770,38281.9,338450,23500,91721.4,592200
43780,151773.1,930650,18920,42725,338450,24860,109048.1,592200
45330,163636.8,930650,19100,47412.1,338450,26230,116224.7,592200
46900,178166.5,930650,19260,56262.4,338450,27640,121904.1,592200
48460,182814.1,930650,19460,58634.6,338450,29000,124179.5,592200
50890,182334.1,930650,20330,58195.4,338450,30560,124138.7,592200
53300,188536.1,930650,21210,58356.6,338450,32090,130179.5,592200
55750,204370.9,930650,22100,64896,338450,33650,139474.9,592200
58170,195443.7,930650,22960,59534.5,338450,35210,135909.2,592200
60650,182323.9,930650,23890,56223,338450,36760,126100.9,592200
63170,155805,930650,24820,51069.8,338450,38350,104735.2,592200
65610,180593.7,930650,25750,53030.1,338450,39860,127563.6,592200
68110,184851.8,930650,26680,54000.7,338450,41430,130851.1,592200
67130,159629,930650,26270,51268.4,338450,40860,108360.6,592200
66130,150880,930650,25880,52085.4,338450,40250,98794.6,592200
65150,158659,930650,25480,59093.7,338450,39670,99565.3,592200
64160,165829.4,930650,25100,64167.6,338450,39060,101661.8,592200
62670,169073.3,930650,24240,64705.8,338450,38430,104367.5,592200
61240,174410.6,930650,23400,70332.4,338450,37840,104078.2,592200
59780,174249.1,930650,22500,70916.1,338450,37280,103333,592200
86370,163568.6,930650,41200,68215.4,338450,45170,95353.2,592200
85890,156590.4,930650,41090,67041.8,338450,44800,89548.6,592200
85480,159355.3,930650,40980,70131.9,338450,44500,89223.4,592200
85030,152951.4,930650,40910,64984.7,338450,44120,87966.7,592200
84590,143854.6,930650,40800,56617,338450,43790,87237.6,592200
83170,132859.4,930650,40090,49991.9,338450,43080,82867.5,592200
81750,131350.6,930650,39380,46988.3,338450,42370,84362.3,592200
80330,138454.2,930650,38660,52237.5,338450,41670,86216.7,592200
78920,146045,930650,37930,56688.6,338450,40990,89356.4,592200
78300,144905,930650,37890,56046.2,338450,40410,88858.8,592200
77640,155156.6,930650,37850,55382,338450,39790,99774.6,592200
77000,158486.4,930650,37810,54408.8,338450,39190,104077.6,592200
76350,153075,930650,37750,51051.4,338450,38600,102023.6,592200
75640,156062,930650,37590,51352.7,338450,38050,104709.3,592200
75010,159283.4,930650,37450,53753.6,338450,37560,105529.8,592200
74330,162811,930650,37310,55727.2,338450,37020,107083.8,592200
73650,173937,930650,37150,63084.5,338450,36500,110852.5,592200
73610,183358.8,930650,36870,68852.6,338450,36740,114506.2,592200
73500,184769.5,930650,36590,70223.7,338450,36910,114545.8,592200
73400,162173.2,930650,36310,53705.3,338450,37090,108467.9,592200
73380,163026.3,930650,36010,54807.8,338450,37370,108218.5,592200
72580,156500.1,930650,35110,50696.1,338450,37470,105804,592200
71830,152286.6,930650,34180,49029,338450,37650,103257.6,592200
71060,161055.5,930650,33270,52493.6,338450,37790,108561.9,592200
70360,164965.8,930650,32360,56287.4,338450,38000,108678.4,592200
69880,155092.6,930650,31900,50163.1,338450,37980,104929.5,592200
69360,161096.6,930650,31420,52425.2,338450,37940,108671.4,592200
68910,169343.5,930650,30980,57293,338450,37930,112050.5,592200
68460,169213.7,930650,30530,56881.1,338450,37930,112332.6,592200
69460,165491.4,930650,31190,54182.1,338450,38270,111309.3,592200
70500,160579.7,930650,31870,51801.6,338450,38630,108778.1,592200
71540,163373.8,930650,32540,50906.6,338450,39000,112467.2,592200
72570,167504.9,930650,33190,52991.1,338450,39380,114513.8,592200
73840,180441.3,930650,34150,60723,338450,39690,119718.3,592200
75090,201373.6,930650,35120,71304.7,338450,39970,130068.9,592200
76260,210097.8,930650,36040,79977.4,338450,40220,130120.4,592200
77520,197669.8,930650,36980,75402.8,338450,40540,122267,592200
79040,194095.8,930650,38050,66332.6,338450,40990,127763.2,592200
80480,197910.5,930650,39120,67849.3,338450,41360,130061.2,592200
81920,206646.1,930650,40180,76987.7,338450,41740,129658.4,592200
83390,198633.5,930650,41270,76641.3,338450,42120,121992.2,592200
85280,208917.9,930650,43620,82144.4,338450,41660,126773.5,592200
87200,228837.7,930650,46050,93818,338450,41150,135019.7,592200
89150,227336.2,930650,48420,94951.6,338450,40730,132384.6,592200
91040,220759.6,930650,50790,91767.4,338450,40250,128992.2,592200
92590,211870.3,930650,52840,92130.2,338450,39750,119740.1,592200
94130,221828.5,930650,54880,95596,338450,39250,126232.5,592200
95610,218481.4,930650,56930,90592.8,338450,38680,127888.6,592200
97150,228998.6,930650,58970,92295.7,338450,38180,136702.9,592200
98730,212964.9,930650,61130,92558.7,338450,37600,120406.2,592200
100220,234066.8,930650,63340,97361.4,338450,36880,136705.4,592200
101830,236491.9,930650,65510,102994.4,338450,36320,133497.5,592200
103390,250786.8,930650,67690,116149.5,338450,35700,134637.3,592200
106620,235409.8,930650,71230,114878.6,338450,35390,120531.2,592200
109850,238834.4,930650,74750,107002.5,338450,35100,131831.9,592200
113130,238481.3,930650,78290,104999.2,338450,34840,133482.1,592200
116360,245388,930650,81830,108310.6,338450,34530,137077.4,592200
119800,233782,930650,85420,114389.8,338450,34380,119392.2,592200
123210,258894.3,930650,89050,125653.9,338450,34160,133240.4,592200
126620,254471.4,930650,92650,133245.4,338450,33970,121226,592200
130060,248329.9,930650,96270,128859,338450,33790,119470.9,592200
133430,258842.7,930650,99770,136428.5,338450,33660,122414.2,592200
136830,281027,930650,103280,145583.7,338450,33550,135443.3,592200
140130,265934.9,930650,106750,135752.9,338450,33380,130182,592200
143500,275931.3,930650,110260,140672.6,338450,33240,135258.7,592200
146890,303880.7,930650,111030,156025.4,338450,35860,147855.3,592200
150210,298228.7,930650,111790,151504.8,338450,38420,146723.9,592200
153550,319746.9,930650,112550,161474.4,338450,41000,158272.5,592200
156880,342874,930650,113330,178040.5,338450,43550,164833.5,592200
160670,341139.8,930650,114350,185849.2,338450,46320,155290.6,592200
164380,359506,930650,115390,197835.6,338450,48990,161670.4,592200
168160,373771.7,930650,116440,208802.9,338450,51720,164968.8,592200
171890,394942.5,930650,117480,220619,338450,54410,174323.5,592200
175860,407726.6,930650,118640,224235,338450,57220,183491.6,592200
179840,428322.9,930650,119790,229475,338450,60050,198847.9,592200
183830,435790,930650,120960,229147.6,338450,62870,206642.4,592200
187790,459113.1,930650,122100,243616.9,338450,65690,215496.2,592200
194270,453032.4,930650,125210,244408.8,338450,69060,208623.6,592200
200680,457592.1,930650,128300,242474.4,338450,72380,215117.7,592200
207130,463025.8,930650,131370,244923.5,338450,75760,218102.3,592200
213550,466659.2,930650,134470,246025.1,338450,79080,220634.1,592200
219490,476342.6,930650,137220,252720.6,338450,82270,223622,592200
225370,477286,930650,139990,253311.6,338450,85380,223974.4,592200
231340,489816.8,930650,142750,261664.8,338450,88590,228152,592200
237260,496172.6,930650,145510,261833.5,338450,91750,234339.1,592200
241870,490999.7,930650,147010,258282,338450,94860,232717.7,592200
246690,488250.7,930650,148520,257620.5,338450,98170,230630.2,592200
251310,488626.1,930650,150020,259369.1,338450,101290,229257,592200
255950,489196.9,930650,151490,259832.3,338450,104460,229364.6,592200
255320,485726.3,930650,150730,259147.4,338450,104590,226578.9,592200
254620,505455,930650,149920,265124.7,338450,104700,240330.3,592200
253900,515114.7,930650,149130,266547.6,338450,104770,248567.1,592200
253280,512576.4,930650,148350,262265.3,338450,104930,250311.1,592200
253080,486833.8,930650,147800,246088,338450,105280,240745.8,592200
252830,467853.7,930650,147240,232378.4,338450,105590,235475.3,592200
252690,466428.9,930650,146720,229430.1,338450,105970,236998.8,592200
385020,445898.6,930650,207830,218124.3,338450,177190,227774.3,592200
385830,417597,930650,207640,202664.8,338450,178190,214932.2,592200
386610,408492.2,930650,207390,200057.9,338450,179220,208434.3,592200
387290,423435.9,930650,207170,210498.8,338450,180120,212937.1,592200
388040,415118.8,930650,206960,201518.1,338450,181080,213600.7,592200
382510,401179.5,930650,203200,189887.1,338450,179310,211292.4,592200
377000,402337.2,930650,199460,190446.1,338450,177540,211891.1,592200
371520,373354.4,930650,195720,172300.2,338450,175800,201054.2,592200
365920,356203.2,930650,191980,162129.8,338450,173940,194073.4,592200
358550,342494.7,930650,187750,155750.2,338450,170800,186744.5,592200
351180,346185.3,930650,183540,157701.8,338450,167640,188483.5,592200
343720,343829.1,930650,179300,153856.4,338450,164420,189972.7,592200
336320,342813,930650,175080,146363.6,338450,161240,196449.4,592200
329300,355641.3,930650,171210,157756.6,338450,158090,197884.7,592200
322300,360752.2,930650,167350,165574.6,338450,154950,195177.6,592200
315290,363461.4,930650,163470,173747.8,338450,151820,189713.6,592200
308280,360287.6,930650,159610,170882.1,338450,148670,189405.5,592200
303120,361286.7,930650,156300,169343.3,338450,146820,191943.4,592200
298070,352337.6,930650,153040,160505.6,338450,145030,191832,592200
292990,321885.6,930650,149750,138947.9,338450,143240,182937.7,592200
287880,309001.9,930650,146460,130312.7,338450,141420,178689.2,592200
282480,288052.8,930650,143090,122014.6,338450,139390,166038.2,592200
277060,280860.9,930650,139720,120862.4,338450,137340,159998.5,592200
271590,269040.6,930650,136330,118146.8,338450,135260,150893.8,592200
266160,264790.3,930650,132970,117729.6,338450,133190,147060.7,592200
261150,275747.3,930650,129570,126882.6,338450,131580,148864.7,592200
256180,285724.6,930650,126160,131320.1,338450,130020,154404.5,592200
251140,272424.8,930650,122740,120828.1,338450,128400,151596.7,592200
246180,264548.1,930650,119370,119939.5,338450,126810,144608.6,592200
241110,259203.4,930650,116820,118939.7,338450,124290,140263.7,592200
236070,241346.1,930650,114300,106115.9,338450,121770,135230.2,592200
230970,216298.5,930650,111750,90615,338450,119220,125683.5,592200
225840,211571,930650,109210,87980.8,338450,116630,123590.2,592200
221150,212628.1,930650,107150,87466.4,338450,114000,125161.7,592200
216420,240076.3,930650,105100,99529.8,338450,111320,140546.5,592200
211670,232951.8,930650,103030,100006,338450,108640,132945.8,592200
206960,225237.3,930650,101010,95382.4,338450,105950,129854.9,592200
201280,223474,930650,98230,96397.8,338450,103050,127076.2,592200
195690,208729.7,930650,95460,87744.5,338450,100230,120985.2,592200
190070,193508.8,930650,92710,78365.4,338450,97360,115143.4,592200
184440,187758,930650,89950,75370.1,338450,94490,112387.9,592200
176150,186815,930650,86580,75096.7,338450,89570,111718.3,592200
167930,190499.5,930650,83220,77354.1,338450,84710,113145.4,592200
159720,183535.3,930650,79840,74402.1,338450,79880,109133.2,592200
151410,184526.1,930650,76470,78171.7,338450,74940,106354.4,592200
143010,189107.3,930650,73280,85263.3,338450,69730,103844,592200
134680,181169.6,930650,70100,81729.6,338450,64580,99440,592200
126270,164728.9,930650,66900,71999.6,338450,59370,92729.3,592200
117880,164825.3,930650,63730,73322.5,338450,54150,91502.8,592200
109830,168163.7,930650,60520,76798.1,338450,49310,91365.6,592200
101790,161531.3,930650,57330,74127.4,338450,44460,87403.9,592200
93820,149727.9,930650,54120,68395.2,338450,39700,81332.7,592200
85720,154735.4,930650,50930,71823.5,338450,34790,82911.9,592200
83250,150525.8,930650,50170,68936.6,338450,33080,81589.2,592200
80760,143072.3,930650,49410,65333.5,338450,31350,77738.8,592200
78250,137660.6,930650,48660,62989.7,338450,29590,74670.9,592200
75690,135305.9,930650,47870,61683.9,338450,27820,73622,592200
72690,127377,930650,46250,55395.5,338450,26440,71981.5,592200
69530,116889.3,930650,44590,47152.8,338450,24940,69736.5,592200
66480,116888.9,930650,42930,46833.4,338450,23550,70055.5,592200
63320,118970.6,930650,41270,49539.4,338450,22050,69431.2,592200
60120,127547.1,930650,39250,54890.2,338450,20870,72656.9,592200
57000,118680.3,930650,37210,48153.6,338450,19790,70526.7,592200
53840,118322.5,930650,35210,48209.9,338450,18630,70112.6,592200
50610,118656,930650,33150,48316.1,338450,17460,70339.9,592200
52830,135136.3,930650,33280,55062.5,338450,19550,80073.8,592200
55140,132434.2,930650,33420,57490.2,338450,21720,74944,592200
57350,123024.2,930650,33550,49795.1,338450,23800,73229.1,592200
59590,113526.8,930650,33660,40699.2,338450,25930,72827.6,592200
61880,122804.1,930650,33990,46473,338450,27890,76331.1,592200
64190,122601.8,930650,34360,45065.1,338450,29830,77536.7,592200
66400,122500.6,930650,34670,44136.9,338450,31730,78363.7,592200
68700,120189.5,930650,35020,42876,338450,33680,77313.5,592200
70980,119216.7,930650,35340,41929.4,338450,35640,77287.3,592200
73350,123312.8,930650,35720,45807.5,338450,37630,77505.3,592200
75650,118625.7,930650,36070,42810.4,338450,39580,75815.3,592200
77950,112652.5,930650,36420,39598.8,338450,41530,73053.7,592200
78800,112675.9,930650,35680,39399.2,338450,43120,73276.7,592200
79670,116781.1,930650,34910,42143.5,338450,44760,74637.6,592200
80530,122925.1,930650,34160,44585.3,338450,46370,78339.8,592200
81350,120888.9,930650,33370,41615.5,338450,47980,79273.4,592200
82310,121671.4,930650,32820,39978.7,338450,49490,81692.7,592200
83230,116366.7,930650,32270,36949.9,338450,50960,79416.8,592200
84150,120959.4,930650,31710,40773.1,338450,52440,80186.3,592200
85130,119917.9,930650,31170,39620.6,338450,53960,80297.3,592200
85420,119728.7,930650,29760,37492.9,338450,55660,82235.8,592200
85730,113172.8,930650,28380,31663,338450,57350,81509.8,592200
86130,110176,930650,26980,30296.5,338450,59150,79879.5,592200
86480,111308.5,930650,25620,30147.4,338450,60860,81161.1,592200
85310,106641.6,930650,24680,25500.5,338450,60630,81141.1,592200
84150,102485.4,930650,23750,23524.3,338450,60400,78961.1,592200
83030,99871.2,930650,22830,21633.2,338450,60200,78238,592200
81920,99829,930650,21910,22001,338450,60010,77828,592200
80710,105136.8,930650,20840,23883.4,338450,59870,81253.4,592200
79490,101761.1,930650,19760,20519.5,338450,59730,81241.6,592200
78320,95168.2,930650,18710,15462.4,338450,59610,79705.8,592200
50310,93756.1,930650,13660,14839.5,338450,36650,78916.6,592200
49600,99545.8,930650,12570,18017.3,338450,37030,81528.5,592200
48920,98668.7,930650,11480,16657.9,338450,37440,82010.8,592200
48230,90088.6,930650,10390,10474.5,338450,37840,79614.1,592200
47500,89608.6,930650,9290,10457.6,338450,38210,79151,592200
50230,90132.9,930650,10180,8542.7,338450,40050,81590.2,592200
52980,92085,930650,11090,7676.9,338450,41890,84408.1,592200
55740,90857.1,930650,11970,7441.3,338450,43770,83415.8,592200
58530,101007.5,930650,12870,10379.4,338450,45660,90628.1,592200
61670,104196.4,930650,13950,12071.6,338450,47720,92124.8,592200
64820,107900.1,930650,15000,14936.9,338450,49820,92963.2,592200
68030,104291,930650,16100,11701.4,338450,51930,92589.6,592200
71240,101010.6,930650,17180,10125.1,338450,54060,90885.5,592200
74300,106801.5,930650,18170,13840.7,338450,56130,92960.8,592200
77480,112165.5,930650,19190,16196.7,338450,58290,95968.8,592200
80560,111182.1,930650,20180,12821.8,338450,60380,98360.3,592200
83680,110598.8,930650,21180,10252,338450,62500,100346.8,592200
86320,122121.7,930650,21610,14667.8,338450,64710,107453.9,592200
88930,132903.2,930650,22050,19356.2,338450,66880,113547,592200
91570,133946.2,930650,22470,18839.4,338450,69100,115106.8,592200
94200,132248.8,930650,22910,16894,338450,71290,115354.8,592200
96680,127085.6,930650,23320,13858.5,338450,73360,113227.1,592200
99180,127300.6,930650,23720,12365.3,338450,75460,114935.3,592200
101650,127141.4,930650,24150,10601,338450,77500,116540.4,592200
104150,135845.5,930650,24530,14054.2,338450,79620,121791.3,592200
105660,144164.1,930650,24270,19141.7,338450,81390,125022.4,592200
107180,149641.1,930650,24010,20727.4,338450,83170,128913.7,592200
108760,149317.2,930650,23740,19271.1,338450,85020,130046.1,592200
110300,161515.9,930650,23450,20136.1,338450,86850,141379.8,592200
108620,172889.2,930650,23030,21087.7,338450,85590,151801.5,592200
106970,174463.3,930650,22620,17646.3,338450,84350,156817,592200
105250,176993.3,930650,22180,17376.4,338450,83070,159616.9,592200
103620,180429,930650,21760,22021.4,338450,81860,158407.6,592200
102290,178807.5,930650,21550,22869.5,338450,80740,155938,592200
100900,176634.6,930650,21310,21973.8,338450,79590,154660.8,592200
99600,167354,930650,21130,18627.6,338450,78470,148726.4,592200
98190,158513.7,930650,20880,16219.6,338450,77310,142294.1,592200
96720,149184.2,930650,20360,14924.8,338450,76360,134259.4,592200
95160,139659.3,930650,19830,14111.2,338450,75330,125548.1,592200
93730,122025.8,930650,19310,12267.7,338450,74420,109758.1,592200
92220,114103.5,930650,18760,10127.8,338450,73460,103975.7,592200
87140,107315.1,930650,18100,8349.8,338450,69040,98965.3,592200
82000,94927.3,930650,17400,6729.6,338450,64600,88197.7,592200
76960,93601.2,930650,16750,7616.6,338450,60210,85984.6,592200
71910,88098.5,930650,16070,6596.8,338450,55840,81501.7,592200
65990,85049.5,930650,15320,8027.9,338450,50670,77021.6,592200
60150,83030.5,930650,14570,7547.5,338450,45580,75483,592200
54260,79005.7,930650,13860,6083.3,338450,40400,72922.4,592200
48390,76747.1,930650,13120,5650.2,338450,35270,71096.9,592200
42770,73867.9,930650,12160,4493.7,338450,30610,69374.2,592200
37120,73004.8,930650,11220,4556.3,338450,25900,68448.5,592200
31520,70775.4,930650,10260,4775.9,338450,21260,65999.5,592200
25870,69602.5,930650,9310,5161.3,338450,16560,64441.2,592200
26120,71545.9,930650,9300,5213.5,338450,16820,66332.4,592200
26320,70443.9,930650,9290,5087.4,338450,17030,65356.5,592200
26550,71913.1,930650,9280,5115.4,338450,17270,66797.7,592200
26810,71746.9,930650,9300,5163.5,338450,17510,66583.4,592200
27230,71056.2,930650,9280,5101,338450,17950,65955.2,592200
27610,72368.8,930650,9280,5713.9,338450,18330,66654.9,592200
28050,75415.2,930650,9260,7524.5,338450,18790,67890.7,592200
28520,72885.9,930650,9260,7387.1,338450,19260,65498.8,592200
29240,71506.6,930650,9360,5569.4,338450,19880,65937.2,592200
30040,72189.3,930650,9500,5597,338450,20540,66592.3,592200
30800,76676,930650,9620,8433.1,338450,21180,68242.9,592200
31540,81734.1,930650,9730,10252,338450,21810,71482.1,592200
34500,81174.9,930650,10180,11304.9,338450,24320,69870,592200
37470,91493.9,930650,10640,14186.1,338450,26830,77307.8,592200
40490,101698.2,930650,11110,17832.9,338450,29380,83865.3,592200
43440,103086.6,930650,11600,19911.8,338450,31840,83174.8,592200
46620,103308.3,930650,12190,19581.5,338450,34430,83726.8,592200
49640,103959.5,930650,12770,19956.1,338450,36870,84003.4,592200
52810,111479.7,930650,13320,23121.9,338450,39490,88357.8,592200
55970,119031.7,930650,13910,27521.9,338450,42060,91509.8,592200
59340,128837.5,930650,14670,34526.5,338450,44670,94311,592200
62690,133880.5,930650,15430,36798.6,338450,47260,97081.9,592200
66070,134915.2,930650,16220,35061.9,338450,49850,99853.3,592200
69410,129013.7,930650,16970,31639.7,338450,52440,97374,592200
68000,125956.3,930650,16290,28768.7,338450,51710,97187.6,592200
66490,127482,930650,15580,28316.6,338450,50910,99165.4,592200
65010,132515.8,930650,14890,29619.6,338450,50120,102896.2,592200
63550,128018.4,930650,14200,29708.7,338450,49350,98309.7,592200
61710,129189.3,930650,13310,30852.3,338450,48400,98337,592200
59900,128764.8,930650,12430,30035.5,338450,47470,98729.3,592200
58100,123506.7,930650,11540,30577.2,338450,46560,92929.5,592200
56310,121455.6,930650,10660,27904.3,338450,45650,93551.3,592200
54350,120608.4,930650,9920,27149.7,338450,44430,93458.7,592200
52370,116730.9,930650,9240,25438.6,338450,43130,91292.3,592200
50380,117232,930650,8500,27252.5,338450,41880,89979.5,592200
48430,112588.8,930650,7800,25398.2,338450,40630,87190.6,592200
46100,109100.3,930650,7470,24724.8,338450,38630,84375.5,592200
43830,109437.6,930650,7140,25127.8,338450,36690,84309.8,592200
41510,117118.2,930650,6780,33502.4,338450,34730,83615.8,592200
39250,106538.8,930650,6470,26729.2,338450,32780,79809.6,592200
37110,94004.5,930650,6120,18871,338450,30990,75133.5,592200
34950,84447.8,930650,5790,12958,338450,29160,71489.8,592200
32810,78931.8,930650,5440,10124.1,338450,27370,68807.7,592200
14510,77592.8,930650,1510,10487.7,338450,13000,67105.1,592200
11970,71442.7,930650,1250,7279.1,338450,10720,64163.6,592200
9470,67330.5,930650,970,4936,338450,8500,62394.5,592200
6960,69158.5,930650,670,5598.9,338450,6290,63559.6,592200
4370,68597.8,930650,360,5241.1,338450,4010,63356.7,592200
4090,70102.3,930650,350,5155.8,338450,3740,64946.5,592200
3900,68306.3,930650,340,5101,338450,3560,63205.3,592200
3630,66739.7,930650,330,5062.4,338450,3300,61677.3,592200
3370,67238,930650,310,5088.5,338450,3060,62149.5,592200
3130,68968,930650,300,5151,338450,2830,63817,592200
2900,68095.2,930650,270,5101,338450,2630,62994.2,592200
2660,67018.5,930650,240,5040,338450,2420,61978.5,592200
2450,64906.5,930650,210,4901,338450,2240,60005.5,592200
2240,65017.4,930650,200,4938.5,338450,2040,60078.9,592200
2020,65425.4,930650,190,4951,338450,1830,60474.4,592200
1810,47445.5,930650,180,3543.9,338450,1630,43901.6,592200
1580,60566.3,930650,170,4563.5,338450,1410,56002.8,592200
1580,63252.5,930650,230,4813.5,338450,1350,58439,592200
1620,62234.7,930650,290,4776,338450,1330,57458.7,592200
1620,61219.5,930650,340,4688.5,338450,1280,56531,592200
1550,61180.3,930650,360,4688.5,338450,1190,56491.8,592200
1580,60369.1,930650,430,4701,338450,1150,55668.1,592200
1620,59772.8,930650,490,4663.5,338450,1130,55109.3,592200
1590,59637,930650,540,4663.5,338450,1050,54973.5,592200
1640,59639.8,930650,590,4663.5,338450,1050,54976.3,592200
1670,59779.4,930650,630,4749.2,338450,1040,55030.2,592200
1670,63469.9,930650,700,7352.5,338450,970,56117.4,592200
1660,64745.9,930650,750,8367,338450,910,56378.9,592200
1680,64371.9,930650,810,7858.5,338450,870,56513.4,592200
2040,64244.8,930650,1000,6731.1,338450,1040,57513.7,592200
2400,61790.8,930650,1200,4986.9,338450,1200,56803.9,592200
2730,61786.2,930650,1400,4826,338450,1330,56960.2,592200
3130,61928.4,930650,1600,4813.5,338450,1530,57114.9,592200
3610,63586.6,930650,1900,4972.4,338450,1710,58614.2,592200
4070,62509.7,930650,2190,4872.5,338450,1880,57637.2,592200
4520,60862.2,930650,2490,4701,338450,2030,56161.2,592200
4960,60026,930650,2780,4526,338450,2180,55500,592200
5330,59805.6,930650,2960,4501,338450,2370,55304.6,592200
5660,59878.9,930650,3140,4576,338450,2520,55302.9,592200
6010,59833,930650,3320,4501,338450,2690,55332,592200
6370,59663.1,930650,3510,4488.5,338450,2860,55174.6,592200
6020,59578.6,930650,3370,4501,338450,2650,55077.6,592200
5670,59680.3,930650,3230,4413.5,338450,2440,55266.8,592200
5310,59680.3,930650,3100,4401,338450,2210,55279.3,592200
5000,59711.3,930650,2960,4474.2,338450,2040,55237.1,592200
4550,62403.4,930650,2740,6406.8,338450,1810,55996.6,592200
4170,59879.6,930650,2540,4866.7,338450,1630,55012.9,592200
3680,59943,930650,2320,4893.8,338450,1360,55049.2,592200
3270,59353.3,930650,2100,4515.3,338450,1170,54838,592200
2790,59534.9,930650,1910,4501,338450,880,55033.9,592200
2440,60618.3,930650,1730,4563.5,338450,710,56054.8,592200
2010,61871.3,930650,1540,4676,338450,470,57195.3,592200
1610,63018.3,930650,1360,4801,338450,250,58217.3,592200
1620,60948.1,930650,1320,4651,338450,300,56297.1,592200
1630,57369.8,930650,1260,4351,338450,370,53018.8,592200
1620,51163.4,930650,1210,3813.5,338450,410,47349.9,592200
1610,58382.3,930650,1150,4388.5,338450,460,53993.8,592200
1620,58624.4,930650,1110,4476,338450,510,54148.4,592200
1650,58891.6,930650,1060,4488.5,338450,590,54403.1,592200
1680,59017.2,930650,990,4501,338450,690,54516.2,592200
1650,59791.6,930650,930,4576,338450,720,55215.6,592200
1660,59746,930650,900,4576,338450,760,55170,592200
1700,59773.8,930650,900,4601,338450,800,55172.8,592200
1720,60163.7,930650,860,4601,338450,860,55562.7,592200
1720,60065.9,930650,810,4601,338450,910,55464.9,592200
2010,58750.8,930650,920,4526,338450,1090,54224.8,592200
2270,58578.5,930650,1040,4501,338450,1230,54077.5,592200
2630,58903.8,930650,1180,4501,338450,1450,54402.8,592200
3010,59217.9,930650,1310,4501,338450,1700,54716.9,592200
3350,59407.3,930650,1470,4513.5,338450,1880,54893.8,592200
3680,60139.8,930650,1650,4538.5,338450,2030,55601.3,592200
4090,60086.5,930650,1830,4526,338450,2260,55560.5,592200
4510,60207,930650,2040,4576,338450,2470,55631,592200
4920,60593.5,930650,2230,4626,338450,2690,55967.5,592200
5300,62086.2,930650,2430,4851,338450,2870,57235.2,592200
5780,62218,930650,2630,4863.5,338450,3150,57354.5,592200
6170,62203.9,930650,2810,4826,338450,3360,57377.9,592200
6420,62441,930650,2870,4851,338450,3550,57590,592200
6660,64464,930650,2930,6355.4,338450,3730,58108.6,592200
6910,62305.9,930650,2970,5144,338450,3940,57161.9,592200
7120,64756.4,930650,3030,6269,338450,4090,58487.4,592200
7330,68341.1,930650,3100,8308,338450,4230,60033.1,592200
7560,70464.1,930650,3190,9770.6,338450,4370,60693.5,592200
7800,72127.4,930650,3260,10578.1,338450,4540,61549.3,592200
8040,72172.9,930650,3330,10578,338450,4710,61594.9,592200
8220,78982.4,930650,3420,15443.1,338450,4800,63539.3,592200
8370,74653.9,930650,3490,11920.4,338450,4880,62733.5,592200
8590,81631.5,930650,3570,16472,338450,5020,65159.5,592200
8820,80464.3,930650,3670,15574.2,338450,5150,64890.1,592200
8680,78083.8,930650,3700,14503.2,338450,4980,63580.6,592200
8570,77433.9,930650,3720,14537.5,338450,4850,62896.4,592200
8410,75137.8,930650,3730,12482.9,338450,4680,62654.9,592200
8320,76855.8,930650,3760,13130.4,338450,4560,63725.4,592200
8190,75940.9,930650,3770,11308.1,338450,4420,64632.8,592200
8040,69737.7,930650,3780,7335.8,338450,4260,62401.9,592200
7940,66822.9,930650,3810,5545.1,338450,4130,61277.8,592200
6840,66993.8,930650,1870,5281.5,338450,4970,61712.3,592200
6310,66419.3,930650,1550,5374.8,338450,4760,61044.5,592200
5870,68139.6,930650,1280,7146.1,338450,4590,60993.5,592200
5320,69662.1,930650,990,7969.8,338450,4330,61692.3,592200
4830,69145.4,930650,720,7232.2,338450,4110,61913.2,592200
4650,66665.8,930650,660,5292.3,338450,3990,61373.5,592200
4410,66329.6,930650,560,5230.7,338450,3850,61098.9,592200
4210,65319.1,930650,490,4893.2,338450,3720,60425.9,592200
3970,64130.1,930650,400,4872.2,338450,3570,59257.9,592200
3700,64410.2,930650,380,4909.5,338450,3320,59500.7,592200
3410,62900.2,930650,350,4736.5,338450,3060,58163.7,592200
3150,63291.2,930650,330,5591,338450,2820,57700.2,592200
2900,63031.5,930650,290,5297.6,338450,2610,57733.9,592200
2730,62765,930650,300,5297.8,338450,2430,57467.2,592200
2560,63746.2,930650,280,5861.5,338450,2280,57884.7,592200
2360,64591.9,930650,270,6763,338450,2090,57828.9,592200
2170,63325.1,930650,260,6090.4,338450,1910,57234.7,592200
3720,63088.1,930650,640,5798.1,338450,3080,57290,592200
5240,65015.1,930650,1050,6752.5,338450,4190,58262.6,592200
6760,64426.4,930650,1430,6629.4,338450,5330,57797,592200
8270,68429.2,930650,1820,9175.5,338450,6450,59253.7,592200
9940,72487,930650,2280,11876.7,338450,7660,60610.3,592200
11580,73749.6,930650,2740,12491.1,338450,8840,61258.5,592200
13280,74771.6,930650,3210,11913.9,338450,10070,62857.7,592200
14870,77456.9,930650,3660,12895.7,338450,11210,64561.2,592200
16800,79563.4,930650,4290,13421,338450,12510,66142.4,592200
18790,83001,930650,4890,15697.2,338450,13900,67303.8,592200
20630,83388.1,930650,5480,14799.2,338450,15150,68588.9,592200
22570,85591.6,930650,6110,16181.1,338450,16460,69410.5,592200
24960,86019.8,930650,6870,17393.1,338450,18090,68626.7,592200
27330,89571.6,930650,7650,18631,338450,19680,70940.6,592200
29700,89159.2,930650,8420,16784.9,338450,21280,72374.3,592200
32070,88496.2,930650,9180,15941.6,338450,22890,72554.6,592200
34410,90752.3,930650,9990,16614.2,338450,24420,74138.1,592200
36780,87053.7,930650,10760,13892.8,338450,26020,73160.9,592200
39090,88830.8,930650,11560,14621.5,338450,27530,74209.3,592200
41400,91765.8,930650,12340,16558.6,338450,29060,75207.2,592200
43460,87426.2,930650,12740,13533.3,338450,30720,73892.9,592200
45470,86614.2,930650,13140,13283.6,338450,32330,73330.6,592200
47410,89232,930650,13540,12726.4,338450,33870,76505.6,592200
49410,85400.5,930650,13930,12612.6,338450,35480,72787.9,592200
47520,91883.9,930650,13730,17858.8,338450,33790,74025.1,592200
45650,93143.8,930650,13510,19851,338450,32140,73292.8,592200
43710,93042.2,930650,13280,20637.3,338450,30430,72404.9,592200
41800,91512,930650,13080,19216.5,338450,28720,72295.5,592200
39560,91257,930650,12860,18256.6,338450,26700,73000.4,592200
37320,91098,930650,12690,18409,338450,24630,72689,592200
35060,96181.1,930650,12470,23045.4,338450,22590,73135.7,592200
32850,95605.5,930650,12270,23017.8,338450,20580,72587.7,592200
30030,89594.5,930650,11890,19490.3,338450,18140,70104.2,592200
27180,91139.2,930650,11530,21296.4,338450,15650,69842.8,592200
24350,91035.5,930650,11150,22118.9,338450,13200,68916.6,592200
21540,93366.9,930650,10790,24201.7,338450,10750,69165.2,592200
21540,95927.3,930650,10610,25651.5,338450,10930,70275.8,592200
21470,95743.5,930650,10400,24589.7,338450,11070,71153.8,592200
21430,93899.3,930650,10220,23841.1,338450,11210,70058.2,592200
21340,90913,930650,10030,20669.1,338450,11310,70243.9,592200
21690,93299.4,930650,9860,22816.7,338450,11830,70482.7,592200
22010,93956.7,930650,9660,23577.6,338450,12350,70379.1,592200
22280,92809.9,930650,9460,22272.8,338450,12820,70537.1,592200
22600,90808.7,930650,9280,20761.3,338450,13320,70047.4,592200
23510,86277.2,930650,9590,18369.6,338450,13920,67907.6,592200
24440,90510.1,930650,9910,21673.6,338450,14530,68836.5,592200
25360,91058.7,930650,10200,21814.8,338450,15160,69243.9,592200
26250,94222.9,930650,10520,23134.7,338450,15730,71088.2,592200
34050,110189.3,930650,13550,34045.3,338450,20500,76144,592200
41850,109642.4,930650,16590,33569.6,338450,25260,76072.8,592200
49690,100554.6,930650,19650,27139.3,338450,30040,73415.3,592200
57570,100392.8,930650,22700,27236.5,338450,34870,73156.3,592200
65690,102684.6,930650,25890,27017.1,338450,39800,75667.5,592200
73880,107991.6,930650,29080,28997.2,338450,44800,78994.4,592200
82070,115197.8,930650,32300,29755.5,338450,49770,85442.3,592200
90140,120236.8,930650,35470,32618.8,338450,54670,87618,592200
98920,132013.5,930650,39060,39104.1,338450,59860,92909.4,592200
107720,144235.6,930650,42620,44977.3,338450,65100,99258.3,592200
116480,153478.9,930650,46170,49669.8,338450,70310,103809.1,592200
125310,165920.4,930650,49740,53518.1,338450,75570,112402.3,592200
133200,174390.7,930650,53490,53609,338450,79710,120781.7,592200
141160,176488.4,930650,57260,53707.5,338450,83900,122780.9,592200
149170,195578.6,930650,61000,64257.1,338450,88170,131321.5,592200
157080,206393.4,930650,64750,71341.2,338450,92330,135052.2,592200
164420,205556.1,930650,67830,67219.5,338450,96590,138336.6,592200
171720,206409.6,930650,70910,64341,338450,100810,142068.6,592200
179060,209843.5,930650,73980,64556.8,338450,105080,145286.7,592200
186370,217373.8,930650,77080,70004.3,338450,109290,147369.5,592200
193920,231830.6,930650,80790,77792.5,338450,113130,154038.1,592200
201440,244947.2,930650,84500,81372.5,338450,116940,163574.7,592200
208930,257181.9,930650,88200,87838.6,338450,120730,169343.3,592200
216510,275296.4,930650,91910,94402.5,338450,124600,180893.9,592200
222570,301180.9,930650,94580,112599.3,338450,127990,188581.6,592200
228650,297174.2,930650,97240,109292.4,338450,131410,187881.8,592200
234690,304004.7,930650,99910,114621.9,338450,134780,189382.8,592200
240810,307041.1,930650,102580,118674.2,338450,138230,188366.9,592200
247410,337194.6,930650,105420,139480.1,338450,141990,197714.5,592200
253920,334376.5,930650,108240,130669.6,338450,145680,203706.9,592200
260400,353205.7,930650,111070,133897.9,338450,149330,219307.8,592200
280670,378609.8,930650,120080,149117.1,338450,160590,229492.7,592200
288320,362626.8,930650,123740,140649.6,338450,164580,221977.2,592200
296070,344327.2,930650,127390,130861.3,338450,168680,213465.9,592200
303770,327943.5,930650,131060,123027.8,338450,172710,204915.7,592200
311500,329457,930650,134720,122457.2,338450,176780,206999.8,592200
315540,345913.7,930650,136180,130446.1,338450,179360,215467.6,592200
319670,371128.3,930650,137680,143873,338450,181990,227255.3,592200
323700,408876.4,930650,139150,166946.6,338450,184550,241929.8,592200
327760,423646.7,930650,140630,185104.5,338450,187130,238542.2,592200
330860,413654.8,930650,142010,170889.6,338450,188850,242765.2,592200
333980,373333.4,930650,143410,148546.4,338450,190570,224787,592200
337110,375348.1,930650,144810,157366.5,338450,192300,217981.6,592200
340180,385606.9,930650,146190,153966.8,338450,193990,231640.1,592200
342850,386021.6,930650,147370,146923.1,338450,195480,239098.5,592200
345500,375628.2,930650,148520,137901,338450,196980,237727.2,592200
348220,350885.4,930650,149700,125145.5,338450,198520,225739.9,592200
350890,334939.6,930650,150860,120749.3,338450,200030,214190.3,592200
350860,325688.9,930650,150000,121922.8,338450,200860,203766.1,592200
350920,306527.2,930650,149170,110458.7,338450,201750,196068.5,592200
350880,304225.5,930650,148300,112420.8,338450,202580,191804.7,592200
350840,320239.9,930650,147430,121584.5,338450,203410,198655.4,592200
350280,339791.4,930650,146340,137518.8,338450,203940,202272.6,592200
349770,314801.8,930650,145250,122354.4,338450,204520,192447.4,592200
349240,317616.7,930650,144190,119476.3,338450,205050,198140.4,592200
348660,296151.1,930650,143090,103559.7,338450,205570,192591.4,592200
348210,303674.4,930650,142120,100468.2,338450,206090,203206.2,592200
347710,300695.8,930650,141130,94110.7,338450,206580,206585.1,592200
347240,312828.5,930650,140150,102541.8,338450,207090,210286.7,592200
346810,328854.7,930650,139180,114133.4,338450,207630,214721.3,592200
346380,336146.5,930650,140050,123541.6,338450,206330,212604.9,592200
346010,345010.9,930650,140930,130975.6,338450,205080,214035.3,592200
345570,344435.3,930650,141810,129611.7,338450,203760,214823.6,592200
345200,358270.2,930650,142710,139736.4,338450,202490,218533.8,592200
343790,370705.3,930650,143140,149976.8,338450,200650,220728.5,592200
342270,368272.5,930650,143600,149167.1,338450,198670,219105.4,592200
340790,381794.4,930650,144040,152903.5,338450,196750,228890.9,592200
339310,396197.8,930650,144490,162655.7,338450,194820,233542.1,592200
337420,382936.5,930650,145140,158739.4,338450,192280,224197.1,592200
335510,383734,930650,145820,160540.5,338450,189690,223193.5,592200
333620,364598.8,930650,146460,148709.1,338450,187160,215889.7,592200
331690,354567.9,930650,147110,140110.4,338450,184580,214457.5,592200
326130,371961.1,930650,146390,150683.7,338450,179740,221277.4,592200
320620,369926.3,930650,145650,151990.8,338450,174970,217935.5,592200
314980,358540.5,930650,144920,151986,338450,170060,206554.5,592200
309410,334220.4,930650,144190,140422.3,338450,165220,193798.1,592200
303420,323244.1,930650,143020,133853.3,338450,160400,189390.8,592200
297370,314022.4,930650,141900,132641.2,338450,155470,181381.2,592200
291390,285468.2,930650,140740,125210.9,338450,150650,160257.3,592200
285370,275615.3,930650,139590,120890.2,338450,145780,154725.1,592200
279690,243816.1,930650,138470,115954.7,338450,141220,127861.4,592200
274030,237555.2,930650,137380,114873.4,338450,136650,122681.8,592200
268340,251674.1,930650,136230,127552.3,338450,132110,124121.8,592200
262650,244732.9,930650,135110,133563.1,338450,127540,111169.8,592200
254400,215232.5,930650,131470,113471.4,338450,122930,101761.1,592200
246060,189341.5,930650,127780,93783.2,338450,118280,95558.3,592200
237830,201213.1,930650,124140,92550.6,338450,113690,108662.5,592200
229480,198732.1,930650,120470,89110.8,338450,109010,109621.3,592200
220680,207154.6,930650,116450,92808.4,338450,104230,114346.2,592200
211750,186179.5,930650,112390,91048,338450,99360,95131.5,592200
202920,167399.2,930650,108360,76086.5,338450,94560,91312.7,592200
193980,181274.1,930650,104340,74063.8,338450,89640,107210.3,592200
184240,182055.2,930650,98840,74561.7,338450,85400,107493.5,592200
174580,184203.6,930650,93390,77663.8,338450,81190,106539.8,592200
164810,198768,930650,87930,85039.9,338450,76880,113728.1,592200
155110,208381.2,930650,82450,93340.5,338450,72660,115040.7,592200
151910,195930.1,930650,78160,81924.6,338450,73750,114005.5,592200
148730,187981.6,930650,73870,74629.8,338450,74860,113351.8,592200
145500,195324.8,930650,69580,76879.6,338450,75920,118445.2,592200
142290,203685.8,930650,65300,78865.5,338450,76990,124820.3,592200
139970,220515.5,930650,61950,83279,338450,78020,137236.5,592200
137630,228901.8,930650,58610,83791.6,338450,79020,145110.2,592200
135340,259176.4,930650,55270,106180.3,338450,80070,152996.1,592200
132990,255435.5,930650,51890,106500.7,338450,81100,148934.8,592200
131460,234127.6,930650,49230,93084.8,338450,82230,141042.8,592200
129870,180372.5,930650,46510,53156.5,338450,83360,127216,592200
128350,154884.7,930650,43850,37861.8,338450,84500,117022.9,592200
126830,177675.8,930650,41150,51086.4,338450,85680,126589.4,592200
126130,188492,930650,41240,58183.6,338450,84890,130308.4,592200
125510,184786,930650,41340,55568.9,338450,84170,129217.1,592200
124830,172358,930650,41440,43887.8,338450,83390,128470.2,592200
124150,164245.4,930650,41530,38360.4,338450,82620,125885,592200
124900,151358.4,930650,42980,31242.8,338450,81920,120115.6,592200
125610,147369.2,930650,44400,30330.5,338450,81210,117038.7,592200
126310,140237.8,930650,45860,25835.7,338450,80450,114402.1,592200
126990,129516.2,930650,47270,23465,338450,79720,106051.2,592200
127790,130898.4,930650,48380,30618.8,338450,79410,100279.6,592200
128520,136720.8,930650,49470,32738.1,338450,79050,103982.7,592200
129330,128573,930650,50570,29513.8,338450,78760,99059.2,592200
130090,121565,930650,51660,25433.9,338450,78430,96131.1,592200
127930,119610.3,930650,49450,24065.5,338450,78480,95544.8,592200
125720,119592.9,930650,47260,24826.6,338450,78460,94766.3,592200
123460,118406.3,930650,45050,26518.5,338450,78410,91887.8,592200
121280,112153.5,930650,42840,22963,338450,78440,89190.5,592200
120810,102621,930650,42360,16442.6,338450,78450,86178.4,592200
120370,99908.2,930650,41880,16272,338450,78490,83636.2,592200
119990,102701,930650,41390,17362.1,338450,78600,85338.9,592200
73770,122118.5,930650,27780,30894.4,338450,45990,91224.1,592200
72730,141438.9,930650,28110,45076.6,338450,44620,96362.3,592200
71630,128349,930650,28450,36611.7,338450,43180,91737.3,592200
70600,112402.8,930650,28770,26921.8,338450,41830,85481,592200
69490,106049.7,930650,29090,24124.7,338450,40400,81925,592200
69110,101533.2,930650,29530,24830.7,338450,39580,76702.5,592200
68830,118076.9,930650,30030,34468.7,338450,38800,83608.2,592200
68550,130046.4,930650,30490,40144.9,338450,38060,89901.5,592200
68140,129433.9,930650,30930,40082.4,338450,37210,89351.5,592200
68060,118627.1,930650,31850,32586.2,338450,36210,86040.9,592200
67960,121810.3,930650,32750,34185.9,338450,35210,87624.4,592200
67870,108834.8,930650,33650,31077.9,338450,34220,77756.9,592200
67820,77870.4,930650,34570,21957.9,338450,33250,55912.5,592200
67490,78372.4,930650,35330,22010.8,338450,32160,56361.6,592200
67180,85973.3,930650,36060,19345.2,338450,31120,66628.1,592200
66900,101817.8,930650,36840,22999.3,338450,30060,78818.5,592200
66580,107053.4,930650,37590,28544.1,338450,28990,78509.3,592200
66750,119814.8,930650,37650,40572.9,338450,29100,79241.9,592200
66940,106468.8,930650,37710,31543.6,338450,29230,74925.2,592200
67140,105572.5,930650,37740,32416.7,338450,29400,73155.8,592200
67260,105945.3,930650,37800,32830.6,338450,29460,73114.7,592200
67620,113746,930650,37740,37945.1,338450,29880,75800.9,592200
67860,119137.3,930650,37650,43185.2,338450,30210,75952.1,592200
68120,128170.7,930650,37580,49035.1,338450,30540,79135.6,592200
68420,127744.9,930650,37500,47521.2,338450,30920,80223.7,592200
68500,130030.3,930650,37220,47908,338450,31280,82122.3,592200
68650,131528.2,930650,36920,48535.2,338450,31730,82993,592200
68850,132729.6,930650,36640,50393.3,338450,32210,82336.3,592200
69020,148197.6,930650,36360,60103,338450,32660,88094.6,592200
69190,148132.3,930650,35790,57499.7,338450,33400,90632.6,592200
69360,144515.1,930650,35220,51904.3,338450,34140,92610.8,592200
69540,135894.7,930650,34650,43347.1,338450,34890,92547.6,592200
69610,125907,930650,34090,35568,338450,35520,90339,592200
69250,117549,930650,32930,28693,338450,36320,88856,592200
68870,117907.6,930650,31760,29144.8,338450,37110,88762.8,592200
68520,115717,930650,30640,29028.8,338450,37880,86688.2,592200
68150,111046.4,930650,29490,26712.8,338450,38660,84333.6,592200
67800,109598.1,930650,28500,27460.4,338450,39300,82137.7,592200
67510,112902.5,930650,27540,29781.3,338450,39970,83121.2,592200
67090,109468,930650,26540,27768.6,338450,40550,81699.4,592200
66770,100776.5,930650,25540,22211.9,338450,41230,78564.6,592200
65180,102593.8,930650,24380,21040.3,338450,40800,81553.5,592200
63540,99357.2,930650,23210,18471.6,338450,40330,80885.6,592200
61940,92574.9,930650,22030,12072.8,338450,39910,80502.1,592200
60360,92469.4,930650,20870,10180.4,338450,39490,82289,592200
58170,91769,930650,19690,10390.9,338450,38480,81378.1,592200
56080,98511.7,930650,18510,10882.2,338450,37570,87629.5,592200
53950,97768,930650,17330,9148.5,338450,36620,88619.5,592200
51800,92968.7,930650,16150,6881.4,338450,35650,86087.3,592200
50210,90163,930650,15080,5817.4,338450,35130,84345.6,592200
48660,92006.9,930650,14040,7215.3,338450,34620,84791.6,592200
47060,87683.2,930650,12980,6733.3,338450,34080,80949.9,592200
45490,81589.7,930650,11920,5775.1,338450,33570,75814.6,592200
44880,77334.6,930650,11710,6622.2,338450,33170,70712.4,592200
44190,72495.9,930650,11460,5962.9,338450,32730,66533,592200
43610,71879,930650,11240,4790.7,338450,32370,67088.3,592200
42930,72958.9,930650,11030,4703.5,338450,31900,68255.4,592200
41870,72829.9,930650,10660,4752.1,338450,31210,68077.8,592200
40820,72844.6,930650,10300,5346,338450,30520,67498.6,592200
39720,71044.9,930650,9900,4752,338450,29820,66292.9,592200
38630,70882.7,930650,9510,4473.9,338450,29120,66408.8,592200
37720,69245.5,930650,9180,4210.4,338450,28540,65035.1,592200
36860,69152.3,930650,8830,3883,338450,28030,65269.3,592200
35910,69167.7,930650,8490,3740.8,338450,27420,65426.9,592200
35060,69429.5,930650,8180,3864.9,338450,26880,65564.6,592200
35450,64566.3,930650,8170,3530.8,338450,27280,61035.5,592200
35960,45595.4,930650,8150,3154.9,338450,27810,42440.5,592200
36360,45073.6,930650,8140,3129.7,338450,28220,41943.9,592200
36790,45819.7,930650,8120,2794.6,338450,28670,43025.1,592200
37090,46875.8,930650,8080,2034.3,338450,29010,44841.5,592200
37320,46952.7,930650,8010,1851,338450,29310,45101.7,592200
37580,47891.9,930650,7960,2087.5,338450,29620,45804.4,592200
37790,47187.6,930650,7890,2396.8,338450,29900,44790.8,592200
38040,48685.5,930650,7870,2810.5,338450,30170,45875,592200
38240,46958.9,930650,7880,2513.7,338450,30360,44445.2,592200
38440,48709.9,930650,7880,3133.1,338450,30560,45576.8,592200
38660,50192.6,930650,7890,3870.1,338450,30770,46322.5,592200
39180,51852.4,930650,8010,4672.2,338450,31170,47180.2,592200
39800,50526.3,930650,8160,4453.9,338450,31640,46072.4,592200
40340,46766.9,930650,8290,3378.4,338450,32050,43388.5,592200
40920,51039.2,930650,8430,5233.6,338450,32490,45805.6,592200
41510,48270.8,930650,8490,3875.5,338450,33020,44395.3,592200
42100,46683,930650,8560,3087,338450,33540,43596,592200
42690,43984.9,930650,8620,1931,338450,34070,42053.9,592200
43280,44284.2,930650,8680,1305.8,338450,34600,42978.4,592200
44040,48485.9,930650,8930,1595.8,338450,35110,46890.1,592200
44700,46875.3,930650,9140,1503.3,338450,35560,45372,592200
45390,44188.4,930650,9380,819.1,338450,36010,43369.3,592200
46120,43719.2,930650,9610,1104.4,338450,36510,42614.8,592200
49640,43469.8,930650,11110,1626.1,338450,38530,41843.7,592200
53010,56295.2,930650,12560,2411.6,338450,40450,53883.6,592200
56430,68582,930650,14030,3268.9,338450,42400,65313.1,592200
59880,69586.2,930650,15510,3833.5,338450,44370,65752.7,592200
63290,76195.4,930650,16990,6166.9,338450,46300,70028.5,592200
66660,84525.7,930650,18480,10939.2,338450,48180,73586.5,592200
70010,88354.1,930650,19970,13401.7,338450,50040,74952.4,592200
73850,94928.3,930650,21420,16711.1,338450,52430,78217.2,592200
75610,105982.9,930650,22030,22297.9,338450,53580,83685,592200
77480,109390.9,930650,22650,24202.8,338450,54830,85188.1,592200
79320,120826.9,930650,23250,31150.9,338450,56070,89676,592200
81030,124930.3,930650,23860,31150.7,338450,57170,93779.6,592200
83260,124147.5,930650,25970,30381.5,338450,57290,93766,592200
85380,123185,930650,28070,28966.6,338450,57310,94218.4,592200
87520,121371.5,930650,30170,26875,338450,57350,94496.5,592200
89750,120725.2,930650,32280,25873.8,338450,57470,94851.4,592200
91350,128019.4,930650,33960,29990,338450,57390,98029.4,592200
92950,133938.1,930650,35630,33185.4,338450,57320,100752.7,592200
94620,128738.5,930650,37330,32702.9,338450,57290,96035.6,592200
96110,124966.4,930650,38960,31822.2,338450,57150,93144.2,592200
98550,127688.5,930650,41310,32998.1,338450,57240,94690.4,592200
100870,136445.3,930650,43660,37598.9,338450,57210,98846.4,592200
103270,135410.6,930650,46030,35127.5,338450,57240,100283.1,592200
105650,142291.5,930650,48340,38608.6,338450,57310,103682.9,592200
107840,142671.6,930650,49060,41120.9,338450,58780,101550.7,592200
110050,137980.2,930650,49770,40687.1,338450,60280,97293.1,592200
112290,155377.8,930650,50450,51381.5,338450,61840,103996.3,592200
114480,145839.5,930650,51150,43301.5,338450,63330,102538,592200
116900,138332.2,930650,52360,37478.5,338450,64540,100853.7,592200
119360,125143.5,930650,53550,28722.2,338450,65810,96421.3,592200
121800,125972.1,930650,54780,29837.3,338450,67020,96134.8,592200
124180,130735.4,930650,55970,33593.8,338450,68210,97141.6,592200
126170,141741.5,930650,56400,40355,338450,69770,101386.5,592200
128210,145740.8,930650,56800,41590.6,338450,71410,104150.2,592200
130190,147658.7,930650,57210,43713.4,338450,72980,103945.3,592200
132230,154001.6,930650,57650,49078.5,338450,74580,104923.1,592200
135370,161983.5,930650,59560,53210.6,338450,75810,108772.9,592200
138500,163041.8,930650,61460,52612.1,338450,77040,110429.7,592200
141650,172170.7,930650,63360,58840.1,338450,78290,113330.6,592200
144850,170045.7,930650,65260,59058.9,338450,79590,110986.8,592200
147690,181443,930650,66940,64013.5,338450,80750,117429.5,592200
150560,200642,930650,68570,73757.1,338450,81990,126884.9,592200
153460,204398.4,930650,70210,73902.2,338450,83250,130496.2,592200
156350,222629.9,930650,71850,81771.1,338450,84500,140858.8,592200
159540,207859.3,930650,73480,71303.2,338450,86060,136556.1,592200
162780,213191.2,930650,75130,75625.7,338450,87650,137565.5,592200
165930,212663.9,930650,76760,78655.7,338450,89170,134008.2,592200
169180,216843.9,930650,78400,81851.5,338450,90780,134992.4,592200
170020,209879.6,930650,79150,74486.4,338450,90870,135393.2,592200
170850,206222.1,930650,79950,72453.3,338450,90900,133768.8,592200
171700,200029.8,930650,80720,69453.6,338450,90980,130576.2,592200
172500,188616.5,930650,81480,69540.3,338450,91020,119076.2,592200
172450,187300.3,930650,81800,67366.7,338450,90650,119933.6,592200
172420,192704.5,930650,82120,69545.1,338450,90300,123159.4,592200
172370,194271.9,930650,82410,70877.1,338450,89960,123394.8,592200
172380,189725.4,930650,82720,69485.2,338450,89660,120240.2,592200
173380,180888.6,930650,84150,65619.5,338450,89230,115269.1,592200
174380,198306.4,930650,85580,77237.7,338450,88800,121068.7,592200
175360,229315.6,930650,87030,96358.9,338450,88330,132956.7,592200
176410,232154.8,930650,88440,99382.5,338450,87970,132772.3,592200
176360,227392.1,930650,90420,96432.1,338450,85940,130960,592200
176420,240955.2,930650,92390,106289.8,338450,84030,134665.4,592200
176280,233493.4,930650,94340,101269.2,338450,81940,132224.2,592200
176220,213576.7,930650,96320,89951.3,338450,79900,123625.4,592200
175900,189342.7,930650,97500,79244.9,338450,78400,110097.8,592200
175570,192388.8,930650,98680,81944.1,338450,76890,110444.7,592200
175210,188563.4,930650,99860,76920.3,338450,75350,111643.1,592200
174860,191536,930650,101020,81618.5,338450,73840,109917.5,592200
174140,216590.8,930650,102070,99974.5,338450,72070,116616.3,592200
173530,247214.3,930650,103120,112509,338450,70410,134705.3,592200
172890,215602.3,930650,104200,89580.9,338450,68690,126021.4,592200
172220,228326.8,930650,105240,98951,338450,66980,129375.8,592200
177900,251403.2,930650,107440,112776.5,338450,70460,138626.7,592200
183640,292736.8,930650,109650,139638.4,338450,73990,153098.4,592200
189320,272193.5,930650,111840,127431.6,338450,77480,144761.9,592200
195080,251968.4,930650,114060,125892.6,338450,81020,126075.8,592200
200210,270885.1,930650,115560,131534,338450,84650,139351.1,592200
205340,317498.3,930650,117090,149941.3,338450,88250,167557,592200
210510,328281.3,930650,118630,167161.8,338450,91880,161119.5,592200
215600,333449.3,930650,120130,168730.1,338450,95470,164719.2,592200
220680,295877.6,930650,121920,140214.2,338450,98760,155663.4,592200
225650,306982,930650,123690,145215.7,338450,101960,161766.3,592200
230670,300358.7,930650,125470,149449.6,338450,105200,150909.1,592200
235700,311961.6,930650,127250,159691.8,338450,108450,152269.8,592200
238800,334247.4,930650,128080,161480.3,338450,110720,172767.1,592200
241900,317088.2,930650,128890,151249.2,338450,113010,165839,592200
245030,330693.6,930650,129710,154358.4,338450,115320,176335.2,592200
248080,365133.4,930650,130530,174891.9,338450,117550,190241.5,592200
250920,403640.6,930650,130940,189726.6,338450,119980,213914,592200
253700,373861.9,930650,131340,172220.2,338450,122360,201641.7,592200
256530,377710.4,930650,131770,181702.8,338450,124760,196007.6,592200
259350,363272.8,930650,132200,179896.8,338450,127150,183376,592200
262680,310608.4,930650,132870,149159.8,338450,129810,161448.6,592200
266080,313601.8,930650,133600,144707.7,338450,132480,168894.1,592200
269520,337013,930650,134310,153669.1,338450,135210,183343.9,592200
272910,350147.6,930650,135030,158436.9,338450,137880,191710.7,592200
273220,350394.8,930650,135170,168325.3,338450,138050,182069.5,592200
273490,350175.7,930650,135290,170116.2,338450,138200,180059.5,592200
273790,324462.5,930650,135410,155421.8,338450,138380,169040.7,592200
274100,324668.6,930650,135550,152637,338450,138550,172031.6,592200
274540,337705.1,930650,135510,159942.6,338450,139030,177762.5,592200
275020,336169.2,930650,135460,165320.3,338450,139560,170848.9,592200
275460,314218.2,930650,135400,158965.8,338450,140060,155252.4,592200
320470,335759.4,930650,166300,173922.2,338450,154170,161837.2,592200
318920,336573,930650,165350,171837.7,338450,153570,164735.3,592200
317380,361156.7,930650,164420,190991.5,338450,152960,170165.2,592200
315840,365109.6,930650,163460,196811.1,338450,152380,168298.5,592200
314370,358458.1,930650,162500,194377.2,338450,151870,164080.9,592200
315220,369988.6,930650,162880,196267.9,338450,152340,173720.7,592200
316040,353874.3,930650,163270,188258,338450,152770,165616.3,592200
316910,339912.2,930650,163660,178215.8,338450,153250,161696.4,592200
317750,323059.3,930650,164030,167408.4,338450,153720,155650.9,592200
318070,317021.1,930650,164130,166821.1,338450,153940,150200,592200
318540,310218,930650,164270,157005.6,338450,154270,153212.4,592200
318770,304343.7,930650,164330,152750.2,338450,154440,151593.5,592200
319160,322069,930650,164440,162232.6,338450,154720,159836.4,592200
320720,325882.1,930650,165100,162234.4,338450,155620,163647.7,592200
322240,335242.2,930650,165750,165804.1,338450,156490,169438.1,592200
323740,358157.7,930650,166410,183512.5,338450,157330,174645.2,592200
325320,375527.8,930650,167080,193435.8,338450,158240,182092,592200
327080,374302.7,930650,167760,193079.4,338450,159320,181223.3,592200
328930,375070.7,930650,168500,198002.8,338450,160430,177067.9,592200
330780,392157.7,930650,169210,212547.2,338450,161570,179610.5,592200
332600,395648.1,930650,169920,212762.8,338450,162680,182885.3,592200
334510,401161.6,930650,170540,213054.5,338450,163970,188107.1,592200
336360,403642.5,930650,171170,211581.5,338450,165190,192061,592200
338150,406346.7,930650,171790,208995.2,338450,166360,197351.5,592200
340030,410279,930650,172420,211187.9,338450,167610,199091.1,592200
342700,401496.6,930650,173870,204535.6,338450,168830,196961,592200
345410,401768.6,930650,175290,207647.2,338450,170120,194121.4,592200
348050,401149.9,930650,176760,209969.8,338450,171290,191180.1,592200
350770,405498.9,930650,178230,210650.7,338450,172540,194848.2,592200
354240,414655.9,930650,180360,218487.7,338450,173880,196168.2,592200
357660,404347.9,930650,182520,213833.1,338450,175140,190514.8,592200
361130,404773,930650,184660,209325.6,338450,176470,195447.4,592200
364610,423127,930650,186800,215785.9,338450,177810,207341.1,592200
367160,425223.5,930650,188230,213808.1,338450,178930,211415.4,592200
369760,435874.9,930650,189660,217484.4,338450,180100,218390.5,592200
372320,451541.1,930650,191070,227145.8,338450,181250,224395.3,592200
374930,457160.5,930650,192490,232335.1,338450,182440,224825.4,592200
376740,450187.3,930650,193700,230365.5,338450,183040,219821.8,592200
378680,441047.9,930650,194930,228435.8,338450,183750,212612.1,592200
380550,443223.2,930650,196170,230774.5,338450,184380,212448.7,592200
382410,451323.2,930650,197400,233549.2,338450,185010,217774,592200
377950,440091.5,930650,196540,229101.6,338450,181410,210989.9,592200
373440,431393.1,930650,195720,224661.4,338450,177720,206731.7,592200
368920,425950.3,930650,194890,223130.5,338450,174030,202819.8,592200
364380,428752.8,930650,194040,219162.6,338450,170340,209590.2,592200
359420,434887.3,930650,193090,220336.2,338450,166330,214551.1,592200
354390,427446.7,930650,192150,221759.1,338450,162240,205687.6,592200
349450,424656.8,930650,191200,225266,338450,158250,199390.8,592200
344440,424829.3,930650,190240,226932.5,338450,154200,197896.8,592200
340090,410746,930650,189470,221303,338450,150620,189443,592200
335850,391233.1,930650,188700,213691,338450,147150,177542.1,592200
331560,383687.3,930650,187900,210247.9,338450,143660,173439.4,592200
327220,391286.5,930650,187110,219331.9,338450,140110,171954.6,592200
324960,385393.5,930650,185950,220815.3,338450,139010,164578.2,592200
322650,383636.6,930650,184750,215505.2,338450,137900,168131.4,592200
320380,368456.5,930650,183600,206262.7,338450,136780,162193.8,592200
318090,364412.8,930650,182440,207048.3,338450,135650,157364.5,592200
316110,363109.1,930650,181350,202036,338450,134760,161073.1,592200
314110,351020.6,930650,180310,197070,338450,133800,153950.6,592200
312120,367038,930650,179250,204049.5,338450,132870,162988.5,592200
310060,358337.8,930650,178190,196916.4,338450,131870,161421.4,592200
308830,369397.1,930650,177550,194901.7,338450,131280,174495.4,592200
307510,349420.8,930650,176900,194940.6,338450,130610,154480.2,592200
306290,334533.5,930650,176260,188866.7,338450,130030,145666.8,592200
305010,332817.1,930650,175610,183982.5,338450,129400,148834.6,592200
311770,363228.5,930650,177670,199761.1,338450,134100,163467.4,592200
318500,366078,930650,179720,204099.9,338450,138780,161978.1,592200
325230,358262.6,930650,181760,195653.6,338450,143470,162609,592200
332000,348919.5,930650,183830,186372.3,338450,148170,162547.2,592200
338890,388088.1,930650,185700,201418.4,338450,153190,186669.7,592200
346010,402130.5,930650,187630,211633.8,338450,158380,190496.7,592200
353030,399646.8,930650,189510,217213.5,338450,163520,182433.3,592200
360040,406270.7,930650,191380,214473.5,338450,168660,191797.2,592200
366620,415902.9,930650,192990,215530.2,338450,173630,200372.7,592200
373220,428966.7,930650,194610,215440,338450,178610,213526.7,592200
379810,372163.5,930650,196190,184462.5,338450,183620,187701,592200
386400,372416.6,930650,197790,189660.2,338450,188610,182756.4,592200
388510,391066.9,930650,198040,204995.7,338450,190470,186071.2,592200
390640,400375.1,930650,198270,212120.2,338450,192370,188254.9,592200
392770,408359,930650,198510,216280.2,338450,194260,192078.8,592200
394840,419991.9,930650,198760,219109.6,338450,196080,200882.3,592200
396900,402723.8,930650,199170,211990.1,338450,197730,190733.7,592200
398960,385072.9,930650,199590,204294.3,338450,199370,180778.6,592200
401150,389949.4,930650,200030,206413.5,338450,201120,183535.9,592200
403230,384221.8,930650,200450,202610.2,338450,202780,181611.6,592200
404830,386729.3,930650,200950,198599.3,338450,203880,188130,592200
406540,406662.8,930650,201450,202642.6,338450,205090,204020.2,592200
408180,407291.4,930650,201970,195528.1,338450,206210,211763.3,592200
409810,405179.2,930650,202450,190170,338450,207360,215009.2,592200
406000,423079.7,930650,199680,201459.7,338450,206320,221620,592200
402190,393028.2,930650,196890,191557.5,338450,205300,201470.7,592200
398430,378998.3,930650,194100,188247.3,338450,204330,190751,592200
394560,368535.4,930650,191290,184171.4,338450,203270,184364,592200
390640,373037.4,930650,188710,182144.1,338450,201930,190893.3,592200
386820,358924.5,930650,186100,179616.4,338450,200720,179308.1,592200
383010,364412.6,930650,183530,181020.9,338450,199480,183391.7,592200
353630,360961,930650,182520,188483.7,338450,171110,172477.3,592200
349080,377823.9,930650,180150,191955.5,338450,168930,185868.4,592200
344450,375365,930650,177780,182222,338450,166670,193143,592200
339930,364612.3,930650,175410,167971,338450,164520,196641.3,592200
335370,344989.6,930650,173060,152863,338450,162310,192126.6,592200
335350,306151.2,930650,171590,143368.5,338450,163760,162782.7,592200
335270,283546.2,930650,170100,132408.1,338450,165170,151138.1,592200
335160,270234.2,930650,168620,119073.6,338450,166540,151160.6,592200
335120,251742.6,930650,167130,105453.2,338450,167990,146289.4,592200
335470,254458.9,930650,166140,106670.1,338450,169330,147788.8,592200
335830,251728.9,930650,165130,105370.1,338450,170700,146358.8,592200
336190,260165.8,930650,164150,109062.9,338450,172040,151102.9,592200
336630,267520.5,930650,163160,113576.5,338450,173470,153944,592200
336480,251115.5,930650,161780,104759.4,338450,174700,146356.1,592200
336390,248348.9,930650,160370,102630.8,338450,176020,145718.1,592200
336290,234868.8,930650,159000,88623.1,338450,177290,146245.7,592200
336080,261498.6,930650,157610,88778.3,338450,178470,172720.3,592200
339280,271693.6,930650,157960,90236.8,338450,181320,181456.8,592200
342510,279829.3,930650,158320,97522.8,338450,184190,182306.5,592200
345730,292130.2,930650,158700,122158.1,338450,187030,169972.1,592200
348970,320209,930650,159080,131733.2,338450,189890,188475.8,592200
352050,379449.6,930650,159340,157058.3,338450,192710,222391.3,592200
355160,392640,930650,159590,167026.1,338450,195570,225613.9,592200
358270,392750.7,930650,159850,170914.7,338450,198420,221836,592200
361440,361622.4,930650,160100,151870.3,338450,201340,209752.1,592200
365200,334439,930650,160830,134923.7,338450,204370,199515.3,592200
368920,327307.9,930650,161600,131737.4,338450,207320,195570.5,592200
372680,340233.6,930650,162340,140596.8,338450,210340,199636.8,592200
376460,356891.1,930650,163080,154230.7,338450,213380,202660.4,592200
386060,379132.1,930650,166590,160418.9,338450,219470,218713.2,592200
395690,392458,930650,170110,165286.9,338450,225580,227171.1,592200
405240,408471,930650,173630,176280.6,338450,231610,232190.4,592200
414880,425346.2,930650,177160,178996,338450,237720,246350.2,592200
424550,436996.8,930650,180910,182166,338450,243640,254830.8,592200
434270,455081.5,930650,184680,188261.1,338450,249590,266820.4,592200
443900,489062.8,930650,188440,206322.6,338450,255460,282740.2,592200
453610,507436.9,930650,192210,215085.8,338450,261400,292351.1,592200
462120,508887.9,930650,195490,218980.9,338450,266630,289907,592200
470630,504478.5,930650,198770,215901.4,338450,271860,288577.1,592200
479140,538684.4,930650,202070,222100.3,338450,277070,316584.1,592200
487640,544192.9,930650,205340,216813.5,338450,282300,327379.4,592200
492260,530949.2,930650,207550,210718.8,338450,284710,320230.4,592200
496750,547048.3,930650,209740,222872.4,338450,287010,324175.9,592200
501300,571633.4,930650,211930,232413.3,338450,289370,339220.1,592200
505870,581765.6,930650,214110,236035.5,338450,291760,345730.1,592200
508200,570899,930650,215380,246644,338450,292820,324255,592200
510490,572530.4,930650,216620,251339,338450,293870,321191.4,592200
512830,529808.7,930650,217860,237121.3,338450,294970,292687.4,592200
515120,532608.7,930650,219110,240926.1,338450,296010,291682.6,592200
520620,546080.4,930650,221220,252774.9,338450,299400,293305.5,592200
526070,565481.6,930650,223310,262487.5,338450,302760,302994.1,592200
531580,605001.3,930650,225440,280415,338450,306140,324586.3,592200
537050,621373.1,930650,227520,288742.2,338450,309530,332630.9,592200
544440,637312.6,930650,229650,291510.1,338450,314790,345802.5,592200
551850,658117.9,930650,231760,293496.1,338450,320090,364621.8,592200
559220,668440.5,930650,233880,296858.7,338450,325340,371581.8,592200
566630,675862.2,930650,236030,300079.5,338450,330600,375782.7,592200
579500,666626.6,930650,242510,301404.9,338450,336990,365221.7,592200
592380,665409.9,930650,248990,300228.6,338450,343390,365181.3,592200
605250,667273.3,930650,255500,301136.1,338450,349750,366137.2,592200
618090,673273.9,930650,261970,300062.5,338450,356120,373211.4,592200
625270,678217.9,930650,263880,298856.9,338450,361390,379361,592200
632360,712243.2,930650,265800,308748.9,338450,366560,403494.3,592200
639500,738326.7,930650,267710,311083.1,338450,371790,427243.6,592200
646670,743965.4,930650,269620,306997.4,338450,377050,436968,592200
632950,752257.8,930650,263570,304812.2,338450,369380,447445.6,592200
619270,747987.1,930650,257500,301253.5,338450,361770,446733.6,592200
605550,653727.5,930650,251450,234696,338450,354100,419031.5,592200
591890,540640.7,930650,245390,154182,338450,346500,386458.7,592200
577800,540221.3,930650,239830,157027.5,338450,337970,383193.8,592200
563770,531035.2,930650,234290,151816.1,338450,329480,379219.1,592200
549710,565505.3,930650,228700,170315.9,338450,321010,395189.4,592200
535610,559852.7,930650,223130,166833.8,338450,312480,393018.9,592200
521030,531020,930650,217010,142276.7,338450,304020,388743.3,592200
506340,529433.4,930650,210880,140353.5,338450,295460,389079.9,592200
491650,524503.3,930650,204770,137337.6,338450,286880,387165.7,592200
477000,532219.7,930650,198640,138902.3,338450,278360,393317.4,592200
460080,528422,930650,193070,136492.2,338450,267010,391929.8,592200
443090,527976.8,930650,187500,135016.7,338450,255590,392960.1,592200
426160,517724.4,930650,181930,133568.2,338450,244230,384156.2,592200
409200,569841.1,930650,176350,178488.9,338450,232850,391352.2,592200
393780,656505.6,930650,171690,250937.9,338450,222090,405567.7,592200
378340,708254.4,930650,167040,294903.8,338450,211300,413350.6,592200
362950,698476,930650,162390,298225.4,338450,200560,400250.6,592200
347490,697646.6,930650,157730,297993.9,338450,189760,399652.7,592200
333570,682396.7,930650,153950,295778,338450,179620,386618.7,592200
319770,677488.1,930650,150130,300402.2,338450,169640,377085.9,592200
305860,660470.8,930650,146360,300117.2,338450,159500,360353.6,592200
291960,637648.9,930650,142560,299976.7,338450,149400,337672.2,592200
284260,618534.1,930650,139010,286152.2,338450,145250,332381.9,592200
276590,607526.3,930650,135490,282434.8,338450,141100,325091.5,592200
268860,586138.9,930650,131940,270744,338450,136920,315394.9,592200
261150,577411.1,930650,128380,264662.9,338450,132770,312748.2,592200
253720,532946.5,930650,125090,246578.5,338450,128630,286368,592200
246330,484462.4,930650,121800,221161.1,338450,124530,263301.3,592200
238900,437608.9,930650,118490,190162.2,338450,120410,247446.7,592200
385780,443579.8,930650,177150,193451.3,338450,208630,250128.5,592200
369910,423937.6,930650,171320,188390.5,338450,198590,235547.1,592200
354080,401059.1,930650,165520,177028.2,338450,188560,224030.9,592200
338230,379643.5,930650,159720,160060.3,338450,178510,219583.2,592200
322410,383033,930650,153900,169497.1,338450,168510,213535.9,592200
324420,363323.3,930650,155790,155578.7,338450,168630,207744.6,592200
326370,317521.7,930650,157690,123062.4,338450,168680,194459.3,592200
328380,302518.3,930650,159550,114430.2,338450,168830,188088.1,592200
330450,289203.9,930650,161470,112561.7,338450,168980,176642.2,592200
332570,295500.9,930650,163660,128027.8,338450,168910,167473.1,592200
334760,292619.2,930650,165890,131507.4,338450,168870,161111.8,592200
336920,315704.4,930650,168120,148378.3,338450,168800,167326.1,592200
339110,282077.5,930650,170320,125296.4,338450,168790,156781.1,592200
340110,280759.8,930650,171800,123803.8,338450,168310,156956,592200
341000,279081.7,930650,173250,118391.9,338450,167750,160689.8,592200
342020,282590.4,930650,174740,121405.1,338450,167280,161185.3,592200
342920,294590.8,930650,176190,132393.9,338450,166730,162196.9,592200
345410,320484,930650,177610,144889.8,338450,167800,175594.2,592200
347850,334475.5,930650,179030,150231.5,338450,168820,184244,592200
350280,363005.1,930650,180420,169596.6,338450,169860,193408.5,592200
352750,417247.6,930650,181870,206302.2,338450,170880,210945.4,592200
355640,423754,930650,183360,210939.2,338450,172280,212814.8,592200
358410,411970.6,930650,184870,203065.4,338450,173540,208905.2,592200
361340,389706.3,930650,186390,188959.7,338450,174950,200746.6,592200
364150,391424.2,930650,187880,193156.3,338450,176270,198267.9,592200
368330,405656.4,930650,189670,204067.9,338450,178660,201588.5,592200
372400,385473.8,930650,191440,187429.1,338450,180960,198044.7,592200
376530,386598.4,930650,193240,186380.5,338450,183290,200217.9,592200
380690,369785.4,930650,195020,172769.5,338450,185670,197015.9,592200
387550,386797.9,930650,197680,183426.8,338450,189870,203371.1,592200
394370,400250.1,930650,200340,197273,338450,194030,202977.1,592200
401190,430013.6,930650,202970,213725.4,338450,198220,216288.2,592200
408040,450425.7,930650,205620,227552.9,338450,202420,222872.8,592200
414310,467784.6,930650,208070,238327.6,338450,206240,229457,592200
420450,478697.8,930650,210480,239012.5,338450,209970,239685.3,592200
426740,483319,930650,212910,239927.4,338450,213830,243391.6,592200
432910,469140.8,930650,215320,231608.4,338450,217590,237532.4,592200
438270,441282.9,930650,217320,217275.4,338450,220950,224007.5,592200
443750,422852,930650,219360,208780.5,338450,224390,214071.5,592200
449140,431620.4,930650,221380,218122.9,338450,227760,213497.5,592200
454530,450904.5,930650,223400,232783.1,338450,231130,218121.4,592200
457660,445023.3,930650,224230,228216.9,338450,233430,216806.4,592200
460740,437504.5,930650,225070,222863,338450,235670,214641.5,592200
463890,439040.7,930650,225920,225274.1,338450,237970,213766.6,592200
467040,462980.2,930650,226730,239838.1,338450,240310,223142.1,592200
468850,469680,930650,227480,244871.8,338450,241370,224808.2,592200
470720,462244.5,930650,228210,240078.3,338450,242510,222166.2,592200
472540,469453.2,930650,228940,235307.3,338450,243600,234145.9,592200
474480,467420.1,930650,229680,231169,338450,244800,236251.1,592200
476040,462721.9,930650,230440,231172.8,338450,245600,231549.1,592200
477570,456383.3,930650,231210,230133.1,338450,246360,226250.2,592200
479190,458306,930650,231990,225900,338450,247200,232406,592200
480690,456768.1,930650,232750,221116.8,338450,247940,235651.3,592200
485370,459671.3,930650,234370,226462.6,338450,251000,233208.7,592200
490020,478759.6,930650,235980,231909.6,338450,254040,246850,592200
494740,470945.7,930650,237620,233098.3,338450,257120,237847.4,592200
499360,466264.5,930650,239210,233986.4,338450,260150,232278.1,592200
504400,464862.4,930650,240700,233046.1,338450,263700,231816.3,592200
509340,462920.6,930650,242190,231121.9,338450,267150,231798.7,592200
514310,500650.6,930650,243660,242341.6,338450,270650,258309,592200
519290,510774.4,930650,245120,244337.4,338450,274170,266437,592200
524360,491110.6,930650,246520,232574.9,338450,277840,258535.7,592200
529550,487475.7,930650,247920,228736.1,338450,281630,258739.6,592200
534650,530274.4,930650,249310,247106.2,338450,285340,283168.2,592200
539770,554342.6,930650,250720,254763.6,338450,289050,299579,592200
548740,543710.9,930650,252880,249566.5,338450,295860,294144.4,592200
557720,557698,930650,255040,252334.4,338450,302680,305363.6,592200
566680,564554.4,930650,257200,252923.3,338450,309480,311631.1,592200
575700,571500.8,930650,259380,248904.5,338450,316320,322596.3,592200
584220,587991.3,930650,261600,250017,338450,322620,337974.3,592200
592720,600979.8,930650,263860,255684.7,338450,328860,345295.1,592200
601240,605470.3,930650,266120,252938.1,338450,335120,352532.2,592200
609710,597929,930650,268350,252621,338450,341360,345308,592200
618270,620021.6,930650,270400,258572.9,338450,347870,361448.7,592200
626790,644818.3,930650,272430,263968.6,338450,354360,380849.7,592200
635270,658924.7,930650,274460,270518.1,338450,360810,388406.6,592200
643790,651950.5,930650,276500,268118.5,338450,367290,383832,592200
648310,653933,930650,277340,271043.3,338450,370970,382889.7,592200
652780,687036.4,930650,278180,284219.1,338450,374600,402817.3,592200
657270,705895.7,930650,279010,289937.6,338450,378260,415958.1,592200
661770,718038.3,930650,279860,301857.8,338450,381910,416180.5,592200
666170,714045.6,930650,280960,302187.1,338450,385210,411858.5,592200
670540,720538.7,930650,282040,301344,338450,388500,419194.7,592200
674990,697613.9,930650,283140,290913.6,338450,391850,406700.3,592200
679410,693976.5,930650,284220,283015.3,338450,395190,410961.2,592200
683480,684356.7,930650,285380,279980.6,338450,398100,404376.1,592200
687580,664681,930650,286500,273643.8,338450,401080,391037.2,592200
691630,663907.1,930650,287630,270261.3,338450,404000,393645.8,592200
695660,664816.3,930650,288790,270489.1,338450,406870,394327.2,592200
695820,667536.4,930650,288760,271617.4,338450,407060,395919,592200
696030,654614.4,930650,288720,268187.2,338450,407310,386427.2,592200
696140,648928,930650,288700,263295.2,338450,407440,385632.8,592200
696300,667011.1,930650,288690,271260.9,338450,407610,395750.2,592200
696580,655027.9,930650,288650,269649.4,338450,407930,385378.5,592200
696820,653191.3,930650,288600,277259.7,338450,408220,375931.6,592200
697080,677842.7,930650,288580,290178.5,338450,408500,387664.2,592200
723100,711956.4,930650,295770,299382.4,338450,427330,412574,592200
725040,707043.3,930650,296210,296421.8,338450,428830,410621.5,592200
727090,700867.7,930650,296700,293097.9,338450,430390,407769.8,592200
729080,718881.7,930650,297160,295234.9,338450,431920,423646.8,592200
731100,727564.7,930650,297640,301489,338450,433460,426075.7,592200
731790,737963.2,930650,298130,297785.1,338450,433660,440178.1,592200
732490,714167.7,930650,298660,288318.2,338450,433830,425849.5,592200
733210,697964,930650,299160,280668.3,338450,434050,417295.7,592200
733880,684999.1,930650,299660,282357.8,338450,434220,402641.3,592200
734460,700477,930650,299910,288700.6,338450,434550,411776.4,592200
735010,730866.6,930650,300120,294943.1,338450,434890,435923.5,592200
735590,749486.9,930650,300310,298144.6,338450,435280,451342.3,592200
736110,752912.6,930650,300540,296186.7,338450,435570,456725.9,592200
736530,742158.2,930650,300670,289639.8,338450,435860,452518.4,592200
736960,732889.8,930650,300830,285865,338450,436130,447024.8,592200
737410,737196.9,930650,300980,291678.6,338450,436430,445518.3,592200
737860,732638.7,930650,301130,288808.5,338450,436730,443830.2,592200
726800,741063.9,930650,291600,294714.6,338450,435200,446349.3,592200
715730,738649.5,930650,282080,295613.1,338450,433650,443036.4,592200
704660,729460.3,930650,272580,288132.7,338450,432080,441327.6,592200
693610,751285.4,930650,263050,294659.4,338450,430560,456626,592200
682500,764885.3,930650,254160,302787.2,338450,428340,462098.1,592200
671340,774212.5,930650,245250,308313,338450,426090,465899.5,592200
660240,796082.7,930650,236370,311090.5,338450,423870,484992.2,592200
649090,794267.3,930650,227490,310313.9,338450,421600,483953.4,592200
640040,782033.2,930650,220930,306470,338450,419110,475563.2,592200
631040,772425.7,930650,214380,300794.7,338450,416660,471631,592200
622000,740391.2,930650,207830,279775.8,338450,414170,460615.4,592200
612930,719042.2,930650,201270,267246.1,338450,411660,451796.1,592200
598610,681639.4,930650,196600,236361.7,338450,402010,445277.7,592200
584180,653772.7,930650,191880,213742.6,338450,392300,440030.1,592200
569800,587380.2,930650,187180,167804.1,338450,382620,419576.1,592200
555420,550989.2,930650,182490,143747.7,338450,372930,407241.5,592200
540550,541517.5,930650,177430,136524.5,338450,363120,404993,592200
525780,508732.8,930650,172380,129897.6,338450,353400,378835.2,592200
510810,507479.3,930650,167310,124153.1,338450,343500,383326.2,592200
495970,493044.7,930650,162250,120796.5,338450,333720,372248.2,592200
480390,474486.8,930650,156420,115092.8,338450,323970,359394,592200
464800,461231.6,930650,150570,114287,338450,314230,346944.6,592200
449150,432253.3,930650,144730,115424.1,338450,304420,316829.2,592200
433590,445059.4,930650,138910,123358.6,338450,294680,321700.8,592200
420200,465039.6,930650,135920,140196.9,338450,284280,324842.7,592200
406900,482335,930650,132940,150552.9,338450,273960,331782.1,592200
393550,464983.9,930650,129970,146988.2,338450,263580,317995.7,592200
380210,465296.9,930650,127000,146099.4,338450,253210,319197.5,592200
367540,433288.3,930650,123870,138633.6,338450,243670,294654.7,592200
354850,413260.8,930650,120730,134908.5,338450,234120,278352.3,592200
342170,392911.2,930650,117600,132181.1,338450,224570,260730.1,592200
329450,414270.6,930650,114460,130304.1,338450,214990,283966.5,592200
315640,431942.1,930650,110780,132697.5,338450,204860,299244.6,592200
301870,414409.7,930650,107100,128951.5,338450,194770,285458.2,592200
288110,384457.1,930650,103400,120078.4,338450,184710,264378.7,592200
274380,358945.6,930650,99740,109321.5,338450,174640,249624.1,592200
264070,335729.8,930650,96840,106083,338450,167230,229646.8,592200
253810,334241.7,930650,93910,108818.8,338450,159900,225422.9,592200
243530,332086.1,930650,91030,104697.1,338450,152500,227389,592200
233240,321175.9,930650,88100,101026.6,338450,145140,220149.3,592200
223030,299632.5,930650,85250,91154,338450,137780,208478.5,592200
212860,286390.9,930650,82390,86482.8,338450,130470,199908.1,592200
202660,255613.7,930650,79530,71242.2,338450,123130,184371.5,592200
192410,236404.5,930650,76690,62178.5,338450,115720,174226,592200
183190,212497,930650,74440,55028.8,338450,108750,157468.2,592200
174010,205778.8,930650,72210,52060.2,338450,101800,153718.6,592200
164820,208079.3,930650,70000,49961.2,338450,94820,158118.1,592200
155580,210453.1,930650,67780,53552.4,338450,87800,156900.7,592200
152900,216603.8,930650,67020,53598.8,338450,85880,163005,592200
150290,225771.4,930650,66310,55360.6,338450,83980,170410.8,592200
147700,224689.7,930650,65580,56633.7,338450,82120,168056,592200
145000,227640.2,930650,64860,56293.1,338450,80140,171347.1,592200
143040,223484,930650,64460,58301.7,338450,78580,165182.3,592200
141070,213384.8,930650,64050,58667.3,338450,77020,154717.5,592200
139080,203282.7,930650,63630,54302.6,338450,75450,148980.1,592200
137140,188470.3,930650,63220,50581.5,338450,73920,137888.8,592200
135190,187552.3,930650,62860,52230.7,338450,72330,135321.6,592200
133250,185841.8,930650,62480,51974.1,338450,70770,133867.7,592200
131290,175603.1,930650,62100,50524,338450,69190,125079.1,592200
129400,167489.7,930650,61750,43596.6,338450,67650,123893.1,592200
127080,165233.4,930650,61140,42179.3,338450,65940,123054.1,592200
124790,169533.5,930650,60530,41215.3,338450,64260,128318.2,592200
122460,162449,930650,59900,33063.1,338450,62560,129385.9,592200
120110,152784.4,930650,59280,26701.7,338450,60830,126082.7,592200
118130,150891.5,930650,59230,23846.7,338450,58900,127044.8,592200
116160,139964.9,930650,59160,22013.3,338450,57000,117951.6,592200
114190,133560.5,930650,59120,20907,338450,55070,112653.5,592200
112200,127418.8,930650,59050,20336.6,338450,53150,107082.2,592200
109960,129396.1,930650,58610,21404.9,338450,51350,107991.2,592200
107710,132113.2,930650,58160,21206.4,338450,49550,110906.8,592200
105410,142277.6,930650,57750,22194.6,338450,47660,120083,592200
103100,135181.5,930650,57310,21809.2,338450,45790,113372.3,592200
99270,130853.2,930650,55050,23779.7,338450,44220,107073.5,592200
95510,126873.4,930650,52810,21964.8,338450,42700,104908.6,592200
91670,125611.9,930650,50560,19559.9,338450,41110,106052,592200
87860,124111.7,930650,48290,18110.9,338450,39570,106000.8,592200
83880,124764.6,930650,45780,18090.7,338450,38100,106673.9,592200
79850,124278,930650,43260,16616.9,338450,36590,107661.1,592200
75860,122551,930650,40710,18049.2,338450,35150,104501.8,592200
31980,125030.3,930650,8840,14900.5,338450,23140,110129.8,592200
29580,122438.8,930650,7600,14315.6,338450,21980,108123.2,592200
27210,122023.2,930650,6290,14272.6,338450,20920,107750.6,592200
24710,118593.6,930650,5030,13266.2,338450,19680,105327.4,592200
22260,114075.5,930650,3740,10444.5,338450,18520,103631,592200
22510,109105.9,930650,3730,9194.7,338450,18780,99911.2,592200
22710,107797.3,930650,3690,9520.3,338450,19020,98277,592200
22950,107178.1,930650,3670,9282,338450,19280,97896.1,592200
23200,103804.4,930650,3660,11409.5,338450,19540,92394.9,592200
23390,94368,930650,3610,6900.5,338450,19780,87467.5,592200
23710,94972.3,930650,3600,6559.5,338450,20110,88412.8,592200
23940,89481.4,930650,3580,5878.5,338450,20360,83602.9,592200
24180,80453.1,930650,3570,4938.5,338450,20610,75514.6,592200
24530,77559.2,930650,3600,4638.5,338450,20930,72920.7,592200
24830,75880.8,930650,3630,4513.5,338450,21200,71367.3,592200
25110,75454,930650,3660,4476,338450,21450,70978,592200
25420,76250.8,930650,3670,4988.2,338450,21750,71262.6,592200
28410,74122.5,930650,4930,4830.6,338450,23480,69291.9,592200
31400,74208.5,930650,6180,4931.9,338450,25220,69276.6,592200
34440,71277.2,930650,7430,4737.9,338450,27010,66539.3,592200
37420,69185,930650,8690,5040,338450,28730,64145,592200
40930,77963.7,930650,10200,10922.4,338450,30730,67041.3,592200
44430,77289.4,930650,11690,9515.8,338450,32740,67773.6,592200
47860,75233,930650,13180,6649,338450,34680,68584,592200
51430,75193.1,930650,14710,6142.3,338450,36720,69050.8,592200
54930,77388.1,930650,16290,6184,338450,38640,71204.1,592200
58470,80739.3,930650,17900,6526,338450,40570,74213.3,592200
61950,85909.6,930650,19480,7448.6,338450,42470,78461,592200
65510,88052.7,930650,21110,8041.2,338450,44400,80011.5,592200
70560,93201.8,930650,24500,10934.9,338450,46060,82266.9,592200
75720,90549.6,930650,27950,11401,338450,47770,79148.6,592200
80900,89703.3,930650,31400,9701.7,338450,49500,80001.6,592200
86040,90610.4,930650,34820,11350.3,338450,51220,79260.1,592200
91160,90448.1,930650,38040,11966.1,338450,53120,78482,592200
96370,89039,930650,41260,11379.8,338450,55110,77659.2,592200
101560,87904,930650,44490,12369.3,338450,57070,75534.7,592200
106690,89581.5,930650,47690,16078.8,338450,59000,73502.7,592200
112710,88629.9,930650,51610,16373.8,338450,61100,72256.1,592200
118750,87811,930650,55520,16315.2,338450,63230,71495.8,592200
124700,86094,930650,59460,17315,338450,65240,68779,592200
130780,89177.9,930650,63370,18906.5,338450,67410,70271.4,592200
132360,92547.5,930650,65050,21314,338450,67310,71233.5,592200
133970,97581.7,930650,66720,24235.6,338450,67250,73346.1,592200
135490,100500.9,930650,68400,24444.1,338450,67090,76056.8,592200
137110,104973.3,930650,70100,25821.5,338450,67010,79151.8,592200
138420,106012.4,930650,71840,28623.9,338450,66580,77388.5,592200
139690,106334,930650,73540,30624,338450,66150,75710,592200
140980,106439.5,930650,75260,31990.4,338450,65720,74449.1,592200
142270,107114.8,930650,76990,33053.4,338450,65280,74061.4,592200
143970,118586.5,930650,79080,41107.4,338450,64890,77479.1,592200
145680,117089.6,930650,81140,40299.9,338450,64540,76789.7,592200
147400,117201.2,930650,83230,37788.7,338450,64170,79412.5,592200
149080,126369.6,930650,85310,44801.2,338450,63770,81568.4,592200
155980,134642.7,930650,87480,50305.9,338450,68500,84336.8,592200
162940,141413,930650,89630,53896.2,338450,73310,87516.8,592200
169850,151521,930650,91800,62805.8,338450,78050,88715.2,592200
176750,166638.6,930650,93980,76255.6,338450,82770,90383,592200
184310,170675,930650,96390,80666.9,338450,87920,90008.1,592200
191800,183869.7,930650,98790,88570.4,338450,93010,95299.3,592200
199350,182797.7,930650,101210,86770.9,338450,98140,96026.8,592200
206880,188204,930650,103630,86194.3,338450,103250,102009.7,592200
215280,212716,930650,106320,97244.2,338450,108960,115471.8,592200
223670,245390.6,930650,108990,113351.9,338450,114680,132038.7,592200
232070,286678.1,930650,111670,134175.6,338450,120400,152502.5,592200
240510,309417.1,930650,114380,142337,338450,126130,167080.1,592200
255980,317572.7,930650,122010,144117.6,338450,133970,173455.1,592200
271460,318723.4,930650,129650,150276.7,338450,141810,168446.7,592200
286890,330817.8,930650,137270,150980.2,338450,149620,179837.6,592200
302480,324923.8,930650,144940,142574.2,338450,157540,182349.6,592200
317790,334125.3,930650,151850,148485.4,338450,165940,185639.9,592200
333070,300756.9,930650,158740,136959.2,338450,174330,163797.7,592200
348390,321101.4,930650,165650,158424.5,338450,182740,162676.9,592200
363640,319379.2,930650,172570,158930.3,338450,191070,160448.9,592200
378300,339352.4,930650,178740,168467.7,338450,199560,170884.7,592200
392930,384229.7,930650,184900,187973,338450,208030,196256.7,592200
407650,429105.3,930650,191090,210541.7,338450,216560,218563.6,592200
422300,473696.3,930650,197240,234359.2,338450,225060,239337.1,592200
439100,492678.8,930650,202940,245172.1,338450,236160,247506.7,592200
455900,516865.4,930650,208630,255865.6,338450,247270,260999.8,592200
472760,544452.5,930650,214310,273439.8,338450,258450,271012.7,592200
489630,560342.6,930650,220020,280331,338450,269610,280011.6,592200
506980,581124,930650,225100,282022.9,338450,281880,299101.1,592200
524280,598675.8,930650,230170,279520.9,338450,294110,319154.9,592200
541660,606873.7,930650,235290,281204.1,338450,306370,325669.6,592200
558920,630512,930650,240350,290638.2,338450,318570,339873.8,592200
575860,629718.3,930650,245480,282412.4,338450,330380,347305.9,592200
592750,621140.4,930650,250590,270113.5,338450,342160,351026.9,592200
609560,648518.5,930650,255700,285049.9,338450,353860,363468.6,592200
626440,680520.7,930650,260820,299748.5,338450,365620,380772.2,592200
639920,700226,930650,264640,304139.3,338450,375280,396086.7,592200
653390,699737.6,930650,268440,300219.4,338450,384950,399518.2,592200
666930,692223,930650,272250,288746.1,338450,394680,403476.9,592200
680370,679430.1,930650,276040,274745.6,338450,404330,404684.5,592200
693540,671884.6,930650,280000,267633.2,338450,413540,404251.4,592200
706670,682497.5,930650,283970,272466,338450,422700,410031.5,592200
719850,707485.6,930650,287920,284679.8,338450,431930,422805.8,592200
740030,701542.7,930650,295640,275346.5,338450,444390,426196.2,592200
753680,732224.2,930650,300070,287899.8,338450,453610,444324.4,592200
767390,767919.7,930650,304510,301189,338450,462880,466730.7,592200
780990,782117.6,930650,308950,307127.3,338450,472040,474990.3,592200
794720,767561,930650,313400,308565.9,338450,481320,458995.1,592200
794490,778995,930650,309120,307840.3,338450,485370,471154.7,592200
794350,788534.3,930650,304870,306101.1,338450,489480,482433.2,592200
794150,807366.5,930650,300570,306766.2,338450,493580,500600.3,592200
793930,821463.2,930650,296310,308658.7,338450,497620,512804.5,592200
792840,828708.1,930650,291640,308973.1,338450,501200,519735,592200
791720,821063,930650,286960,309123.3,338450,504760,511939.7,592200
790600,850245.3,930650,282260,312812.3,338450,508340,537433,592200
789490,767976.2,930650,277600,266476.4,338450,511890,501499.8,592200
781190,819521.8,930650,266010,302699.4,338450,515180,516822.4,592200
772900,824023.4,930650,254430,299912.3,338450,518470,524111.1,592200
764600,847332.3,930650,242840,297373.6,338450,521760,549958.7,592200
756300,839466.4,930650,231260,296380.9,338450,525040,543085.5,592200
756190,822814.2,930650,231220,284557.8,338450,524970,538256.4,592200
756050,828649.7,930650,231160,289176.5,338450,524890,539473.2,592200
755880,726847.3,930650,231110,205303.7,338450,524770,521543.6,592200
755760,629767.7,930650,231080,133940.2,338450,524680,495827.5,592200
755830,613228.1,930650,231000,130669.8,338450,524830,482558.3,592200
755920,622169.6,930650,230970,133890.2,338450,524950,488279.4,592200
755950,621589.1,930650,230890,133979.4,338450,525060,487609.7,592200
756030,637606.5,930650,230820,135126.2,338450,525210,502480.3,592200
756250,613591.6,930650,230770,132834.1,338450,525480,480757.5,592200
756470,620380.7,930650,230720,132448.7,338450,525750,487932,592200
756620,621260.8,930650,230660,133529.9,338450,525960,487730.9,592200
756810,626624,930650,230610,133975.3,338450,526200,492648.7,592200
758850,637333.2,930650,232940,135940.6,338450,525910,501392.6,592200
760960,627833.5,930650,235310,136112.4,338450,525650,491721.1,592200
762990,631954.5,930650,237660,137539.8,338450,525330,494414.7,592200
765060,614842.5,930650,240010,136392.4,338450,525050,478450.1,592200
767160,638728.9,930650,242350,154939.4,338450,524810,483789.5,592200
769250,625639.2,930650,244700,134549.3,338450,524550,491089.9,592200
771290,668737.1,930650,247060,166382,338450,524230,502355.1,592200
773370,732340.6,930650,249400,212602.1,338450,523970,519738.5,592200
775430,646580.1,930650,251760,162085.7,338450,523670,484494.4,592200
777540,601120.5,930650,254120,128076.2,338450,523420,473044.3,592200
779600,617701.9,930650,256450,134162.8,338450,523150,483539.1,592200
781680,619745,930650,258820,134400.1,338450,522860,485344.9,592200
780890,617147.4,930650,260110,144792.5,338450,520780,472354.9,592200
780140,655465.2,930650,261410,165381.9,338450,518730,490083.3,592200
779320,627099.7,930650,262680,147372.5,338450,516640,479727.2,592200
778500,653240.4,930650,263950,151567.4,338450,514550,501673,592200
777760,644973.1,930650,265240,155343.5,338450,512520,489629.6,592200
777020,652412.6,930650,266540,153376.5,338450,510480,499036.1,592200
776260,658033.1,930650,267820,158302.5,338450,508440,499730.6,592200
775540,674857.7,930650,269120,173796.6,338450,506420,501061.1,592200
774650,746549.6,930650,270340,231030.8,338450,504310,515518.8,592200
773690,739529.6,930650,271590,227185.8,338450,502100,512343.8,592200
772820,734736.7,930650,272840,230210,338450,499980,504526.7,592200
771960,804600.6,930650,274080,282945.8,338450,497880,521654.8,592200
770120,810726.4,930650,279880,305505.2,338450,490240,505221.2,592200
768310,812791.3,930650,285650,306416.9,338450,482660,506374.4,592200
766530,803418.9,930650,291420,306664.6,338450,475110,496754.3,592200
764700,813589.5,930650,297210,308936.3,338450,467490,504653.2,592200
754700,808714,930650,295390,308033.2,338450,459310,500680.8,592200
744720,798936.5,930650,293580,305575.3,338450,451140,493361.2,592200
734740,805646.7,930650,291770,311372.2,338450,442970,494274.5,592200
724710,792769.2,930650,289970,305399.2,338450,434740,487370,592200
714570,775790.2,930650,288240,302592.2,338450,426330,473198,592200
704390,760993.9,930650,286520,298869.2,338450,417870,462124.7,592200
694160,732339.3,930650,284780,287450.9,338450,409380,444888.4,592200
683990,700261.6,930650,283040,278308.1,338450,400950,421953.5,592200
678650,710066.4,930650,281630,287976.9,338450,397020,422089.5,592200
673300,702413.3,930650,280220,288399.7,338450,393080,414013.6,592200
667930,704173.2,930650,278820,294958.4,338450,389110,409214.8,592200
662570,682585,930650,277400,287674.6,338450,385170,394910.4,592200
657410,671376,930650,275650,289698.8,338450,381760,381677.2,592200
652340,697624,930650,273920,297318.3,338450,378420,400305.7,592200
647210,693773.2,930650,272200,298674.8,338450,375010,395098.4,592200
642060,686863.1,930650,270450,297511.7,338450,371610,389351.4,592200
636800,700402.8,930650,268290,300384.8,338450,368510,400018,592200
631540,700649.2,930650,266160,300850.8,338450,365380,399798.4,592200
626280,678251.6,930650,264010,290273.8,338450,362270,387977.8,592200
621030,691104.2,930650,261850,292229.9,338450,359180,398874.3,592200
613480,676841.1,930650,259330,273241.7,338450,354150,403599.4,592200
605870,713821.1,930650,256800,302779.1,338450,349070,411042,592200
598210,717204.4,930650,254280,309651.3,338450,343930,407553.1,592200
590630,717023.3,930650,251750,311273.1,338450,338880,405750.2,592200
582450,691255.7,930650,248840,301042,338450,333610,390213.7,592200
574370,683705.6,930650,245940,297072.4,338450,328430,386633.2,592200
566250,688232.1,930650,243030,298657.6,338450,323220,389574.5,592200
558200,697372.4,930650,240120,303885.4,338450,318080,393487,592200
549960,671191.4,930650,237940,298157.4,338450,312020,373034,592200
541710,656269.6,930650,235720,292708.7,338450,305990,363560.9,592200
533510,647884.4,930650,233510,290620.5,338450,300000,357263.9,592200
525390,647037.5,930650,231330,298251.3,338450,294060,348786.2,592200
519380,621711.2,930650,229570,290701,338450,289810,331010.2,592200
513350,618442.6,930650,227850,289260.8,338450,285500,329181.8,592200
507380,637723.1,930650,226080,295493.4,338450,281300,342229.7,592200
501400,621888.1,930650,224350,296400.3,338450,277050,325487.8,592200
497000,619166.4,930650,222710,294504.6,338450,274290,324661.8,592200
492570,598666.8,930650,221050,286375.9,338450,271520,312290.9,592200
488200,583605.8,930650,219400,275705.4,338450,268800,307900.4,592200
549360,580255.4,930650,245620,272045,338450,303740,308210.4,592200
542510,558780.7,930650,243460,256190.1,338450,299050,302590.6,592200
535730,545809.6,930650,241310,250503.2,338450,294420,295306.4,592200
528940,540453.5,930650,239160,255091.2,338450,289780,285362.3,592200
522180,542497.5,930650,237000,261459.4,338450,285180,281038.1,592200
517340,545152,930650,234710,256860.4,338450,282630,288291.6,592200
512580,556207.2,930650,232460,262697.7,338450,280120,293509.5,592200
507860,575067.7,930650,230180,263924.9,338450,277680,311142.8,592200
503040,572221.5,930650,227920,261516.3,338450,275120,310705.2,592200
498470,591464.7,930650,225990,269286.3,338450,272480,322178.4,592200
493900,583875.7,930650,224050,273316.3,338450,269850,310559.4,592200
489380,590608.6,930650,222110,274456.9,338450,267270,316151.7,592200
484760,583220.1,930650,220140,266754.2,338450,264620,316465.9,592200
479980,590674.1,930650,217900,266886.7,338450,262080,323787.4,592200
475240,584121.4,930650,215670,263239.4,338450,259570,320882,592200
470480,581667.4,930650,213430,261524.7,338450,257050,320142.7,592200
465750,595530.4,930650,211220,273736.7,338450,254530,321793.7,592200
465120,596886.3,930650,210260,273180.2,338450,254860,323706.1,592200
464460,591122.6,930650,209310,269387.8,338450,255150,321734.8,592200
463810,583257.7,930650,208370,264551.4,338450,255440,318706.3,592200
463200,547637.7,930650,207450,242319.9,338450,255750,305317.8,592200
462040,530110.5,930650,206300,228622.3,338450,255740,301488.2,592200
460750,549921.2,930650,205140,243341.7,338450,255610,306579.5,592200
459630,540581.9,930650,203980,248616.4,338450,255650,291965.5,592200
458290,560274.4,930650,202820,262771.8,338450,255470,297502.6,592200
455920,576907.8,930650,201230,267937.3,338450,254690,308970.5,592200
453580,567773.4,930650,199630,265500.2,338450,253950,302273.2,592200
451270,541485.4,930650,198040,251747.8,338450,253230,289737.6,592200
448870,543977.1,930650,196450,246426.7,338450,252420,297550.4,592200
453400,573621.6,930650,198670,253829.7,338450,254730,319791.9,592200
457970,576014.5,930650,200900,252833.2,338450,257070,323181.3,592200
462540,567484.8,930650,203130,247835.7,338450,259410,319649.1,592200
467020,561847.3,930650,205360,248941.1,338450,261660,312906.2,592200
471410,557671.5,930650,206780,253936.4,338450,264630,303735.1,592200
475770,571054.4,930650,208210,257072.8,338450,267560,313981.6,592200
480090,541987.5,930650,209640,245545.5,338450,270450,296442,592200
484490,501696,930650,211060,227443.7,338450,273430,274252.3,592200
488450,510783.6,930650,212600,237718.4,338450,275850,273065.2,592200
492370,506582.7,930650,214140,240189.8,338450,278230,266392.9,592200
496350,503682.5,930650,215680,237782,338450,280670,265900.5,592200
500220,488309.5,930650,217220,228938.5,338450,283000,259371,592200
503710,465602.8,930650,216450,222854.4,338450,287260,242748.4,592200
507030,465431.5,930650,215660,231292.5,338450,291370,234139,592200
510350,480830,930650,214850,237688.4,338450,295500,243141.6,592200
513810,488930.5,930650,214060,244028.3,338450,299750,244902.2,592200
519720,479320.8,930650,214410,229849.8,338450,305310,249471,592200
525600,492683,930650,214720,229749.8,338450,310880,262933.2,592200
531450,481948.8,930650,215040,220966.5,338450,316410,260982.3,592200
537380,464525.5,930650,215360,216042.7,338450,322020,248482.8,592200
543510,490602.1,930650,215500,230335.1,338450,328010,260267,592200
549650,510548.5,930650,215620,233647,338450,334030,276901.5,592200
555790,501445.7,930650,215780,227481.5,338450,340010,273964.2,592200
561920,478052.7,930650,215890,209527.9,338450,346030,268524.8,592200
560660,477279,930650,214240,201675.4,338450,346420,275603.6,592200
559360,477379.5,930650,212560,205636.4,338450,346800,271743.1,592200
558130,408978.5,930650,210880,152193.6,338450,347250,256784.9,592200
556860,427310.8,930650,209220,172885.3,338450,347640,254425.5,592200
555080,449631.4,930650,208670,179149.4,338450,346410,270482,592200
553370,459095.8,930650,208140,183331.3,338450,345230,275764.5,592200
551580,389116.5,930650,207600,137823.9,338450,343980,251292.6,592200
549890,366457.8,930650,207080,121620.7,338450,342810,244837.1,592200
549010,351954.9,930650,206170,108074.2,338450,342840,243880.7,592200
547970,365278.9,930650,205260,109449.7,338450,342710,255829.2,592200
547100,353322.4,930650,204370,134441.8,338450,342730,218880.6,592200
546150,360192.3,930650,203460,151710.9,338450,342690,208481.4,592200
546480,358474.2,930650,203840,140619.2,338450,342640,217855,592200
546750,377940,930650,204220,153826.8,338450,342530,224113.2,592200
547130,437565.4,930650,204610,206055.6,338450,342520,231509.8,592200
547480,481424.7,930650,205000,219177.8,338450,342480,262246.9,592200
547950,537725.3,930650,205620,229166.8,338450,342330,308558.5,592200
548450,496288.9,930650,206230,211307.6,338450,342220,284981.3,592200
548910,494727.8,930650,206830,205264.2,338450,342080,289463.6,592200
549420,463117.6,930650,207440,188143.4,338450,341980,274974.2,592200
548970,464272.3,930650,207250,168000.8,338450,341720,296271.5,592200
548530,489218.2,930650,207070,171467.9,338450,341460,317750.3,592200
548150,541300.8,930650,206870,209572.3,338450,341280,331728.5,592200
547690,546776.9,930650,206660,223925.7,338450,341030,322851.2,592200
547210,528129.8,930650,204710,213498.2,338450,342500,314631.6,592200
546660,479256.3,930650,202750,193609.7,338450,343910,285646.6,592200
546130,458709.4,930650,200800,183363,338450,345330,275346.4,592200
545660,452404.9,930650,198860,184234.6,338450,346800,268170.3,592200
545090,473350.6,930650,196970,193412,338450,348120,279938.6,592200
544540,503848.9,930650,195090,208584.8,338450,349450,295264.1,592200
543980,526231.9,930650,193220,215497.9,338450,350760,310734,592200
543440,547395.1,930650,191340,225119.3,338450,352100,322275.8,592200
542420,559909.3,930650,188710,224364.1,338450,353710,335545.2,592200
541320,562379.1,930650,186070,222566.5,338450,355250,339812.6,592200
540200,585275,930650,183410,237035.9,338450,356790,348239.1,592200
539140,597840.2,930650,180760,249825.5,338450,358380,348014.7,592200
533390,619697.7,930650,176900,262664.6,338450,356490,357033.1,592200
527580,637661.1,930650,172990,269669.3,338450,354590,367991.8,592200
521860,630844,930650,169120,255674.5,338450,352740,375169.5,592200
516060,621604.7,930650,165230,244558.5,338450,350830,377046.2,592200
510370,588641.3,930650,161260,220836.5,338450,349110,367804.8,592200
504590,579063.6,930650,157290,208757.6,338450,347300,370306,592200
498870,558848.6,930650,153330,199279.4,338450,345540,359569.2,592200
541780,501050.6,930650,208450,174762.6,338450,333330,326288,592200
544860,508142.3,930650,209350,187510,338450,335510,320632.3,592200
547890,533274.5,930650,210260,211830.5,338450,337630,321444,592200
551020,502160,930650,211170,197999.3,338450,339850,304160.7,592200
554130,505265.1,930650,212080,198499,338450,342050,306766.1,592200
547030,465731.2,930650,206610,173678.6,338450,340420,292052.6,592200
540030,488773.3,930650,201130,190009.2,338450,338900,298764.1,592200
532950,467873.8,930650,195620,177234.1,338450,337330,290639.7,592200
525940,479270.4,930650,190150,185985.8,338450,335790,293284.6,592200
522280,454359,930650,188200,163274.5,338450,334080,291084.5,592200
518670,442574.2,930650,186260,154288.3,338450,332410,288285.9,592200
515000,398243.8,930650,184290,138305.7,338450,330710,259938.1,592200
511340,395384.1,930650,182340,142413.7,338450,329000,252970.4,592200
507900,393103.9,930650,180400,143582.7,338450,327500,249521.2,592200
504440,375969.6,930650,178470,137473.3,338450,325970,238496.3,592200
500920,379911.2,930650,176540,144978,338450,324380,234933.2,592200
497510,389206.5,930650,174610,140249.7,338450,322900,248956.8,592200
493970,410210.3,930650,174350,158751.1,338450,319620,251459.2,592200
490460,392446.6,930650,174110,148726.6,338450,316350,243720,592200
486960,385794.5,930650,173870,148625.4,338450,313090,237169.1,592200
483460,408277.1,930650,173600,183459.1,338450,309860,224818,592200
478020,421909.4,930650,171870,192666.7,338450,306150,229242.7,592200
472580,423406.5,930650,170130,190700.6,338450,302450,232705.9,592200
467190,445643.5,930650,168420,205793.4,338450,298770,239850.1,592200
461630,431278.8,930650,166640,194997.7,338450,294990,236281.1,592200
454950,407904,930650,163700,174578.2,338450,291250,233325.8,592200
448210,387444.8,930650,160780,155138.5,338450,287430,232306.3,592200
441420,368411.7,930650,157830,152856,338450,283590,215555.7,592200
434650,417279.9,930650,154890,183334.3,338450,279760,233945.6,592200
425220,423599.9,930650,150880,187049.6,338450,274340,236550.3,592200
415690,432832,930650,146860,198114,338450,268830,234718,592200
406230,399086.1,930650,142820,173246.2,338450,263410,225839.9,592200
396740,383988.7,930650,138800,164420,338450,257940,219568.7,592200
386950,392604.6,930650,133910,167823.2,338450,253040,224781.4,592200
377190,413875,930650,129010,181102.4,338450,248180,232772.6,592200
367530,407483.5,930650,124150,181999.2,338450,243380,225484.3,592200
357740,430181.1,930650,119250,197204.8,338450,238490,232976.3,592200
348190,443696.6,930650,114470,203815.4,338450,233720,239881.2,592200
338650,427045.8,930650,109670,198589.6,338450,228980,228456.2,592200
329100,449995.4,930650,104870,205889.8,338450,224230,244105.6,592200
319480,420746.1,930650,100060,191976.8,338450,219420,228769.3,592200
309160,386546.8,930650,96450,185567.1,338450,212710,200979.7,592200
298890,390937,930650,92830,179932.4,338450,206060,211004.6,592200
288570,358842.6,930650,89240,158846.7,338450,199330,199995.9,592200
278250,335718.2,930650,85590,140661.7,338450,192660,195056.5,592200
268090,347049.8,930650,82420,150314.6,338450,185670,196735.2,592200
257930,356187.5,930650,79210,150358.5,338450,178720,205829,592200
247780,356702.9,930650,76000,153739.1,338450,171780,202963.8,592200
237630,334010,930650,72800,135896.6,338450,164830,198113.4,592200
227810,291916.9,930650,69820,107185.9,338450,157990,184731,592200
218070,278567.8,930650,66830,95214.6,338450,151240,183353.2,592200
208280,281821.4,930650,63830,102824.3,338450,144450,178997.1,592200
198510,281019.1,930650,60850,106855.4,338450,137660,174163.7,592200
188650,244264.2,930650,58330,85129.4,338450,130320,159134.8,592200
178740,224104.7,930650,55810,70369.2,338450,122930,153735.5,592200
168820,196435.2,930650,53270,51561.9,338450,115550,144873.3,592200
158940,203933.8,930650,50750,58225.8,338450,108190,145708,592200
148840,185399.8,930650,47930,59343.1,338450,100910,126056.7,592200
138850,167702.8,930650,45150,48525,338450,93700,119177.8,592200
128750,167003.8,930650,42310,47953.7,338450,86440,119050.1,592200
118630,157569.6,930650,39480,43470.8,338450,79150,114098.8,592200
108420,154423.4,930650,36470,44631.8,338450,71950,109791.6,592200
98110,158795,930650,33440,46776.2,338450,64670,112018.8,592200
87810,150662.1,930650,30410,45274.3,338450,57400,105387.8,592200
77510,150695.2,930650,27380,47192.1,338450,50130,103503.1,592200
74530,139575.9,930650,26040,43181.5,338450,48490,96394.4,592200
71510,135476.4,930650,24680,39469.4,338450,46830,96007,592200
68440,124859.2,930650,23340,34327.7,338450,45100,90531.5,592200
65390,120849.6,930650,21990,32062.8,338450,43400,88786.8,592200
63030,108697.4,930650,20880,23064.5,338450,42150,85632.9,592200
60650,96616.5,930650,19770,14992,338450,40880,81624.5,592200
58240,88710.1,930650,18650,13489.3,338450,39590,75220.8,592200
55900,85938.1,930650,17550,11910.7,338450,38350,74027.4,592200
55920,88257.1,930650,18850,11388.6,338450,37070,76868.5,592200
55950,86879.3,930650,20080,10682.9,338450,35870,76196.4,592200
55910,82118.8,930650,21350,10153.8,338450,34560,71965,592200
55990,79589.4,930650,22660,10114.4,338450,33330,69475,592200
65400,73935.9,930650,33390,9769.9,338450,32010,64166,592200
74820,72712.4,930650,44110,9764.8,338450,30710,62947.6,592200
84260,72712.4,930650,54860,9764.8,338450,29400,62947.6,592200
93720,63644.8,930650,65610,10730.5,338450,28110,52914.3,592200
100520,61269.7,930650,73720,11915.3,338450,26800,49354.4,592200
107300,60343.3,930650,81850,13143,338450,25450,47200.3,592200
114180,59076.4,930650,89990,14695.3,338450,24190,44381.1,592200
120990,59806.7,930650,98080,16447.7,338450,22910,43359,592200
126580,61932.1,930650,104730,17800.9,338450,21850,44131.2,592200
132190,62552.7,930650,111410,18601,338450,20780,43951.7,592200
137810,62806.8,930650,118100,19986.7,338450,19710,42820.1,592200
143440,82055.9,930650,124760,40697.8,338450,18680,41358.1,592200
146100,95970.3,930650,127110,54707.6,338450,18990,41262.7,592200
148820,87649.3,930650,129450,46721.1,338450,19370,40928.2,592200
151560,76095.6,930650,131810,35326.4,338450,19750,40769.2,592200
154250,67004.1,930650,134160,26137.8,338450,20090,40866.3,592200
156690,65783.4,930650,136040,23938.2,338450,20650,41845.2,592200
159020,66009.3,930650,137920,23056,338450,21100,42953.3,592200
161430,66072.9,930650,139820,23029.6,338450,21610,43043.3,592200
65070,45672.6,930650,63850,5529.6,338450,1220,40143,592200
73470,47210.9,930650,72080,6901,338450,1390,40309.9,592200
81870,50155.9,930650,80320,10028.1,338450,1550,40127.8,592200
90290,60141.2,930650,88550,20149.8,338450,1740,39991.4,592200
98680,67087.4,930650,96780,27152,338450,1900,39935.4,592200
105060,72787.5,930650,100820,32788.9,338450,4240,39998.6,592200
111370,79625.5,930650,104880,39516.1,338450,6490,40109.4,592200
117760,100045.6,930650,108920,58518,338450,8840,41527.6,592200
124160,115907.3,930650,113000,72362.9,338450,11160,43544.4,592200
131430,121564.3,930650,117760,77218.1,338450,13670,44346.2,592200
138760,161495.8,930650,122520,107294.9,338450,16240,54200.9,592200
146100,145172.7,930650,127300,94929.8,338450,18800,50242.9,592200
153470,155536,930650,132100,102416.4,338450,21370,53119.6,592200
160680,231127.9,930650,136500,158797.8,338450,24180,72330.1,592200
167980,218659,930650,140950,149433.8,338450,27030,69225.2,592200
175190,175706,930650,145420,117154.6,338450,29770,58551.4,592200
182480,156705.6,930650,149860,102587.9,338450,32620,54117.7,592200
184710,146925.2,930650,148830,92085.1,338450,35880,54840.1,592200
187020,145193.2,930650,147820,87743.7,338450,39200,57449.5,592200
189290,219948.1,930650,146810,141737.9,338450,42480,78210.2,592200
191540,245705.4,930650,145790,159557.8,338450,45750,86147.6,592200
193580,249369.5,930650,144760,161555.3,338450,48820,87814.2,592200
195630,263443.4,930650,143700,170955.1,338450,51930,92488.3,592200
197710,244709.2,930650,142670,154277.3,338450,55040,90431.9,592200
199690,242606.9,930650,141600,150228.6,338450,58090,92378.3,592200
203340,228058.9,930650,141700,137562,338450,61640,90496.9,592200
206980,257940.3,930650,141770,158197.3,338450,65210,99743,592200
210660,245311.1,930650,141870,147840.4,338450,68790,97470.7,592200
214220,247882.4,930650,141930,149643.5,338450,72290,98238.9,592200
213070,244670.8,930650,140170,145385,338450,72900,99285.8,592200
211860,195376.2,930650,138370,106288.1,338450,73490,89088.1,592200
210660,216682.4,930650,136600,120006.7,338450,74060,96675.7,592200
209530,238750.7,930650,134830,134728.9,338450,74700,104021.8,592200
209940,222837.7,930650,133820,124434.8,338450,76120,98402.9,592200
210340,187877.2,930650,132780,99731.7,338450,77560,88145.5,592200
210700,239659.4,930650,131770,136628,338450,78930,103031.4,592200
211180,250853.7,930650,130770,144977,338450,80410,105876.7,592200
211630,243952.5,930650,129560,139037.3,338450,82070,104915.2,592200
212130,196831.1,930650,128370,102089.4,338450,83760,94741.7,592200
212570,210281,930650,127160,114299.3,338450,85410,95981.7,592200
213070,243463.8,930650,125970,135578.8,338450,87100,107885,592200
219830,214416.4,930650,127580,108277.5,338450,92250,106138.9,592200
226640,201718.2,930650,129200,101592.1,338450,97440,100126.1,592200
233280,203498.8,930650,130790,107135,338450,102490,96363.8,592200
240060,242946.1,930650,132400,134179.1,338450,107660,108767,592200
247640,205691.3,930650,135140,106278.4,338450,112500,99412.9,592200
255220,213076.3,930650,137880,114764.5,338450,117340,98311.8,592200
262780,269196.2,930650,140620,144329.6,338450,122160,124866.6,592200
270350,188873.4,930650,143340,82881.5,338450,127010,105991.9,592200
278860,190436.9,930650,146420,84644.8,338450,132440,105792.1,592200
287430,249377,930650,149500,119989.2,338450,137930,129387.8,592200
296040,294001.2,930650,152600,149708.8,338450,143440,144292.4,592200
304650,313449.3,930650,155680,158029.1,338450,148970,155420.2,592200
310740,336084.8,930650,159310,174699.7,338450,151430,161385.1,592200
316920,315876,930650,162970,152819.5,338450,153950,163056.5,592200
323090,363280.5,930650,166630,185511.4,338450,156460,177769.1,592200
329270,350925.4,930650,170280,179470.3,338450,158990,171455.1,592200
334360,363262.2,930650,173870,183938.2,338450,160490,179324,592200
339390,392276.6,930650,177420,199149.9,338450,161970,193126.7,592200
344480,408635.6,930650,181030,205346.7,338450,163450,203288.9,592200
349570,371318.9,930650,184570,200540.7,338450,165000,170778.2,592200
354900,378235.1,930650,188250,200324.7,338450,166650,177910.4,592200
360200,368799.4,930650,191910,189116,338450,168290,179683.4,592200
365520,395104.8,930650,195610,206062.2,338450,169910,189042.6,592200
370840,394289,930650,199270,208133.8,338450,171570,186155.2,592200
378040,393506.3,930650,201240,214848.1,338450,176800,178658.2,592200
385220,392117.2,930650,203180,211094.7,338450,182040,181022.5,592200
392520,406262.7,930650,205150,219428.6,338450,187370,186834.1,592200
399720,390401.9,930650,207100,217948.5,338450,192620,172453.4,592200
406560,379245.9,930650,208050,206961.6,338450,198510,172284.3,592200
413370,374149.6,930650,208990,214778,338450,204380,159371.6,592200
420140,386541,930650,209920,220873,338450,210220,165668,592200
427000,388739.7,930650,210890,222298.3,338450,216110,166441.4,592200
434850,397868.1,930650,212230,222215.3,338450,222620,175652.8,592200
442740,392696.9,930650,213580,221000.8,338450,229160,171696.1,592200
450550,384234.8,930650,214910,216983.4,338450,235640,167251.4,592200
458330,394927.5,930650,216250,219588.7,338450,242080,175338.8,592200
461990,399484.5,930650,216800,219129.9,338450,245190,180354.6,592200
465570,412283.1,930650,217390,222323.3,338450,248180,189959.8,592200
469170,425558.4,930650,217950,222888.1,338450,251220,202670.3,592200
472740,423178.3,930650,218530,220745.5,338450,254210,202432.8,592200
473840,428392.9,930650,218790,224646.6,338450,255050,203746.3,592200
474930,427324.8,930650,219050,225947,338450,255880,201377.8,592200
476050,432999.5,930650,219320,225912.7,338450,256730,207086.8,592200
477120,429792.2,930650,219590,223191.3,338450,257530,206600.9,592200
478050,431809.1,930650,219470,225557.1,338450,258580,206252,592200
478990,440352.8,930650,219360,227152.5,338450,259630,213200.3,592200
479920,458906.8,930650,219260,228441.7,338450,260660,230465.1,592200
480860,461477.9,930650,219140,230101.2,338450,261720,231376.7,592200
479620,447059.5,930650,217470,214798.6,338450,262150,232260.9,592200
478330,415054,930650,215750,195479.5,338450,262580,219574.5,592200
477080,474408.7,930650,214060,234589.3,338450,263020,239819.4,592200
475850,492720.2,930650,212380,228787.5,338450,263470,263932.7,592200
475600,493010.3,930650,211550,231496,338450,264050,261514.3,592200
475270,471747.1,930650,210660,222029.3,338450,264610,249717.8,592200
475090,492367.1,930650,209820,232379.7,338450,265270,259987.4,592200
426600,516040.2,930650,189550,232685.8,338450,237050,283354.4,592200
424060,497390.5,930650,189390,222502.4,338450,234670,274888.1,592200
421480,445405.4,930650,189240,185867.2,338450,232240,259538.2,592200
418970,495893.6,930650,189100,237855,338450,229870,258038.6,592200
416420,479183,930650,188940,233912.6,338450,227480,245270.4,592200
413930,469621.1,930650,187870,231581.4,338450,226060,238039.7,592200
411410,474124.1,930650,186750,234730.6,338450,224660,239393.5,592200
408930,498270.4,930650,185690,235262.4,338450,223240,263008,592200
406410,479183.9,930650,184590,228919.4,338450,221820,250264.5,592200
404330,493551.1,930650,183860,229748.1,338450,220470,263803,592200
402380,475146.7,930650,183170,222596.4,338450,219210,252550.3,592200
400380,457949.4,930650,182480,210658.3,338450,217900,247291.1,592200
398330,461297,930650,181780,215520,338450,216550,245777,592200
396910,434116.8,930650,181500,206878,338450,215410,227238.8,592200
395570,435656.3,930650,181230,206834.9,338450,214340,228821.4,592200
394180,369673.5,930650,180940,173946.2,338450,213240,195727.3,592200
392790,392478.7,930650,180670,197346,338450,212120,195132.7,592200
391380,367305.9,930650,181140,172783.5,338450,210240,194522.4,592200
390020,420647.2,930650,181630,212353.8,338450,208390,208293.4,592200
388690,421966.9,930650,182130,216559.9,338450,206560,205407,592200
387340,409299.8,930650,182590,208067.1,338450,204750,201232.7,592200
386370,439950.5,930650,183330,220847.9,338450,203040,219102.6,592200
385470,419340.9,930650,184070,205259.5,338450,201400,214081.4,592200
384570,426256.1,930650,184790,220491,338450,199780,205765.1,592200
383580,418344.4,930650,185510,219013.5,338450,198070,199330.9,592200
382500,418932.3,930650,186340,218337.8,338450,196160,200594.5,592200
381320,400728.9,930650,187170,207579.7,338450,194150,193149.2,592200
380200,393504,930650,188000,210967.4,338450,192200,182536.6,592200
378970,386720.8,930650,188820,205563.6,338450,190150,181157.2,592200
376510,377067.9,930650,188570,206773.4,338450,187940,170294.5,592200
374040,377319.2,930650,188330,208276.5,338450,185710,169042.7,592200
371530,362091.2,930650,188080,196123.8,338450,183450,165967.4,592200
369110,361718.3,930650,187840,207714.5,338450,181270,154003.8,592200
364180,365470.6,930650,186020,209682.2,338450,178160,155788.4,592200
359390,365698.9,930650,184220,204108.5,338450,175170,161590.4,592200
354540,379748.4,930650,182380,210669.2,338450,172160,169079.2,592200
349700,350670,930650,180570,202793,338450,169130,147877,592200
346920,361865.4,930650,180320,210446.6,338450,166600,151418.8,592200
344010,379430.2,930650,180020,208873.2,338450,163990,170557,592200
341180,372794.1,930650,179740,205466.1,338450,161440,167328,592200
338370,340923.9,930650,179460,188062.9,338450,158910,152861,592200
337100,330424.6,930650,177230,182309.1,338450,159870,148115.5,592200
335910,319595.7,930650,174930,179461.9,338450,160980,140133.8,592200
334650,341050.8,930650,172670,194493.2,338450,161980,146557.6,592200
333430,338058.7,930650,170410,194527.6,338450,163020,143531.1,592200
331500,354767.5,930650,168130,195009.6,338450,163370,159757.9,592200
329570,268959.2,930650,165850,138972.2,338450,163720,129987,592200
327620,257312.7,930650,163540,127524.1,338450,164080,129788.6,592200
325660,311558.4,930650,161240,164427.3,338450,164420,147131.1,592200
323980,312850.9,930650,158490,167596.6,338450,165490,145254.3,592200
322320,329624.4,930650,155740,174128.2,338450,166580,155496.2,592200
320620,330522.6,930650,153000,157782.3,338450,167620,172740.3,592200
318980,267976.4,930650,150230,119145.4,338450,168750,148831,592200
314490,292398.1,930650,147970,125793,338450,166520,166605.1,592200
309920,320611.5,930650,145700,143077.7,338450,164220,177533.8,592200
305440,318253.9,930650,143450,139591.7,338450,161990,178662.2,592200
300840,310461.9,930650,141180,133912.3,338450,159660,176549.6,592200
296170,328326.1,930650,139470,152203.3,338450,156700,176122.8,592200
291550,240650.9,930650,137800,88541.4,338450,153750,152109.5,592200
286870,295751.3,930650,136110,122669.6,338450,150760,173081.7,592200
282170,326734.1,930650,134420,143072.7,338450,147750,183661.4,592200
277810,298782.8,930650,132820,120456,338450,144990,178326.8,592200
273340,291947.9,930650,131200,117421,338450,142140,174526.9,592200
269030,303949.5,930650,129610,122305.2,338450,139420,181644.3,592200
264600,278440.6,930650,128010,111201.2,338450,136590,167239.4,592200
259510,249429.5,930650,125830,90059.5,338450,133680,159370,592200
254410,270374.3,930650,123650,109895.3,338450,130760,160479,592200
249340,260202.2,930650,121490,121867.2,338450,127850,138335,592200
244250,218295.5,930650,119330,88007.4,338450,124920,130288.1,592200
239090,195780.9,930650,116940,76262.8,338450,122150,119518.1,592200
233850,212808.9,930650,114580,86332.2,338450,119270,126476.7,592200
228620,212144.9,930650,112180,83264.4,338450,116440,128880.5,592200
223410,223487.9,930650,109830,90127.2,338450,113580,133360.7,592200
218500,214972.6,930650,107280,83821.1,338450,111220,131151.5,592200
213560,196246.7,930650,104710,78938.9,338450,108850,117307.8,592200
208540,266390,930650,102170,129055.1,338450,106370,137334.9,592200
203620,268418.4,930650,99620,137979.1,338450,104000,130439.3,592200
196530,170256.2,930650,96370,57047.7,338450,100160,113208.5,592200
189430,226088.6,930650,93080,97248.6,338450,96350,128840,592200
182340,176083.9,930650,89840,51380.6,338450,92500,124703.3,592200
175290,158601.5,930650,86560,49316.9,338450,88730,109284.6,592200
167820,209858.3,930650,82810,86115,338450,85010,123743.3,592200
160360,224984.6,930650,79070,98175,338450,81290,126809.6,592200
152900,186037.9,930650,75310,71748.1,338450,77590,114289.8,592200
145440,152916.9,930650,71550,51602.6,338450,73890,101314.3,592200
137770,153951,930650,67810,49515.5,338450,69960,104435.5,592200
130290,162546.4,930650,64100,55594.9,338450,66190,106951.5,592200
122650,181501.8,930650,60360,69703,338450,62290,111798.8,592200
115110,189045.6,930650,56630,77760.3,338450,58480,111285.3,592200
110800,136439.3,930650,54280,38929,338450,56520,97510.3,592200
106570,129041.3,930650,51940,35424,338450,54630,93617.3,592200
102240,100277.1,930650,49580,18046.9,338450,52660,82230.2,592200
97890,94836.5,930650,47230,16372.1,338450,50660,78464.4,592200
94620,98217.9,930650,45610,17407.9,338450,49010,80810,592200
91290,89980,930650,44020,15677.9,338450,47270,74302.1,592200
87930,120760.5,930650,42380,37716.7,338450,45550,83043.8,592200
59570,122016.2,930650,26780,37512.2,338450,32790,84504,592200
55500,85108,930650,24540,13813.7,338450,30960,71294.3,592200
51440,64436.1,930650,22330,5484.4,338450,29110,58951.7,592200
47430,91539,930650,20110,21493.3,338450,27320,70045.7,592200
43410,106895.1,930650,17890,32238.7,338450,25520,74656.4,592200
41370,84394.6,930650,16530,13161.2,338450,24840,71233.4,592200
39270,78478.5,930650,15140,9088.9,338450,24130,69389.6,592200
37230,95719.3,930650,13760,22091.3,338450,23470,73628,592200
35130,94948.5,930650,12380,21705.3,338450,22750,73243.2,592200
33420,78640.5,930650,11020,9732,338450,22400,68908.5,592200
31670,77791.9,930650,9660,8484.7,338450,22010,69307.2,592200
29930,51325.5,930650,8290,5461.5,338450,21640,45864,592200
28240,60838.6,930650,6910,10894.2,338450,21330,49944.4,592200
26580,58367.1,930650,5860,11442,338450,20720,46925.1,592200
24960,48530,930650,4820,4196.2,338450,20140,44333.8,592200
23360,52886.6,930650,3760,3831.7,338450,19600,49054.9,592200
21770,75247.7,930650,2700,5233.4,338450,19070,70014.3,592200
20940,64845.2,930650,2520,5815.2,338450,18420,59030,592200
20130,109033.1,930650,2330,30828.9,338450,17800,78204.2,592200
19320,103321.7,930650,2150,27479.7,338450,17170,75842,592200
18530,86316.6,930650,1970,13849.1,338450,16560,72467.5,592200
17870,84784.1,930650,1900,15152.9,338450,15970,69631.2,592200
17200,79356.2,930650,1830,7768.1,338450,15370,71588.1,592200
16530,75639.7,930650,1750,4788.5,338450,14780,70851.2,592200
15910,74117.4,930650,1680,4676,338450,14230,69441.4,592200
15200,73054.1,930650,1560,5040,338450,13640,68014.1,592200
14530,70483.3,930650,1460,4438.5,338450,13070,66044.8,592200
13860,71832.3,930650,1330,5772.9,338450,12530,66059.4,592200
13160,70636.8,930650,1210,4876,338450,11950,65760.8,592200
12620,72568.6,930650,1310,6528.1,338450,11310,66040.5,592200
12070,81944.4,930650,1410,14378.7,338450,10660,67565.7,592200
11470,68572.7,930650,1500,5085.8,338450,9970,63486.9,592200
10870,67576.4,930650,1580,4426,338450,9290,63150.4,592200
11190,68278.6,930650,2480,4463.5,338450,8710,63815.1,592200
11390,66240,930650,3390,4376,338450,8000,61864,592200
11600,64756.9,930650,4260,4263.6,338450,7340,60493.3,592200
11830,73440.7,930650,5170,12271.1,338450,6660,61169.6,592200
12710,97229.9,930650,6650,29775,338450,6060,67454.9,592200
13590,99795.4,930650,8130,31367.2,338450,5460,68428.2,592200
14470,97668.7,930650,9630,30033.8,338450,4840,67634.9,592200
15390,90709.8,930650,11110,25450.8,338450,4280,65259,592200
17080,82819.2,930650,12500,19968.6,338450,4580,62850.6,592200
18740,88801.2,930650,13870,24101.7,338450,4870,64699.5,592200
20450,86146.2,930650,15260,22719.6,338450,5190,63426.6,592200
22140,81381.9,930650,16650,20332.4,338450,5490,61049.5,592200
23300,72627.5,930650,17430,14223.9,338450,5870,58403.6,592200
24500,69848.7,930650,18220,12724.6,338450,6280,57124.1,592200
25670,70080.3,930650,19000,12254.1,338450,6670,57826.2,592200
26870,68752.4,930650,19800,11213.3,338450,7070,57539.1,592200
27440,69480.6,930650,20220,11587.7,338450,7220,57892.9,592200
28070,74257.2,930650,20640,14641,338450,7430,59616.2,592200
28730,86539.6,930650,21110,23548.9,338450,7620,62990.7,592200
29250,108667,930650,21530,39919,338450,7720,68748,592200
33540,119261.9,930650,24570,47900.4,338450,8970,71361.5,592200
37720,117023.9,930650,27610,46846.3,338450,10110,70177.6,592200
41930,110574.1,930650,30630,43013.9,338450,11300,67560.2,592200
46170,109259.3,930650,33670,41468.4,338450,12500,67790.9,592200
50770,111861.8,930650,36970,44379.4,338450,13800,67482.4,592200
55420,119643.1,930650,40290,49544.1,338450,15130,70099,592200
60000,117261.2,930650,43560,48523.3,338450,16440,68737.9,592200
64630,111269.2,930650,46880,44581.5,338450,17750,66687.7,592200
69550,108550.2,930650,50340,43244.4,338450,19210,65305.8,592200
74580,110752,930650,53830,41624.7,338450,20750,69127.3,592200
79570,110654.2,930650,57260,41673.6,338450,22310,68980.6,592200
84490,106589.4,930650,60740,39081.8,338450,23750,67507.6,592200
86610,106987.5,930650,60390,40522,338450,26220,66465.5,592200
88740,110086.8,930650,60010,42884.5,338450,28730,67202.3,592200
90930,111013.5,930650,59650,42308.7,338450,31280,68704.8,592200
93070,108910.3,930650,59270,40674.2,338450,33800,68236.1,592200
94330,112405.5,930650,58120,42225.6,338450,36210,70179.9,592200
95640,111071.9,930650,56970,41225.2,338450,38670,69846.7,592200
96850,109485.1,930650,55800,39111.6,338450,41050,70373.5,592200
98130,109399.6,930650,54610,37622.6,338450,43520,71777,592200
99330,108775.6,930650,53470,34905.6,338450,45860,73870,592200
100490,107914.2,930650,52310,33123.3,338450,48180,74790.9,592200
101670,106317.4,930650,51190,30793.8,338450,50480,75523.6,592200
102810,107635.5,930650,50020,30325.6,338450,52790,77309.9,592200
103370,110340,930650,49380,32048,338450,53990,78292,592200
103820,115077.9,930650,48710,34900.5,338450,55110,80177.4,592200
104280,112352.3,930650,48070,33050.8,338450,56210,79301.5,592200
104730,112819.9,930650,47420,31998.2,338450,57310,80821.7,592200
106070,112244.6,930650,47410,30726.4,338450,58660,81518.2,592200
107400,104300.9,930650,47420,27756.6,338450,59980,76544.3,592200
108730,105001.4,930650,47390,27979.5,338450,61340,77021.9,592200
110070,110269.1,930650,47390,29028.9,338450,62680,81240.2,592200
111310,106797.2,930650,47420,27231,338450,63890,79566.2,592200
112600,99125.6,930650,47490,23513.3,338450,65110,75612.3,592200
113860,101924.8,930650,47520,22737.9,338450,66340,79186.9,592200
115010,98332.7,930650,47550,20669,338450,67460,77663.7,592200
117700,93738.2,930650,48880,20324.5,338450,68820,73413.7,592200
120390,88800.1,930650,50220,18726.9,338450,70170,70073.2,592200
123050,97865.6,930650,51550,19432.5,338450,71500,78433.1,592200
125720,93301,930650,52870,16585.9,338450,72850,76715.1,592200
128890,88409.2,930650,54390,13738.8,338450,74500,74670.4,592200
132090,87686,930650,55890,12332.2,338450,76200,75353.8,592200
135210,87359.2,930650,57380,10673.2,338450,77830,76686,592200
66130,81567.1,930650,23180,9254.9,338450,42950,72312.2,592200
68790,93013.1,930650,23830,9722,338450,44960,83291.1,592200
71440,87505.2,930650,24470,9429.6,338450,46970,78075.6,592200
74110,86681.3,930650,25100,8548.3,338450,49010,78133,592200
76790,84458.9,930650,25750,8926.9,338450,51040,75532,592200
79320,87983.4,930650,27320,8991.6,338450,52000,78991.8,592200
81810,93656,930650,28850,10848,338450,52960,82808,592200
84400,91570.6,930650,30420,9751,338450,53980,81819.6,592200
86920,89852.1,930650,31970,8513.3,338450,54950,81338.8,592200
88860,77342.5,930650,33000,8373.4,338450,55860,68969.1,592200
90830,75358.5,930650,34070,9074.3,338450,56760,66284.2,592200
92790,77939.7,930650,35100,18499.1,338450,57690,59440.6,592200
94730,99958.8,930650,36150,29295.1,338450,58580,70663.7,592200
95840,111065.5,930650,36460,25152.8,338450,59380,85912.7,592200
97000,108112.8,930650,36810,22573.2,338450,60190,85539.6,592200
98070,110053.1,930650,37100,24906.6,338450,60970,85146.5,592200
99220,101306.1,930650,37420,18775.3,338450,61800,82530.8,592200
99350,90028.8,930650,37630,11228,338450,61720,78800.8,592200
99580,87979.2,930650,37890,9400.1,338450,61690,78579.1,592200
99750,79405.8,930650,38100,7892.2,338450,61650,71513.6,592200
100020,64626,930650,38350,6417.2,338450,61670,58208.8,592200
99880,86848.3,930650,38370,8403.5,338450,61510,78444.8,592200
99670,68099.7,930650,38380,7393,338450,61290,60706.7,592200
99510,85609.6,930650,38400,8245.4,338450,61110,77364.2,592200
99320,85066.3,930650,38420,8594.8,338450,60900,76471.5,592200
100190,84059,930650,39550,10320.4,338450,60640,73738.6,592200
101040,79061.2,930650,40660,11957.7,338450,60380,67103.5,592200
101880,96999.2,930650,41760,17530.3,338450,60120,79468.9,592200
102670,100863.9,930650,42890,21056.9,338450,59780,79807,592200
104110,102033.8,930650,44240,22966.2,338450,59870,79067.6,592200
105490,103210.4,930650,45600,24613.3,338450,59890,78597.1,592200
106910,109130.4,930650,46960,28650.1,338450,59950,80480.3,592200
108320,121287.8,930650,48300,36458.8,338450,60020,84829,592200
109390,134586.4,930650,49410,46302.6,338450,59980,88283.8,592200
110600,149721.9,930650,50560,57446.8,338450,60040,92275.1,592200
111690,141955.8,930650,51660,51018.1,338450,60030,90937.7,592200
112830,112026,930650,52790,28699.9,338450,60040,83326.1,592200
114410,126534.6,930650,54230,40675.7,338450,60180,85858.9,592200
116050,135639.1,930650,55650,46602,338450,60400,89037.1,592200
117650,137518.6,930650,57060,47084.3,338450,60590,90434.3,592200
119250,148195.7,930650,58490,56145.2,338450,60760,92050.5,592200
121060,134227.2,930650,60960,62278.7,338450,60100,71948.5,592200
122900,151733.8,930650,63450,61403.7,338450,59450,90330.1,592200
124680,158862.6,930650,65900,69072,338450,58780,89790.6,592200
126510,160316.3,930650,68350,74833.5,338450,58160,85482.8,592200
127800,151150.8,930650,70400,66286.4,338450,57400,84864.4,592200
129190,169434.7,930650,72450,76918.9,338450,56740,92515.8,592200
130430,165299.1,930650,74460,87421.1,338450,55970,77878,592200
131760,190533.5,930650,76510,103185,338450,55250,87348.5,592200
133210,243654.4,930650,78700,134944.9,338450,54510,108709.5,592200
134700,294239.8,930650,80920,173218.7,338450,53780,121021.1,592200
136160,276857.3,930650,83100,166901.1,338450,53060,109956.2,592200
137640,298254.4,930650,85310,179337.9,338450,52330,118916.5,592200
144970,299833.7,930650,89220,180324.9,338450,55750,119508.8,592200
152360,309755.2,930650,93170,186776.8,338450,59190,122978.4,592200
159650,328519.5,930650,97090,194213.4,338450,62560,134306.1,592200
166970,335362.9,930650,101020,194527.3,338450,65950,140835.6,592200
174810,342701.2,930650,105350,197365.9,338450,69460,145335.3,592200
182610,345049.5,930650,109700,196284,338450,72910,148765.5,592200
190400,345260.1,930650,114030,195953.5,338450,76370,149306.6,592200
198200,352391.5,930650,118390,201226.4,338450,79810,151165.1,592200
205020,360319.7,930650,121560,202722.5,338450,83460,157597.2,592200
211880,345233.5,930650,124770,187953,338450,87110,157280.5,592200
218650,373799.3,930650,127950,204076.2,338450,90700,169723.1,592200
225420,390967,930650,131130,210252.9,338450,94290,180714.1,592200
231920,407186.4,930650,133140,215076,338450,98780,192110.4,592200
238390,411134.9,930650,135170,213365.5,338450,103220,197769.4,592200
244820,423676.8,930650,137180,220355.6,338450,107640,203321.2,592200
251260,436886.3,930650,139180,223124.6,338450,112080,213761.7,592200
256610,439967.9,930650,140790,225621.6,338450,115820,214346.3,592200
261880,471932.9,930650,142380,242919.2,338450,119500,229013.7,592200
267160,496741.5,930650,143950,253671.2,338450,123210,243070.3,592200
272450,490328.4,930650,145540,248894.9,338450,126910,241433.5,592200
278580,524196.6,930650,147630,267346.8,338450,130950,256849.8,592200
284650,541798.5,930650,149700,274430.5,338450,134950,267368,592200
290720,517685.3,930650,151810,266074.3,338450,138910,251611,592200
296790,512977.7,930650,153890,265427.2,338450,142900,247550.5,592200
297430,486161.6,930650,155400,252694.2,338450,142030,233467.4,592200
298170,477770.7,930650,156910,248650,338450,141260,229120.7,592200
298810,453748,930650,158430,238758.9,338450,140380,214989.1,592200
299510,455827.6,930650,159960,234485,338450,139550,221342.6,592200
299830,442308.8,930650,160930,228395.6,338450,138900,213913.2,592200
300140,451236.3,930650,161920,230638.8,338450,138220,220597.5,592200
300460,452694.5,930650,162920,231193.5,338450,137540,221501,592200
300770,451813.9,930650,163910,232227.3,338450,136860,219586.6,592200
300750,453830.4,930650,164710,230679.1,338450,136040,223151.3,592200
300780,444339.8,930650,165530,225693.9,338450,135250,218645.9,592200
300830,433826.3,930650,166340,226830.6,338450,134490,206995.7,592200
300810,461226.6,930650,167150,234083.6,338450,133660,227143,592200
301910,456711.1,930650,168230,232793.9,338450,133680,223917.2,592200
303030,459457.5,930650,169310,235243.7,338450,133720,224213.8,592200
304110,453546,930650,170410,232914.8,338450,133700,220631.2,592200
305230,442510.1,930650,171500,227569.4,338450,133730,214940.7,592200
306900,442348,930650,172890,236876.6,338450,134010,205471.4,592200
308490,445686.8,930650,174260,236218.8,338450,134230,209468,592200
310230,480287.3,930650,175670,242836.7,338450,134560,237450.6,592200
470180,518377.3,930650,224700,252828.2,338450,245480,265549.1,592200
472810,521996.5,930650,224970,261517.6,338450,247840,260478.9,592200
475350,521111.6,930650,225230,261695.6,338450,250120,259416,592200
477980,525254.8,930650,225500,257677.3,338450,252480,267577.5,592200
480520,535873.2,930650,225740,262292.4,338450,254780,273580.8,592200
484980,523106,930650,226140,254680.3,338450,258840,268425.7,592200
489350,523400.4,930650,226560,249154.8,338450,262790,274245.6,592200
493730,540859.7,930650,226980,249711.2,338450,266750,291148.5,592200
498170,545731.1,930650,227400,248838.5,338450,270770,296892.6,592200
503080,504226.7,930650,227730,243024.9,338450,275350,261201.8,592200
507960,512666.1,930650,228070,238898.5,338450,279890,273767.6,592200
512820,513668.5,930650,228430,240729.6,338450,284390,272938.9,592200
517690,488552.1,930650,228740,222000.4,338450,288950,266551.7,592200
522290,526669.3,930650,229210,242213.7,338450,293080,284455.6,592200
526790,530516.8,930650,229650,242545.1,338450,297140,287971.7,592200
531390,519441.6,930650,230090,242363.9,338450,301300,277077.7,592200
535950,479818.6,930650,230570,235729.9,338450,305380,244088.7,592200
534510,496615.3,930650,229410,250223,338450,305100,246392.3,592200
533020,518504.8,930650,228240,256355.5,338450,304780,262149.3,592200
531570,526955.4,930650,227090,255260.5,338450,304480,271694.9,592200
530160,526435.4,930650,225940,253157.2,338450,304220,273278.2,592200
528260,536388.6,930650,224660,255912.6,338450,303600,280476,592200
526460,541616.7,930650,223370,261348,338450,303090,280268.7,592200
524640,533474.6,930650,222100,258392.7,338450,302540,275081.9,592200
522830,544191.3,930650,220830,254801.5,338450,302000,289389.8,592200
521020,543508.6,930650,219750,248792.8,338450,301270,294715.8,592200
519250,537770.8,930650,218680,246296.8,338450,300570,291474,592200
517500,508918.8,930650,217630,246205.3,338450,299870,262713.5,592200
515700,514407.5,930650,216530,250081.4,338450,299170,264326.1,592200
510740,523115.9,930650,214200,250678.2,338450,296540,272437.7,592200
505860,537667.8,930650,211910,249821.6,338450,293950,287846.2,592200
500950,524813.3,930650,209580,248471.4,338450,291370,276341.9,592200
495990,485142.6,930650,207280,233224,338450,288710,251918.6,592200
491710,447730.9,930650,205890,216940.4,338450,285820,230790.5,592200
487360,465713.4,930650,204470,228263.5,338450,282890,237449.9,592200
483060,461739,930650,203080,227120.9,338450,279980,234618.1,592200
478750,444552.5,930650,201680,220978.2,338450,277070,223574.3,592200
472540,446934.6,930650,198430,214585,338450,274110,232349.6,592200
466320,395621.2,930650,195160,189765.6,338450,271160,205855.6,592200
460170,401692.9,930650,191920,197496.4,338450,268250,204196.5,592200
454000,411037.5,930650,188670,197058.7,338450,265330,213978.8,592200
449140,403600.6,930650,186430,198296.7,338450,262710,205303.9,592200
444360,361902.9,930650,184190,178598.4,338450,260170,183304.5,592200
439530,350161.7,930650,181940,178267.9,338450,257590,171893.8,592200
434710,320851.4,930650,179680,169361.3,338450,255030,151490.1,592200
430620,320727.9,930650,176660,176874.2,338450,253960,143853.7,592200
426530,302988.6,930650,173600,161177.9,338450,252930,141810.7,592200
422390,292943.5,930650,170560,153594.9,338450,251830,139348.6,592200
418240,275988.7,930650,167520,138274.6,338450,250720,137714.1,592200
412910,283021.7,930650,163900,135799.7,338450,249010,147222,592200
407620,284495.5,930650,160310,137612.7,338450,247310,146882.8,592200
402290,257206.8,930650,156680,125083.2,338450,245610,132123.6,592200
397020,274716.1,930650,153070,126308.1,338450,243950,148408,592200
385300,287706.2,930650,149180,132084,338450,236120,155622.2,592200
373650,272497.6,930650,145290,123815.1,338450,228360,148682.5,592200
362010,236037.8,930650,141410,105579.5,338450,220600,130458.3,592200
350370,212223.2,930650,137540,97139.1,338450,212830,115084.1,592200
339070,212755.4,930650,134040,93663,338450,205030,119092.4,592200
327670,250075.2,930650,130560,121660.5,338450,197110,128414.7,592200
316300,246915.7,930650,127060,124203.9,338450,189240,122711.8,592200
305010,262770.6,930650,123590,119307.4,338450,181420,143463.2,592200
294530,256648.8,930650,120240,113598.1,338450,174290,143050.7,592200
284050,252968.8,930650,116890,113588.6,338450,167160,139380.2,592200
273540,250662.3,930650,113500,121594.2,338450,160040,129068.1,592200
263110,217343.7,930650,110170,107771.7,338450,152940,109572,592200
256110,246287.3,930650,106350,108415.2,338450,149760,137872.1,592200
249100,233250.7,930650,102520,94950,338450,146580,138300.7,592200
242110,213474.8,930650,98710,84868.1,338450,143400,128606.7,592200
235070,204333.5,930650,94890,74162.1,338450,140180,130171.4,592200
227220,200580.7,930650,90850,67789.3,338450,136370,132791.4,592200
219440,221341.1,930650,86850,78840.7,338450,132590,142500.4,592200
211660,238539,930650,82830,83744.2,338450,128830,154794.8,592200
203810,214509.3,930650,78810,76309.5,338450,125000,138199.8,592200
196280,218390.6,930650,75170,74629.8,338450,121110,143760.8,592200
188770,231553.4,930650,71540,71633.1,338450,117230,159920.3,592200
181260,229453.6,930650,67900,66910.5,338450,113360,162543.1,592200
173670,235513,930650,64260,64758,338450,109410,170755,592200
167990,220648.7,930650,61660,63475.5,338450,106330,157173.2,592200
162240,211892.1,930650,59040,59733.1,338450,103200,152159,592200
156500,231443.4,930650,56400,63751.5,338450,100100,167691.9,592200
150760,218133.1,930650,53810,59818.9,338450,96950,158314.2,592200
145500,206580.4,930650,51350,55762.9,338450,94150,150817.5,592200
140220,205148.4,930650,48910,56558,338450,91310,148590.4,592200
134930,211947.2,930650,46450,60693.8,338450,88480,151253.4,592200
129720,206743.3,930650,44010,58503.1,338450,85710,148240.2,592200
124500,186037.2,930650,41590,51105.8,338450,82910,134931.4,592200
119300,179753,930650,39190,46138.5,338450,80110,133614.5,592200
114100,171773,930650,36770,42587.7,338450,77330,129185.3,592200
108900,166759.9,930650,34400,41351.9,338450,74500,125408,592200
109070,159957.5,930650,34660,38784.4,338450,74410,121173.1,592200
109210,150033.9,930650,34910,40357.8,338450,74300,109676.1,592200
109320,134503.5,930650,35170,35892.1,338450,74150,98611.4,592200
109440,127433.6,930650,35430,35026.1,338450,74010,92407.5,592200
109870,149762.3,930650,35840,40805.3,338450,74030,108957,592200
110340,122839,930650,36230,33506.8,338450,74110,89332.2,592200
110760,122656.2,930650,36650,32014.8,338450,74110,90641.4,592200
110840,124363.4,930650,34550,29178.1,338450,76290,95185.3,592200
110310,126393.6,930650,35010,29847.9,338450,75300,96545.7,592200
109760,130308.8,930650,35480,32088,338450,74280,98220.8,592200
109190,131146.8,930650,35940,33869.8,338450,73250,97277,592200
108710,141022.5,930650,36420,38760.8,338450,72290,102261.7,592200
118950,145256,930650,41870,42061,338450,77080,103195,592200
129240,156378.8,930650,47350,48810.1,338450,81890,107568.7,592200
139490,182170.3,930650,52780,64798.7,338450,86710,117371.6,592200
149880,201808.8,930650,58250,77870,338450,91630,123938.8,592200
162370,227508.6,930650,65140,93309.7,338450,97230,134198.9,592200
174890,234261.9,930650,72000,98368.1,338450,102890,135893.8,592200
187460,260544.9,930650,78860,112750.4,338450,108600,147794.5,592200
199970,302166.3,930650,85710,142000.9,338450,114260,160165.4,592200
212980,309260,930650,92300,146921.4,338450,120680,162338.6,592200
225960,305185.4,930650,98830,145929.1,338450,127130,159256.3,592200
238920,305109.2,930650,105390,144444.5,338450,133530,160664.7,592200
251940,327449.4,930650,111930,157882.5,338450,140010,169566.9,592200
265630,374872.2,930650,119510,190008.2,338450,146120,184864,592200
279360,382037.9,930650,127100,194571.6,338450,152260,187466.3,592200
293040,334013.3,930650,134670,159830.3,338450,158370,174183,592200
306750,353154.7,930650,142250,171242.2,338450,164500,181912.5,592200
320810,402529.5,930650,151110,211018.6,338450,169700,191510.9,592200
334860,425764.4,930650,159950,224909.2,338450,174910,200855.2,592200
348920,431409.5,930650,168800,229199.2,338450,180120,202210.3,592200
363040,446280.1,930650,177680,241029.7,338450,185360,205250.4,592200
374800,481126.5,930650,184160,260898.1,338450,190640,220228.4,592200
386620,489826,930650,190670,261159.3,338450,195950,228666.7,592200
398420,475336.7,930650,197160,249806.4,338450,201260,225530.3,592200
410230,478059.3,930650,203670,248816.6,338450,206560,229242.7,592200
428690,506220.6,930650,209360,261810.1,338450,219330,244410.5,592200
447170,527403.6,930650,215040,270470.6,338450,232130,256933,592200
465730,550831.4,930650,220740,279548.2,338450,244990,271283.2,592200
484210,569636.2,930650,226420,285507.8,338450,257790,284128.4,592200
504710,579304.9,930650,232950,281826.7,338450,271760,297478.2,592200
525180,595209.9,930650,239500,285756.1,338450,285680,309453.8,592200
545660,611647.5,930650,246010,285371.1,338450,299650,326276.4,592200
566200,629457.3,930650,252560,289942.6,338450,313640,339514.7,592200
583770,657843.1,930650,257440,303190.7,338450,326330,354652.4,592200
601380,667872.9,930650,262330,305764.6,338450,339050,362108.3,592200
618970,654121,930650,267200,303214.9,338450,351770,350906.1,592200
636510,636919.1,930650,272090,288865,338450,364420,348054.1,592200
640880,632076.2,930650,269930,278075.3,338450,370950,354000.9,592200
645220,626014.5,930650,267760,275256.2,338450,377460,350758.3,592200
649550,576580,930650,265610,223756.6,338450,383940,352823.4,592200
653920,554567.4,930650,263450,208877.2,338450,390470,345690.2,592200
657360,560659.8,930650,261750,215297.2,338450,395610,345362.6,592200
660900,573643.9,930650,260080,208260.9,338450,400820,365383,592200
664410,505490.5,930650,258380,175944.8,338450,406030,329545.7,592200
667910,596234.7,930650,256700,258608.4,338450,411210,337626.3,592200
671310,543707.9,930650,254670,223743.7,338450,416640,319964.2,592200
674690,540807.1,930650,252690,222985.9,338450,422000,317821.2,592200
678030,515670.6,930650,250680,208393.7,338450,427350,307276.9,592200
681470,489279.5,930650,248660,195870.6,338450,432810,293408.9,592200
676490,484243.9,930650,248700,204477.8,338450,427790,279766.1,592200
671530,451362.6,930650,248740,190777.2,338450,422790,260585.4,592200
666560,434376.1,930650,248780,186800.5,338450,417780,247575.6,592200
661540,419574.1,930650,248820,177764.2,338450,412720,241809.9,592200
655640,460383.2,930650,248370,211004.1,338450,407270,249379.1,592200
649720,484901.7,930650,247880,230232.5,338450,401840,254669.2,592200
643850,463800.8,930650,247420,214295.2,338450,396430,249505.6,592200
637990,479955.1,930650,246980,220414.6,338450,391010,259540.5,592200
631690,500247.3,930650,246360,237842.2,338450,385330,262405.1,592200
625430,530796.9,930650,245750,258884.6,338450,379680,271912.3,592200
619240,548077,930650,245130,256531.2,338450,374110,291545.8,592200
612960,545823.7,930650,244530,262209.4,338450,368430,283614.3,592200
603390,526260.4,930650,241830,265557,338450,361560,260703.4,592200
593880,546499.8,930650,239120,266613.7,338450,354760,279886.1,592200
584330,609126.9,930650,236430,278429.3,338450,347900,330697.6,592200
574790,624797.7,930650,233740,292226.6,338450,341050,332571.1,592200
565750,611594.5,930650,231250,288214.8,338450,334500,323379.7,592200
556680,595163.4,930650,228730,277386,338450,327950,317777.4,592200
547650,597183.2,930650,226280,282624.3,338450,321370,314558.9,592200
538650,562426.8,930650,223820,270632.2,338450,314830,291794.6,592200
528120,564782.8,930650,220690,268841.3,338450,307430,295941.5,592200
517620,560461.7,930650,217510,259856.6,338450,300110,300605.1,592200
507170,559724.4,930650,214380,247845.5,338450,292790,311878.9,592200
496660,538073.7,930650,211240,250474.4,338450,285420,287599.3,592200
493570,491940.2,930650,212250,240393,338450,281320,251547.2,592200
490520,478764.4,930650,213260,227099.7,338450,277260,251664.7,592200
487310,434587.2,930650,214220,217176.6,338450,273090,217410.6,592200
484150,417023.7,930650,215220,214935.5,338450,268930,202088.2,592200
481670,405451.6,930650,216490,219310.7,338450,265180,186140.9,592200
479180,403080.1,930650,217800,226207.5,338450,261380,176872.6,592200
476680,413224.6,930650,219030,228730,338450,257650,184494.6,592200
474240,404399.6,930650,220330,224080.6,338450,253910,180319,592200
471660,383199.2,930650,220990,211881.8,338450,250670,171317.4,592200
469040,371745.5,930650,221640,202673,338450,247400,169072.5,592200
466370,361030.5,930650,222270,199074.5,338450,244100,161956,592200
463830,368220.2,930650,222950,208117.9,338450,240880,160102.3,592200
464800,379129.2,930650,222500,215983.5,338450,242300,163145.7,592200
465800,374676.3,930650,222020,200710.9,338450,243780,173965.4,592200
466750,384135.8,930650,221570,196806.4,338450,245180,187329.4,592200
467800,365174.4,930650,221130,191271.8,338450,246670,173902.6,592200
467470,363192.6,930650,220360,186954.5,338450,247110,176238.1,592200
467140,343585.5,930650,219600,176541.1,338450,247540,167044.4,592200
466910,331494.6,930650,218840,171486.5,338450,248070,160008.1,592200
375890,317895.7,930650,192160,169236.1,338450,183730,148659.6,592200
367560,304091.5,930650,190030,164910.2,338450,177530,139181.3,592200
359210,305124.8,930650,187900,168437.8,338450,171310,136687,592200
350860,270036.2,930650,185750,150529.2,338450,165110,119507,592200
342540,259254.9,930650,183610,144604.9,338450,158930,114650,592200
344090,271404.4,930650,184970,149414.9,338450,159120,121989.5,592200
345790,272136,930650,186350,150366.4,338450,159440,121769.6,592200
347390,288962.3,930650,187730,153048.8,338450,159660,135913.5,592200
349030,317233.2,930650,189100,161419.1,338450,159930,155814.1,592200
350800,305856.4,930650,190270,169451.2,338450,160530,136405.2,592200
352550,291745.8,930650,191420,165911.3,338450,161130,125834.5,592200
354300,286026.9,930650,192570,164041.1,338450,161730,121985.8,592200
356030,286615.4,930650,193710,164866,338450,162320,121749.4,592200
358090,303464.5,930650,195190,181077.4,338450,162900,122387.1,592200
360240,311120.9,930650,196670,183701.1,338450,163570,127419.8,592200
362330,292186.1,930650,198140,171030.8,338450,164190,121155.3,592200
364450,322216.6,930650,199620,195035.2,338450,164830,127181.4,592200
370730,340033.4,930650,201360,207933.3,338450,169370,132100.1,592200
376890,342320.4,930650,203050,201454.1,338450,173840,140866.3,592200
383090,355804,930650,204790,204308.5,338450,178300,151495.5,592200
389240,364579.1,930650,206500,210825.6,338450,182740,153753.5,592200
395590,369436.5,930650,207900,212712.8,338450,187690,156723.7,592200
401860,385502.8,930650,209280,217221,338450,192580,168281.8,592200
408190,387225.2,930650,210650,215998.4,338450,197540,171226.8,592200
414420,412215.5,930650,212030,231862.7,338450,202390,180352.8,592200
422030,422452.5,930650,214290,235131.5,338450,207740,187321,592200
429650,433797,930650,216550,232922.8,338450,213100,200874.2,592200
437210,449030.5,930650,218830,236660,338450,218380,212370.5,592200
444810,456358.9,930650,221070,239743,338450,223740,216615.9,592200
450950,485146,930650,221110,251116.1,338450,229840,234029.9,592200
457110,499597,930650,221140,254737.2,338450,235970,244859.8,592200
463230,501329.9,930650,221150,254977.9,338450,242080,246352,592200
469400,500422,930650,221180,254578.5,338450,248220,245843.5,592200
476790,505410.7,930650,222510,262701.5,338450,254280,242709.2,592200
484060,523591.6,930650,223820,266498.9,338450,260240,257092.7,592200
491420,523055.9,930650,225140,266754.5,338450,266280,256301.4,592200
498750,508806.1,930650,226460,253144.4,338450,272290,255661.7,592200
506210,497121,930650,227620,247476,338450,278590,249645,592200
513700,494449.4,930650,228830,246381.5,338450,284870,248067.9,592200
521080,508168.1,930650,229990,250740.6,338450,291090,257427.5,592200
528520,501438.9,930650,231150,247775.9,338450,297370,253663,592200
532970,498380.7,930650,231910,245360.2,338450,301060,253020.5,592200
537420,507854.5,930650,232680,245847.1,338450,304740,262007.4,592200
541760,508952.2,930650,233430,246038.7,338450,308330,262913.5,592200
546220,517367.4,930650,234180,249124.7,338450,312040,268242.7,592200
548670,507160.2,930650,234200,250297.6,338450,314470,256862.6,592200
551120,521147.4,930650,234220,251977,338450,316900,269170.4,592200
553490,527250.5,930650,234230,250082.2,338450,319260,277168.3,592200
555900,521469,930650,234240,245452.1,338450,321660,276016.9,592200
561380,536689.7,930650,234930,248820.8,338450,326450,287868.9,592200
566840,532426.6,930650,235650,246172.4,338450,331190,286254.2,592200
572300,531344.1,930650,236370,250780.1,338450,335930,280564,592200
577750,546442.6,930650,237070,249196.7,338450,340680,297245.9,592200
569860,545756.3,930650,234200,243777.2,338450,335660,301979.1,592200
561990,533322.9,930650,231340,243091.9,338450,330650,290231,592200
554170,529717.8,930650,228480,242493.3,338450,325690,287224.5,592200
546220,510577.5,930650,225610,237188,338450,320610,273389.5,592200
537180,499153.3,930650,222580,235656.6,338450,314600,263496.7,592200
528120,503742.6,930650,219550,243724.8,338450,308570,260017.8,592200
519030,509868.4,930650,216540,241866.4,338450,302490,268002,592200
510000,505049.1,930650,213490,233717.6,338450,296510,271331.5,592200
500360,508382.1,930650,210060,236325.4,338450,290300,272056.7,592200
490700,519100.6,930650,206620,234158.7,338450,284080,284941.9,592200
481070,498684.9,930650,203190,228771.8,338450,277880,269913.1,592200
471470,477440.3,930650,199730,221982.1,338450,271740,255458.2,592200
461810,439073,930650,196030,195038.7,338450,265780,244034.3,592200
452250,433829.1,930650,192310,196816.1,338450,259940,237013,592200
442660,448587.9,930650,188610,209113.1,338450,254050,239474.8,592200
433120,457692.1,930650,184880,225502,338450,248240,232190.1,592200
423780,442451,930650,181070,219677.2,338450,242710,222773.8,592200
414410,470811.1,930650,177240,225206.7,338450,237170,245604.4,592200
405090,496006.7,930650,173410,234081.9,338450,231680,261924.8,592200
395750,459130.2,930650,169580,219671,338450,226170,239459.2,592200
387140,435508.2,930650,166140,207970.8,338450,221000,227537.4,592200
378610,413603.1,930650,162710,207113.8,338450,215900,206489.3,592200
369950,376010.8,930650,159280,189228.1,338450,210670,186782.7,592200
361440,348393.9,930650,155850,177040.2,338450,205590,171353.7,592200
354750,336668.8,930650,152790,172564.6,338450,201960,164104.2,592200
348120,356117.5,930650,149700,183975.9,338450,198420,172141.6,592200
341480,326643.1,930650,146620,153085.1,338450,194860,173558,592200
334890,340400.8,930650,143550,136520.5,338450,191340,203880.3,592200
328470,335434.5,930650,140520,135094.6,338450,187950,200339.9,592200
322140,325719.3,930650,137500,140690.2,338450,184640,185029.1,592200
315680,298317.3,930650,134460,122607.4,338450,181220,175709.9,592200
309330,296124.9,930650,131410,114689.6,338450,177920,181435.3,592200
303490,269379.1,930650,128650,110492.4,338450,174840,158886.7,592200
297670,283784.1,930650,125880,116665.7,338450,171790,167118.4,592200
291830,273768.3,930650,123120,116166.2,338450,168710,157602.1,592200
286010,253688.8,930650,120340,114627,338450,165670,139061.8,592200
279480,264178,930650,116980,115264.6,338450,162500,148913.4,592200
272970,277689.2,930650,113630,117182.1,338450,159340,160507.1,592200
266430,266568,930650,110260,120693,338450,156170,145875,592200
259920,215179.9,930650,106900,86362.9,338450,153020,128817,592200
252520,257249.1,930650,103390,121942.3,338450,149130,135306.8,592200
245090,179279.7,930650,99870,65842,338450,145220,113437.7,592200
237680,162799.3,930650,96380,54343.3,338450,141300,108456,592200
237250,162239.1,930650,80290,50215.4,338450,156960,112023.7,592200
228200,193686.7,930650,75190,67805.2,338450,153010,125881.5,592200
219200,256249,930650,70080,110763.6,338450,149120,145485.4,592200
210140,217979.3,930650,64960,82871.6,338450,145180,135107.7,592200
201130,182379.6,930650,59860,65890.2,338450,141270,116489.4,592200
195900,167015.6,930650,58040,53599,338450,137860,113416.6,592200
190780,138157.4,930650,56270,25550.3,338450,134510,112607.1,592200
185520,134228.3,930650,54450,25015.9,338450,131070,109212.4,592200
180310,132417.5,930650,52650,25174,338450,127660,107243.5,592200
176500,120267.5,930650,52490,17814,338450,124010,102453.5,592200
172660,101692.7,930650,52350,15873.4,338450,120310,85819.3,592200
168880,122901.7,930650,52160,21385.5,338450,116720,101516.2,592200
165080,126846,930650,52000,26118.6,338450,113080,100727.4,592200
161110,131373.2,930650,51810,32891.8,338450,109300,98481.4,592200
157150,108425.1,930650,51640,17873.7,338450,105510,90551.4,592200
153220,129313.9,930650,51450,26705.6,338450,101770,102608.3,592200
149360,142342.8,930650,51270,36593.2,338450,98090,105749.6,592200
149710,146360.9,930650,53020,37254.6,338450,96690,109106.3,592200
150150,148041.9,930650,54780,41094.6,338450,95370,106947.3,592200
150520,162737.5,930650,56510,53716.8,338450,94010,109020.7,592200
150890,138382.9,930650,58250,39425.9,338450,92640,98957,592200
150120,118636.3,930650,59040,27688.3,338450,91080,90948,592200
149320,114042.7,930650,59780,23180,338450,89540,90862.7,592200
148570,107982.9,930650,60560,22331.9,338450,88010,85651,592200
147780,99033.1,930650,61310,18643.2,338450,86470,80389.9,592200
146540,96277.9,930650,62070,16485.3,338450,84470,79792.6,592200
145350,95596.3,930650,62840,17024.6,338450,82510,78571.7,592200
144150,96676.1,930650,63600,18843.5,338450,80550,77832.6,592200
142960,100195.8,930650,64390,19516.1,338450,78570,80679.7,592200
137110,107733.4,930650,60900,21501,338450,76210,86232.4,592200
131330,105486.7,930650,57410,21727.9,338450,73920,83758.8,592200
125500,109511.6,930650,53930,21995.8,338450,71570,87515.8,592200
119720,97759.1,930650,50460,16947.5,338450,69260,80811.6,592200
114400,93640.6,930650,47010,13812,338450,67390,79828.6,592200
109120,91729.6,930650,43580,13821,338450,65540,77908.6,592200
103840,94985.5,930650,40140,16557.7,338450,63700,78427.8,592200
98440,88911.6,930650,36670,13261.6,338450,61770,75650,592200
93020,83449.6,930650,33550,10887.2,338450,59470,72562.4,592200
87600,89313.6,930650,30420,13859.4,338450,57180,75454.2,592200
82100,82442.8,930650,27270,9595,338450,54830,72847.8,592200
76600,69625.8,930650,24140,4370.2,338450,52460,65255.6,592200
80020,67209.9,930650,30020,7022.8,338450,50000,60187.1,592200
83360,72444.4,930650,35900,14895.6,338450,47460,57548.8,592200
86770,74898.9,930650,41780,18986.1,338450,44990,55912.8,592200
90090,72451.4,930650,47660,20435.7,338450,42430,52015.7,592200
93380,76000.9,930650,53110,24519.8,338450,40270,51481.1,592200
96630,75155.5,930650,58590,23121.8,338450,38040,52033.7,592200
99920,75963.4,930650,64070,20989.7,338450,35850,54973.7,592200
103160,76412.2,930650,69530,19856.2,338450,33630,56556,592200
106560,79905.4,930650,75020,20296.2,338450,31540,59609.2,592200
109860,87520,930650,80480,27005,338450,29380,60515,592200
113240,89296.9,930650,85960,27250.6,338450,27280,62046.3,592200
116620,90827.2,930650,91460,30582.1,338450,25160,60245.1,592200
125490,103626.4,930650,97390,42511.3,338450,28100,61115.1,592200
134350,97558.3,930650,103350,37926.9,338450,31000,59631.4,592200
143210,96134.5,930650,109280,32856,338450,33930,63278.5,592200
152100,130352.3,930650,115240,62729.2,338450,36860,67623.1,592200
162580,210198.7,930650,122290,121780.9,338450,40290,88417.8,592200
172980,198363.4,930650,129330,115094.4,338450,43650,83269,592200
183410,185253.9,930650,136380,106691.2,338450,47030,78562.7,592200
193790,203458.3,930650,143420,121698.1,338450,50370,81760.2,592200
204510,188394.3,930650,149980,109512.3,338450,54530,78882,592200
215190,242360.2,930650,156570,149762,338450,58620,92598.2,592200
225890,254492.2,930650,163110,160073.3,338450,62780,94418.9,592200
236550,241541.1,930650,169670,151244.6,338450,66880,90296.5,592200
253260,204734,930650,174320,120531.9,338450,78940,84202.1,592200
270010,193666,930650,178940,110848.6,338450,91070,82817.4,592200
286720,218467.2,930650,183550,122572.5,338450,103170,95894.7,592200
303330,224298.3,930650,188170,116418.1,338450,115160,107880.2,592200
319750,217299.3,930650,192940,108202.1,338450,126810,109097.2,592200
336100,231230.3,930650,197720,109939.6,338450,138380,121290.7,592200
352550,218411.5,930650,202480,107297.6,338450,150070,111113.9,592200
368940,242224.9,930650,207230,111359.9,338450,161710,130865,592200
385440,233772,930650,211800,124596.7,338450,173640,109175.3,592200
401910,229521.4,930650,216360,119400.2,338450,185550,110121.2,592200
418500,249091.6,930650,220900,124106.3,338450,197600,124985.3,592200
434940,255828.9,930650,225460,117649.5,338450,209480,138179.4,592200
443230,278793.7,930650,226920,131779.5,338450,216310,147014.2,592200
451420,269869.1,930650,228360,131560.9,338450,223060,138308.2,592200
459630,293814.5,930650,229810,133411.8,338450,229820,160402.7,592200
467830,295449.4,930650,231250,142015,338450,236580,153434.4,592200
475230,319408.3,930650,232320,150475.4,338450,242910,168932.9,592200
482750,344477.9,930650,233410,152502.9,338450,249340,191975,592200
490190,328875.7,930650,234500,122509.9,338450,255690,206365.8,592200
497570,345483,930650,235590,141202.4,338450,261980,204280.6,592200
505420,305202.5,930650,236980,137178.1,338450,268440,168024.4,592200
513170,318531.4,930650,238370,137075.6,338450,274800,181455.8,592200
521030,324962.5,930650,239760,137128.2,338450,281270,187834.3,592200
528780,303348.7,930650,241160,139067.7,338450,287620,164281,592200
530410,301294.7,930650,241190,140424.9,338450,289220,160869.8,592200
531930,344131.1,930650,241180,158813,338450,290750,185318.1,592200
533590,328477.5,930650,241200,149049.6,338450,292390,179427.9,592200
535130,372912.6,930650,241210,155412.4,338450,293920,217500.2,592200
537140,359910.1,930650,241520,150576.6,338450,295620,209333.5,592200
539060,330031.3,930650,241790,143538.7,338450,297270,186492.6,592200
541050,309717.5,930650,242080,130734.8,338450,298970,178982.7,592200
469820,311537,930650,222990,140577.8,338450,246830,170959.2,592200
470860,317078,930650,221840,138679,338450,249020,178399,592200
471810,310398.4,930650,220680,135811,338450,251130,174587.4,592200
472850,301689.3,930650,219510,139355,338450,253340,162334.3,592200
473850,336282.1,930650,218340,138377.6,338450,255510,197904.5,592200
465730,327831.4,930650,214760,136691.9,338450,250970,191139.5,592200
457590,332871,930650,211170,141844.7,338450,246420,191026.3,592200
449450,336564.2,930650,207570,137941.8,338450,241880,198622.4,592200
441280,320715.9,930650,203970,134720.8,338450,237310,185995.1,592200
434160,283312.4,930650,200410,125072.7,338450,233750,158239.7,592200
427060,277115,930650,196870,119290.6,338450,230190,157824.4,592200
419980,248212.2,930650,193310,111372.3,338450,226670,136839.9,592200
412850,229498.8,930650,189750,105904.7,338450,223100,123594.1,592200
403610,258074.8,930650,186420,110393.6,338450,217190,147681.2,592200
394400,263898.8,930650,183100,112737,338450,211300,151161.8,592200
385210,228796.3,930650,179770,108586.2,338450,205440,120210.1,592200
375930,236372.5,930650,176430,112671.7,338450,199500,123700.8,592200
366320,254485,930650,172950,117330.9,338450,193370,137154.1,592200
356730,253021.2,930650,169450,110750.2,338450,187280,142271,592200
347090,239248.9,930650,165960,95750.4,338450,181130,143498.5,592200
337520,211331.7,930650,162470,90040,338450,175050,121291.7,592200
327600,209720.4,930650,158290,91293.4,338450,169310,118427,592200
317750,208794.6,930650,154140,82444.5,338450,163610,126350.1,592200
307900,198602.3,930650,149980,78327.8,338450,157920,120274.5,592200
298020,175629.2,930650,145810,71060.4,338450,152210,104568.8,592200
289380,164907.2,930650,141670,77738.1,338450,147710,87169.1,592200
280660,177234.1,930650,137490,90719,338450,143170,86515.1,592200
272000,181997.8,930650,133310,85923.7,338450,138690,96074.1,592200
263330,196807.7,930650,129140,86755.3,338450,134190,110052.4,592200
257180,194471.4,930650,126210,84982.4,338450,130970,109489,592200
251060,204977,930650,123310,91935.6,338450,127750,113041.4,592200
244950,221738.7,930650,120390,100931.1,338450,124560,120807.6,592200
238740,207297.8,930650,117450,104499,338450,121290,102798.8,592200
231400,207438.7,930650,112950,108875.5,338450,118450,98563.2,592200
224090,219489.1,930650,108480,107628.1,338450,115610,111861,592200
216690,226776.1,930650,103990,99308,338450,112700,127468.1,592200
209420,214038.2,930650,99490,97102.2,338450,109930,116936,592200
199800,195657.6,930650,94410,96877.2,338450,105390,98780.4,592200
190200,196510.2,930650,89340,93171.2,338450,100860,103339,592200
180630,206228.4,930650,84300,91404.3,338450,96330,114824.1,592200
170980,157448.4,930650,79200,67720.4,338450,91780,89728,592200
170160,94529.1,930650,78380,28280,338450,91780,66249.1,592200
169400,111467,930650,77570,25728.6,338450,91830,85738.4,592200
168540,108315.9,930650,76720,25458.2,338450,91820,82857.7,592200
167760,108206.9,930650,75910,24382.6,338450,91850,83824.3,592200
166440,111115.6,930650,75050,23626.7,338450,91390,87488.9,592200
165180,101543.2,930650,74220,20310.3,338450,90960,81232.9,592200
163930,106122.5,930650,73380,21537.2,338450,90550,84585.3,592200
162620,100759.5,930650,72530,17982.7,338450,90090,82776.8,592200
162910,94267.8,930650,72890,15746,338450,90020,78521.8,592200
163190,72275.9,930650,73250,12532.3,338450,89940,59743.6,592200
163510,52460.8,930650,73620,10339.4,338450,89890,42121.4,592200
163750,65964.9,930650,73980,12108.5,338450,89770,53856.4,592200
173870,72360,930650,81040,12199.1,338450,92830,60160.9,592200
183990,73549.6,930650,88130,14982.1,338450,95860,58567.5,592200
194130,81051.2,930650,95220,19680.6,338450,98910,61370.6,592200
204350,91692.8,930650,102300,21770.8,338450,102050,69922,592200
214290,92160.2,930650,109350,21717.4,338450,104940,70442.8,592200
224280,87554,930650,116370,22693.5,338450,107910,64860.5,592200
234360,89861,930650,123440,22978.4,338450,110920,66882.6,592200
244280,87607.9,930650,130480,23416.7,338450,113800,64191.2,592200
254960,85071.8,930650,137740,24986.2,338450,117220,60085.6,592200
265580,87573.8,930650,145000,25854.1,338450,120580,61719.7,592200
276200,92534.2,930650,152250,29878,338450,123950,62656.2,592200
286820,92740.5,930650,159520,28457.5,338450,127300,64283,592200
297570,98564.3,930650,164730,29433.3,338450,132840,69131,592200
308280,103492.9,930650,169960,32156.6,338450,138320,71336.3,592200
319060,98443.9,930650,175210,33350.8,338450,143850,65093.1,592200
329840,100624,930650,180450,37896.6,338450,149390,62727.4,592200
340610,103178.2,930650,184960,38091,338450,155650,65087.2,592200
351300,114927.8,930650,189430,42880.4,338450,161870,72047.4,592200
362040,126703.7,930650,193930,44772.6,338450,168110,81931.1,592200
372790,137137.7,930650,198410,49857.1,338450,174380,87280.6,592200
384210,162915.8,930650,203140,56457.6,338450,181070,106458.2,592200
395680,178340.3,930650,207850,59577.9,338450,187830,118762.4,592200
407160,181144.1,930650,212590,64170,338450,194570,116974.1,592200
418650,177829.1,930650,217280,67974.9,338450,201370,109854.2,592200
436080,189034,930650,222310,70340.7,338450,213770,118693.3,592200
453640,190911.3,930650,227310,65805.2,338450,226330,125106.1,592200
471170,211212.2,930650,232340,69733,338450,238830,141479.2,592200
488710,230137.5,930650,237370,72254,338450,251340,157883.5,592200
505800,259500.1,930650,242400,79104.7,338450,263400,180395.4,592200
522980,273117.2,930650,247430,81656.4,338450,275550,191460.8,592200
540120,283852.9,930650,252450,87695,338450,287670,196157.9,592200
557220,293031.7,930650,257490,92571.2,338450,299730,200460.5,592200
573680,297514.9,930650,262280,95864.2,338450,311400,201650.7,592200
590150,306552.4,930650,267080,94204.3,338450,323070,212348.1,592200
606600,324054.5,930650,271830,93636.2,338450,334770,230418.3,592200
623110,340891.5,930650,276630,98069.3,338450,346480,242822.2,592200
632730,372884.1,930650,278470,110761.1,338450,354260,262123,592200
642310,388879.6,930650,280300,110913.2,338450,362010,277966.4,592200
651850,417902.3,930650,282140,124974,338450,369710,292928.3,592200
661430,429537.3,930650,283970,128205.5,338450,377460,301331.8,592200
664690,444749.1,930650,279780,129192.4,338450,384910,315556.7,592200
668030,458238.4,930650,275610,133681.9,338450,392420,324556.5,592200
671250,470284.7,930650,271410,138063,338450,399840,332221.7,592200
710610,480828.9,930650,292910,136696,338450,417700,344132.9,592200
721470,481349.5,930650,295070,133544.9,338450,426400,347804.6,592200
732350,489865.8,930650,297210,132839.8,338450,435140,357026,592200
743220,484406.6,930650,299390,133860.9,338450,443830,350545.7,592200
754110,481677.3,930650,301540,132157.5,338450,452570,349519.8,592200
759500,489151.3,930650,302610,132867.4,338450,456890,356283.9,592200
764890,503694.6,930650,303700,137460.2,338450,461190,366234.4,592200
770240,528567.6,930650,304790,142779.6,338450,465450,385788,592200
775690,536000.9,930650,305850,140817.6,338450,469840,395183.3,592200
780930,539376.9,930650,306920,136720,338450,474010,402656.9,592200
786270,525057.5,930650,308010,130960.2,338450,478260,394097.3,592200
791580,525420.4,930650,309090,132708.6,338450,482490,392711.8,592200
796830,529492.8,930650,310130,136522.6,338450,486700,392970.2,592200
801910,525544.7,930650,311080,137344.1,338450,490830,388200.6,592200
807030,526954.9,930650,312060,136320.8,338450,494970,390634.1,592200
812140,515822.5,930650,313040,125511.6,338450,499100,390310.9,592200
817240,502763.5,930650,314000,123433.3,338450,503240,379330.2,592200
813120,504005.2,930650,311620,130774.2,338450,501500,373231,592200
809040,498119.6,930650,309230,133877.4,338450,499810,364242.2,592200
805020,502491.2,930650,306890,133417.8,338450,498130,369073.4,592200
800970,506447.8,930650,304520,132752.1,338450,496450,373695.7,592200
796080,492233.1,930650,301650,127559.2,338450,494430,364673.9,592200
791350,488067.9,930650,298840,124605,338450,492510,363462.9,592200
786450,487597.8,930650,295980,121292.9,338450,490470,366304.9,592200
781640,473210.1,930650,293140,115662.3,338450,488500,357547.8,592200
776550,459601,930650,290160,114009.6,338450,486390,345591.4,592200
771490,457863.3,930650,287170,113944.9,338450,484320,343918.4,592200
766400,460696.8,930650,284200,113583.2,338450,482200,347113.6,592200
761230,456865.3,930650,281180,113338.8,338450,480050,343526.5,592200
742160,453993.9,930650,274660,114397.2,338450,467500,339596.7,592200
723050,443250.9,930650,268130,112181,338450,454920,331069.9,592200
703960,435720.6,930650,261610,112309.3,338450,442350,323411.3,592200
684760,436537.4,930650,255050,112847.1,338450,429710,323690.3,592200
665710,423702.3,930650,248480,110526.5,338450,417230,313175.8,592200
646660,445438.8,930650,241900,113395.3,338450,404760,332043.5,592200
627650,441653.3,930650,235330,114927,338450,392320,326726.3,592200
608590,431757.8,930650,228740,111342.6,338450,379850,320415.2,592200
589000,428659.2,930650,221920,107521.4,338450,367080,321137.8,592200
569480,422057.1,930650,215120,106699.5,338450,354360,315357.6,592200
549950,397319.7,930650,208300,101071.9,338450,341650,296247.8,592200
530380,384485.6,930650,201490,91978.1,338450,328890,292507.5,592200
511590,343616,930650,195940,83029.2,338450,315650,260586.8,592200
492880,302171.5,930650,190430,70652.1,338450,302450,231519.4,592200
474110,283576.8,930650,184910,65946.9,338450,289200,217629.9,592200
455340,258033.4,930650,179370,58771.5,338450,275970,199261.9,592200
436240,242298.9,930650,173800,57495.6,338450,262440,184803.3,592200
417220,234340,930650,168230,63020.8,338450,248990,171319.2,592200
398180,214746.8,930650,162660,58770.7,338450,235520,155976.1,592200
379090,205230.7,930650,157070,55723.7,338450,222020,149507,592200
361710,175418.8,930650,152030,51920.8,338450,209680,123498,592200
344240,170429.5,930650,146990,49472.1,338450,197250,120957.4,592200
326800,167436.8,930650,141930,47369,338450,184870,120067.8,592200
309360,142582.9,930650,136930,41132,338450,172430,101450.9,592200
304770,136338.5,930650,136160,40091.8,338450,168610,96246.7,592200
300220,142198.9,930650,135420,39580.6,338450,164800,102618.3,592200
295610,162497.9,930650,134660,43864.1,338450,160950,118633.8,592200
291090,161266.7,930650,133910,45437.2,338450,157180,115829.5,592200
287840,157408.6,930650,134070,45642.9,338450,153770,111765.7,592200
284640,156463.2,930650,134190,48446.1,338450,150450,108017.1,592200
281500,156276.8,930650,134340,51397.2,338450,147160,104879.6,592200
278310,146143,930650,134490,46564.7,338450,143820,99578.3,592200
273550,138613.6,930650,134480,43135.1,338450,139070,95478.5,592200
268830,133461.6,930650,134530,44022,338450,134300,89439.6,592200
264110,129589.7,930650,134570,45435.6,338450,129540,84154.1,592200
259400,127615.4,930650,134580,46232.7,338450,124820,81382.7,592200
255600,106984.3,930650,132380,33547.3,338450,123220,73437,592200
251750,93123.3,930650,130160,27755,338450,121590,65368.3,592200
247940,88282.2,930650,127950,24733.7,338450,119990,63548.5,592200
244140,85879.7,930650,125740,23079.4,338450,118400,62800.3,592200
242250,79918,930650,124970,21792.6,338450,117280,58125.4,592200
240430,76377.1,930650,124190,23111.9,338450,116240,53265.2,592200
238640,73428.8,930650,123430,21982.2,338450,115210,51446.6,592200
236840,73510.9,930650,122640,22853.8,338450,114200,50657.1,592200
234470,67936.1,930650,121250,21654.5,338450,113220,46281.6,592200
232090,67371.6,930650,119850,21668.8,338450,112240,45702.8,592200
229740,63004.4,930650,118440,17791.6,338450,111300,45212.8,592200
227350,62129.1,930650,117050,17151,338450,110300,44978.1,592200
230780,62542.5,930650,117420,17076.4,338450,113360,45466.1,592200
234220,65500.6,930650,117820,17925,338450,116400,47575.6,592200
237660,67235,930650,118210,18162.9,338450,119450,49072.1,592200
241180,63851.7,930650,118590,17377,338450,122590,46474.7,592200
242270,66308.3,930650,117590,17797,338450,124680,48511.3,592200
243320,62406,930650,116580,15750.8,338450,126740,46655.2,592200
244350,64129.2,930650,115560,15488.9,338450,128790,48640.3,592200
245460,64399.8,930650,114550,15715.1,338450,130910,48684.7,592200
246400,62431.4,930650,113770,13945.9,338450,132630,48485.5,592200
247390,60761.5,930650,112960,13378.7,338450,134430,47382.8,592200
248250,59128.3,930650,112140,12033.9,338450,136110,47094.4,592200
249160,54150.4,930650,111340,11159.2,338450,137820,42991.2,592200
247960,57197,930650,110370,10909.7,338450,137590,46287.3,592200
246720,55658.4,930650,109440,11287.4,338450,137280,44371,592200
245370,54500.5,930650,108450,11104,338450,136920,43396.5,592200
244180,53458.8,930650,107500,10260,338450,136680,43198.8,592200
243970,53599.5,930650,107680,11136.3,338450,136290,42463.2,592200
243800,56032.4,930650,107850,12643.8,338450,135950,43388.6,592200
243660,50948.7,930650,108040,12567.7,338450,135620,38381,592200
155430,52270.9,930650,99550,18216.6,338450,55880,34054.3,592200
161600,53062.9,930650,103390,18216.8,338450,58210,34846.1,592200
167830,63103.9,930650,107220,18889.4,338450,60610,44214.5,592200
174140,64315.6,930650,111080,19567.1,338450,63060,44748.5,592200
180330,66588.4,930650,114910,21277.1,338450,65420,45311.3,592200
180280,68460.1,930650,113300,21714.3,338450,66980,46745.8,592200
180210,67219.6,930650,111670,21716.8,338450,68540,45502.8,592200
180110,64149.3,930650,110050,21187.4,338450,70060,42961.9,592200
180070,63800.4,930650,108440,21280.2,338450,71630,42520.2,592200
180130,82249.2,930650,107130,34596.1,338450,73000,47653.1,592200
180240,62557.9,930650,105810,20699.4,338450,74430,41858.5,592200
180370,62881.3,930650,104510,20344.3,338450,75860,42537,592200
180410,68482.8,930650,103200,22950,338450,77210,45532.8,592200
179080,68441.2,930650,100530,22190,338450,78550,46251.2,592200
177660,82861.6,930650,97860,29820,338450,79800,53041.6,592200
176290,74042.8,930650,95170,21694.5,338450,81120,52348.3,592200
174900,81377.6,930650,92500,23243.6,338450,82400,58134,592200
170190,79096.5,930650,89040,21186.5,338450,81150,57910,592200
165460,78830.2,930650,85590,20610,338450,79870,58220.2,592200
160820,77622.3,930650,82120,18941.7,338450,78700,58680.6,592200
156090,70642.7,930650,78670,16609.5,338450,77420,54033.2,592200
150910,69493.5,930650,74910,16553.1,338450,76000,52940.4,592200
145780,69703.3,930650,71180,16679.7,338450,74600,53023.6,592200
140510,70337.3,930650,67400,16530.3,338450,73110,53807,592200
135390,68501.4,930650,63660,14762.2,338450,71730,53739.2,592200
131090,62247.2,930650,61060,10755.7,338450,70030,51491.5,592200
126770,63763.9,930650,58430,13408.4,338450,68340,50355.5,592200
122470,62808.6,930650,55820,13213.4,338450,66650,49595.2,592200
118150,57833.7,930650,53190,11601.3,338450,64960,46232.4,592200
112630,58307.6,930650,50030,11901.2,338450,62600,46406.4,592200
107090,53400,930650,46870,10820.6,338450,60220,42579.4,592200
101570,51234.3,930650,43730,8899.8,338450,57840,42334.5,592200
95980,51431.4,930650,40550,8413.7,338450,55430,43017.7,592200
89820,52777.9,930650,36970,8884.7,338450,52850,43893.2,592200
83650,52053.5,930650,33350,9233.8,338450,50300,42819.7,592200
77490,54164.8,930650,29760,9345.7,338450,47730,44819.1,592200
71220,54243.8,930650,26170,9373.1,338450,45050,44870.7,592200
64450,54911.1,930650,22210,9104.4,338450,42240,45806.7,592200
57660,51882.4,930650,18260,7104.9,338450,39400,44777.5,592200
50870,50732.3,930650,14310,7523.7,338450,36560,43208.6,592200
44150,49324.6,930650,10390,6237.2,338450,33760,43087.4,592200
40230,45902.1,930650,9220,3917.2,338450,31010,41984.9,592200
36390,45961.6,930650,8060,3796.1,338450,28330,42165.5,592200
32560,42524.6,930650,6920,2873.8,338450,25640,39650.8,592200
28710,39792,930650,5760,2310,338450,22950,37482,592200
25680,37771.4,930650,5100,2319.9,338450,20580,35451.5,592200
22680,36473,930650,4440,2085.1,338450,18240,34387.9,592200
19580,36594.4,930650,3770,2236.3,338450,15810,34358.1,592200
16630,36067.9,930650,3120,2244,338450,13510,33823.9,592200
14040,35852.8,930650,2840,2369,338450,11200,33483.8,592200
11480,35342.8,930650,2540,2381.5,338450,8940,32961.3,592200
8950,35461.1,930650,2250,2479.7,338450,6700,32981.4,592200
6360,35500.8,930650,1980,2531.5,338450,4380,32969.3,592200
7170,35052.7,930650,2740,2594,338450,4430,32458.7,592200
8020,34810.6,930650,3550,2594,338450,4470,32216.6,592200
8880,34926.3,930650,4330,2631.5,338450,4550,32294.8,592200
9660,34280.3,930650,5130,2631.5,338450,4530,31648.8,592200
10700,34210,930650,6030,2694,338450,4670,31516,592200
11850,33767.2,930650,6950,2656.5,338450,4900,31110.7,592200
12880,33620.4,930650,7860,2631.5,338450,5020,30988.9,592200
13970,33849.8,930650,8750,2731.5,338450,5220,31118.3,592200
14900,33466.8,930650,9620,2722.6,338450,5280,30744.2,592200
15830,33716.9,930650,10500,2975.4,338450,5330,30741.5,592200
16700,34719.7,930650,11380,3604.9,338450,5320,31114.8,592200
17670,35005.1,930650,12270,3951.4,338450,5400,31053.7,592200
22590,36364.9,930650,14990,4405.1,338450,7600,31959.8,592200
27700,38557.2,930650,17740,5415.4,338450,9960,33141.8,592200
32710,40281.3,930650,20480,5838.2,338450,12230,34443.1,592200
37700,42233.3,930650,23220,6274.6,338450,14480,35958.7,592200
42820,46259.7,930650,26030,6993.8,338450,16790,39265.9,592200
48000,49211.4,930650,28850,7586.5,338450,19150,41624.9,592200
53140,52005.1,930650,31640,8450.6,338450,21500,43554.5,592200
58290,52058.2,930650,34450,9092.1,338450,23840,42966.1,592200
63780,41168.6,930650,37500,9072.1,338450,26280,32096.5,592200
69280,35368.3,930650,40520,8804.9,338450,28760,26563.4,592200
74780,39355.1,930650,43590,9550.5,338450,31190,29804.6,592200
80310,43189.2,930650,46620,10302,338450,33690,32887.2,592200
88910,44820.5,930650,50490,11555.7,338450,38420,33264.8,592200
97580,46731.7,930650,54330,12339.1,338450,43250,34392.6,592200
106220,48581.4,930650,58190,13951.8,338450,48030,34629.6,592200
114900,54907,930650,62070,16295,338450,52830,38612,592200
124130,62539.2,930650,66250,18483.3,338450,57880,44055.9,592200
133350,66660.9,930650,70400,18659.6,338450,62950,48001.3,592200
142590,78215.9,930650,74600,22413.4,338450,67990,55802.5,592200
151790,80509.9,930650,78770,22592.6,338450,73020,57917.3,592200
160970,82495.8,930650,82740,23534,338450,78230,58961.8,592200
170210,87119.1,930650,86700,24492.5,338450,83510,62626.6,592200
179370,90975.8,930650,90650,24885.2,338450,88720,66090.6,592200
188590,93027.6,930650,94640,23311.8,338450,93950,69715.8,592200
199790,100541.1,930650,99990,26057.7,338450,99800,74483.4,592200
210980,102913,930650,105350,29998.5,338450,105630,72914.5,592200
222100,102963.1,930650,110710,29859.5,338450,111390,73103.6,592200
233300,104634.8,930650,116070,32668.7,338450,117230,71966.1,592200
245400,103159.1,930650,121880,35382.7,338450,123520,67776.4,592200
257420,100124.7,930650,127680,34333.8,338450,129740,65790.9,592200
269440,108333.9,930650,133500,35644.1,338450,135940,72689.8,592200
348360,141317,930650,174860,49656.1,338450,173500,91660.9,592200
363890,163489.1,930650,181440,58635.2,338450,182450,104853.9,592200
379490,166647.4,930650,188060,60323.7,338450,191430,106323.7,592200
394990,169997.5,930650,194660,63908.1,338450,200330,106089.4,592200
410510,170819.9,930650,201270,63618.2,338450,209240,107201.7,592200
418340,168510.2,930650,203320,64282.6,338450,215020,104227.6,592200
426170,173078.6,930650,205390,70086.6,338450,220780,102992,592200
434020,173871.3,930650,207470,69878.3,338450,226550,103993,592200
441820,190733.5,930650,209500,79398.1,338450,232320,111335.4,592200
447480,207820.9,930650,210850,85688.2,338450,236630,122132.7,592200
453200,218185.2,930650,212190,86305.1,338450,241010,131880.1,592200
458890,221293.5,930650,213530,86336.4,338450,245360,134957.1,592200
464500,205557.5,930650,214870,70833.9,338450,249630,134723.6,592200
470740,230949.9,930650,216370,90266.8,338450,254370,140683.1,592200
476990,238559.6,930650,217900,90705.8,338450,259090,147853.8,592200
483120,262874.2,930650,219400,99425.8,338450,263720,163448.4,592200
489380,285532.7,930650,220930,104713.4,338450,268450,180819.3,592200
496050,295888.1,930650,222890,104602.9,338450,273160,191285.2,592200
502730,293829.8,930650,224850,100214.1,338450,277880,193615.7,592200
509480,312016.1,930650,226830,109399.2,338450,282650,202616.9,592200
516140,330580,930650,228790,112522.8,338450,287350,218057.2,592200
522820,356142.2,930650,230860,117312.4,338450,291960,238829.8,592200
529450,361888,930650,232950,116522.2,338450,296500,245365.8,592200
536110,365898.7,930650,235050,116396,338450,301060,249502.7,592200
542770,364799.3,930650,237150,116418.7,338450,305620,248380.6,592200
548750,379462.8,930650,238640,125632.2,338450,310110,253830.6,592200
554740,400925.7,930650,240150,132951.1,338450,314590,267974.6,592200
560730,393443.2,930650,241660,134851.5,338450,319070,258591.7,592200
566700,381228.4,930650,243170,127954.9,338450,323530,253273.5,592200
574860,391897,930650,246000,125960.9,338450,328860,265936.1,592200
583060,386763.6,930650,248850,117356.7,338450,334210,269406.9,592200
591190,363397.7,930650,251660,107509.5,338450,339530,255888.2,592200
599430,365203.1,930650,254510,106318.7,338450,344920,258884.4,592200
606660,376707.7,930650,256700,110696.8,338450,349960,266010.9,592200
613870,392253,930650,258850,113871.9,338450,355020,278381.1,592200
621100,418910.9,930650,261030,121646.8,338450,360070,297264.1,592200
628310,436957.2,930650,263200,121490.9,338450,365110,315466.3,592200
636100,431320.9,930650,265860,120197.3,338450,370240,311123.6,592200
643930,419643.8,930650,268500,121589.2,338450,375430,298054.6,592200
651720,393928.9,930650,271180,112729,338450,380540,281199.9,592200
659550,400307.9,930650,273850,114669,338450,385700,285638.9,592200
665710,406756.2,930650,275490,117409,338450,390220,289347.2,592200
671930,388813.7,930650,277160,109233.4,338450,394770,279580.3,592200
678080,396996.5,930650,278820,115543.4,338450,399260,281453.1,592200
684340,417020.7,930650,280450,123194.3,338450,403890,293826.4,592200
691320,418133,930650,282280,122924.3,338450,409040,295208.7,592200
698230,413049.8,930650,284100,120697.2,338450,414130,292352.6,592200
705250,396733.9,930650,285900,115030.7,338450,419350,281703.2,592200
712280,392784.1,930650,287730,118218.8,338450,424550,274565.3,592200
719230,415833.7,930650,289520,122948.8,338450,429710,292884.9,592200
726220,406160.1,930650,291320,113338,338450,434900,292822.1,592200
733210,388284.1,930650,293120,106136.2,338450,440090,282147.9,592200
740180,389536.8,930650,294900,103505.5,338450,445280,286031.3,592200
741620,376995.6,930650,294960,104981,338450,446660,272014.6,592200
743030,371400.6,930650,295000,99554.7,338450,448030,271845.9,592200
744490,347001.4,930650,295030,89332.6,338450,449460,257668.8,592200
745940,337899.2,930650,295110,88715.7,338450,450830,249183.5,592200
747580,338042.9,930650,295160,94156.9,338450,452420,243886,592200
749050,347920.9,930650,295200,98246.3,338450,453850,249674.6,592200
750660,337590.8,930650,295260,94524.8,338450,455400,243066,592200
752250,340290.8,930650,295320,95106.9,338450,456930,245183.9,592200
753270,343140.8,930650,295210,93425.9,338450,458060,249714.9,592200
754390,346181,930650,295090,94011.7,338450,459300,252169.3,592200
755440,347031,930650,294950,94890.1,338450,460490,252140.9,592200
756520,356079.8,930650,294840,101072.8,338450,461680,255007,592200
752960,378569.9,930650,293620,113805.5,338450,459340,264764.4,592200
749520,387710.2,930650,292410,120011.4,338450,457110,267698.8,592200
745980,405990.3,930650,291190,124100,338450,454790,281890.3,592200
742440,403884.7,930650,289970,118602.4,338450,452470,285282.3,592200
738660,404291.1,930650,288660,114597.9,338450,450000,289693.2,592200
734810,432849.2,930650,287370,138694.5,338450,447440,294154.7,592200
731060,414864.6,930650,286070,120811.5,338450,444990,294053.1,592200
727280,440803.4,930650,284780,132021.8,338450,442500,308781.6,592200
723530,441728.6,930650,283480,127429.5,338450,440050,314299.1,592200
719780,422482.7,930650,282190,123771.2,338450,437590,298711.5,592200
716070,418765.9,930650,280910,128009.7,338450,435160,290756.2,592200
712350,426738,930650,279640,133622.2,338450,432710,293115.8,592200
707400,427313.6,930650,278490,133960.2,338450,428910,293353.4,592200
702590,430031,930650,277340,133697.6,338450,425250,296333.4,592200
697730,419232.8,930650,276180,128390.9,338450,421550,290841.9,592200
692880,455980,930650,275040,124444.3,338450,417840,331535.7,592200
687350,446680.5,930650,273700,112989.6,338450,413650,333690.9,592200
681950,446411.4,930650,272390,117242.8,338450,409560,329168.6,592200
676440,432104.6,930650,271060,115717.2,338450,405380,316387.4,592200
671050,429196.7,930650,269750,121427.8,338450,401300,307768.9,592200
665620,388114.8,930650,268490,112842.6,338450,397130,275272.2,592200
660250,400970.1,930650,267280,117666.5,338450,392970,283303.6,592200
654920,414815.3,930650,266020,119980.4,338450,388900,294834.9,592200
649520,410941.2,930650,264790,108716.2,338450,384730,302225,592200
648880,412046.5,930650,264770,113118.2,338450,384110,298928.3,592200
648270,413609.6,930650,264740,120393.4,338450,383530,293216.2,592200
647660,401069.2,930650,264730,115235,338450,382930,285834.2,592200
647020,405110.4,930650,264690,113559,338450,382330,291551.4,592200
646750,417522,930650,264770,112471.1,338450,381980,305050.9,592200
646560,416487.5,930650,264870,114066,338450,381690,302421.5,592200
646370,425963.3,930650,264940,127257.4,338450,381430,298705.9,592200
689480,416997.6,930650,271450,123100.4,338450,418030,293897.2,592200
690010,398396,930650,271490,109510.3,338450,418520,288885.7,592200
690590,394282.8,930650,271550,107035.9,338450,419040,287246.9,592200
691120,403346.7,930650,271610,103655,338450,419510,299691.7,592200
691660,400127.8,930650,271680,102260.1,338450,419980,297867.7,592200
693630,405958.2,930650,272080,104170.3,338450,421550,301787.9,592200
695600,393736.3,930650,272490,99591.7,338450,423110,294144.6,592200
697570,389501.3,930650,272900,95501,338450,424670,294000.3,592200
699600,391798.5,930650,273300,97510.5,338450,426300,294288,592200
702550,392474.6,930650,274200,100306.5,338450,428350,292168.1,592200
705560,364904.6,930650,275110,93326.7,338450,430450,271577.9,592200
708540,370607.6,930650,276010,89319,338450,432530,281288.6,592200
711560,376918.9,930650,276940,91961.6,338450,434620,284957.3,592200
713060,369881.7,930650,277360,95812.1,338450,435700,274069.6,592200
714620,370663.4,930650,277800,92726.8,338450,436820,277936.6,592200
716140,371143.3,930650,278230,93704,338450,437910,277439.3,592200
717720,362665.9,930650,278670,93264.5,338450,439050,269401.4,592200
714750,384837.3,930650,277820,94633.8,338450,436930,290203.5,592200
711860,389712.8,930650,276990,98155.1,338450,434870,291557.7,592200
708830,368490.2,930650,276120,96454.5,338450,432710,272035.7,592200
705940,374933,930650,275290,103515.7,338450,430650,271417.3,592200
703420,380903.4,930650,274460,107226,338450,428960,273677.4,592200
700900,382200.6,930650,273600,102304.2,338450,427300,279896.4,592200
698390,350093,930650,272750,99177.2,338450,425640,250915.8,592200
695860,335669.1,930650,271920,97819.7,338450,423940,237849.4,592200
693830,309440.4,930650,271450,77481.7,338450,422380,231958.7,592200
691750,317773.5,930650,270990,90492.5,338450,420760,227281,592200
689690,307443.3,930650,270500,86849.4,338450,419190,220593.9,592200
687600,319681.5,930650,270020,91745.2,338450,417580,227936.3,592200
684440,308235.4,930650,269740,76995.6,338450,414700,231239.8,592200
681220,313083,930650,269410,84162.7,338450,411810,228920.3,592200
677970,308673.4,930650,269090,74467.9,338450,408880,234205.5,592200
674740,329476,930650,268780,94139.5,338450,405960,235336.5,592200
671430,306264.8,930650,268220,76987.7,338450,403210,229277.1,592200
668110,287355.8,930650,267690,72569.7,338450,400420,214786.1,592200
664680,304648.9,930650,267130,83022.4,338450,397550,221626.5,592200
661380,249020.1,930650,266590,52323.9,338450,394790,196696.2,592200
657800,256530.3,930650,265970,54920.6,338450,391830,201609.7,592200
654240,257711,930650,265370,59937.8,338450,388870,197773.2,592200
650580,269486.4,930650,264740,69077,338450,385840,200409.4,592200
646920,275512.5,930650,264120,69048.6,338450,382800,206463.9,592200
644630,254880.6,930650,263380,68089,338450,381250,186791.6,592200
642280,213771.6,930650,262620,59898.6,338450,379660,153873,592200
639960,264772,930650,261870,64020.9,338450,378090,200751.1,592200
637620,271100.1,930650,261100,65897.3,338450,376520,205202.8,592200
635100,290082.4,930650,260410,75612.7,338450,374690,214469.7,592200
632590,307319.4,930650,259710,80222.3,338450,372880,227097.1,592200
630010,324190.8,930650,259000,83206.5,338450,371010,240984.3,592200
627460,310068.8,930650,258300,72863.8,338450,369160,237205,592200
624940,320339.6,930650,257420,71965.2,338450,367520,248374.4,592200
622520,323318.4,930650,256590,75672.7,338450,365930,247645.7,592200
619980,293744.1,930650,255720,76326.6,338450,364260,217417.5,592200
617490,304799,930650,254830,87619.1,338450,362660,217179.9,592200
610280,304174,930650,251770,83750.3,338450,358510,220423.7,592200
603060,302036.8,930650,248690,82381.6,338450,354370,219655.2,592200
595910,293984.2,930650,245630,81034.4,338450,350280,212949.8,592200
588700,265515.2,930650,242560,74842.9,338450,346140,190672.3,592200
579190,257332.1,930650,239260,67849,338450,339930,189483.1,592200
569690,256048.5,930650,235950,67393.8,338450,333740,188654.7,592200
560130,232966.1,930650,232620,60715.9,338450,327510,172250.2,592200
550630,229411.5,930650,229300,59918.9,338450,321330,169492.6,592200
543580,224588.3,930650,226600,56653.5,338450,316980,167934.8,592200
536570,209043.4,930650,223890,53305.9,338450,312680,155737.5,592200
529470,208693.9,930650,221160,57804.6,338450,308310,150889.3,592200
522490,244256.5,930650,218440,65614.9,338450,304050,178641.6,592200
514070,246306.2,930650,215370,60685.9,338450,298700,185620.3,592200
505660,274556.6,930650,212320,62042.9,338450,293340,212513.7,592200
497200,299219.3,930650,209230,68148.2,338450,287970,231071.1,592200
488800,291858.8,930650,206190,71627.9,338450,282610,220230.9,592200
479680,280512.8,930650,203580,59509.1,338450,276100,221003.7,592200
470600,267598.1,930650,201000,54091.8,338450,269600,213506.3,592200
461540,238427.2,930650,198430,56984.3,338450,263110,181442.9,592200
452420,236078.2,930650,195830,59387,338450,256590,176691.2,592200
443880,206621.2,930650,193190,49789.6,338450,250690,156831.6,592200
435300,176652.1,930650,190530,43752.7,338450,244770,132899.4,592200
426750,157312.1,930650,187920,37276,338450,238830,120036.1,592200
418190,126140.1,930650,185280,36150.5,338450,232910,89989.6,592200
410060,146737,930650,182970,53483.6,338450,227090,93253.4,592200
401930,139178.4,930650,180670,47887.4,338450,221260,91291,592200
393820,155253.6,930650,178390,49684.7,338450,215430,105568.9,592200
385730,142168.7,930650,176110,45893.4,338450,209620,96275.3,592200
376360,146026.9,930650,172800,36343.4,338450,203560,109683.5,592200
367100,129659.5,930650,169540,30932,338450,197560,98727.5,592200
357690,126009.9,930650,166220,28359.8,338450,191470,97650.1,592200
348400,141942.5,930650,162970,27007.4,338450,185430,114935.1,592200
339180,133486.2,930650,160440,24269.3,338450,178740,109216.9,592200
330020,122801.6,930650,157960,30788.4,338450,172060,92013.2,592200
320830,138415.2,930650,155460,37733.3,338450,165370,100681.9,592200
311670,138080.4,930650,152950,45507.9,338450,158720,92572.5,592200
304450,134111.6,930650,151010,38134.9,338450,153440,95976.7,592200
297200,150737.9,930650,149050,48098.3,338450,148150,102639.6,592200
289930,159505.3,930650,147100,59566.9,338450,142830,99938.4,592200
282720,143780.6,930650,145130,65932.4,338450,137590,77848.2,592200
277370,157531.6,930650,144880,75549.8,338450,132490,81981.8,592200
271980,177710.7,930650,144610,85205.7,338450,127370,92505,592200
266550,161889.1,930650,144330,76491.1,338450,122220,85398,592200
266760,162373.8,930650,151020,84424.8,338450,115740,77949,592200
264990,144624.8,930650,151130,67057.3,338450,113860,77567.5,592200
263100,177005,930650,151190,88159.5,338450,111910,88845.5,592200
261270,206233.1,930650,151240,103637.1,338450,110030,102596,592200
259440,200918.6,930650,151340,102925.9,338450,108100,97992.7,592200
258140,185362.7,930650,150150,98126.7,338450,107990,87236,592200
256740,186506.5,930650,148960,96744.6,338450,107780,89761.9,592200
255390,206748.4,930650,147780,109619,338450,107610,97129.4,592200
254010,161500.1,930650,146590,74140.4,338450,107420,87359.7,592200
251470,114953.2,930650,144320,43514.6,338450,107150,71438.6,592200
249030,142205.7,930650,142080,59224.8,338450,106950,82980.9,592200
246590,232602,930650,139820,109584,338450,106770,123018,592200
244150,172202.5,930650,137590,74034.9,338450,106560,98167.6,592200
243440,168096.4,930650,136530,67735.8,338450,106910,100360.6,592200
242810,196142.8,930650,135510,100601.8,338450,107300,95541,592200
242130,203363.2,930650,134490,109210.4,338450,107640,94152.8,592200
241520,155479.2,930650,133440,74678.6,338450,108080,80800.6,592200
239870,142086.5,930650,133220,52939.4,338450,106650,89147.1,592200
238280,180792,930650,132990,81469.7,338450,105290,99322.3,592200
236600,187993.5,930650,132720,90510.4,338450,103880,97483.1,592200
234950,165970.3,930650,132490,80568.8,338450,102460,85401.5,592200
233030,168047.6,930650,131990,87799.8,338450,101040,80247.8,592200
231080,231649.4,930650,131490,117282.6,338450,99590,114366.8,592200
229140,232780.4,930650,130980,117246.3,338450,98160,115534.1,592200
227170,212079.1,930650,130510,116263.8,338450,96660,95815.3,592200
224950,217612.1,930650,130080,120168.6,338450,94870,97443.5,592200
222720,209451.6,930650,129670,112782.9,338450,93050,96668.7,592200
220450,227698.3,930650,129250,124307.7,338450,91200,103390.6,592200
218200,240166.5,930650,128830,126847.2,338450,89370,113319.3,592200
213450,261937.1,930650,126120,126301.7,338450,87330,135635.4,592200
208760,249693.4,930650,123400,120869.3,338450,85360,128824.1,592200
203990,239175.3,930650,120690,115846.8,338450,83300,123328.5,592200
199290,220670.6,930650,117970,112346.9,338450,81320,108323.7,592200
194290,218631.9,930650,115180,109317.4,338450,79110,109314.5,592200
189310,204344.5,930650,112400,97011.5,338450,76910,107333,592200
184300,188443,930650,109620,89712.4,338450,74680,98730.6,592200
179330,201036.1,930650,106850,107848.5,338450,72480,93187.6,592200
173980,178791,930650,103450,78187.7,338450,70530,100603.3,592200
168620,164587.8,930650,100050,66736.9,338450,68570,97850.9,592200
163290,164097.3,930650,96680,72004,338450,66610,92093.3,592200
157850,143916.3,930650,93270,60316.7,338450,64580,83599.6,592200
148940,125512.6,930650,86550,47332.2,338450,62390,78180.4,592200
139890,120286.1,930650,79760,43884.1,338450,60130,76402,592200
130930,114980.3,930650,73040,41721.9,338450,57890,73258.4,592200
121890,100499.2,930650,66260,32982,338450,55630,67517.2,592200
114310,89117.4,930650,60890,26596.2,338450,53420,62521.2,592200
106600,88588.2,930650,55480,26708.3,338450,51120,61879.9,592200
98940,86807.3,930650,50110,25384,338450,48830,61423.3,592200
91230,86898.1,930650,44670,24545.6,338450,46560,62352.5,592200
83750,82535.9,930650,39460,22943.7,338450,44290,59592.2,592200
76230,75545.9,930650,34250,20102.5,338450,41980,55443.4,592200
68690,69885.8,930650,29030,16840.2,338450,39660,53045.6,592200
61140,64230.8,930650,23800,12439.2,338450,37340,51791.6,592200
59100,61781.4,930650,23160,11232.4,338450,35940,50549,592200
57100,59923.3,930650,22500,10552.5,338450,34600,49370.8,592200
55110,54621,930650,21860,7305.7,338450,33250,47315.3,592200
53030,49060.7,930650,21210,5062.3,338450,31820,43998.4,592200
51630,49509,930650,21000,4459,338450,30630,45050,592200
50180,54418.7,930650,20830,5025,338450,29350,49393.7,592200
48770,47174.7,930650,20630,4238.9,338450,28140,42935.8,592200
47300,48905.7,930650,20430,4267.6,338450,26870,44638.1,592200
45650,48375.3,930650,20050,4161.2,338450,25600,44214.1,592200
43970,54175.9,930650,19670,4584.5,338450,24300,49591.4,592200
42290,53383.7,930650,19290,4742.7,338450,23000,48641,592200
40620,48574.8,930650,18920,4636.3,338450,21700,43938.5,592200
40910,49003.6,930650,18960,4762.5,338450,21950,44241.1,592200
41280,46411,930650,19040,4276.1,338450,22240,42134.9,592200
41600,44001.1,930650,19100,3958.2,338450,22500,40042.9,592200
41940,43655.1,930650,19190,4000.5,338450,22750,39654.6,592200
41730,49782.4,930650,18590,6175.8,338450,23140,43606.6,592200
41420,47255.1,930650,17990,4850.7,338450,23430,42404.4,592200
41160,45607.2,930650,17410,4391.9,338450,23750,41215.3,592200
40860,44096.4,930650,16790,4054.6,338450,24070,40041.8,592200
40620,45177.4,930650,16300,4029.6,338450,24320,41147.8,592200
40380,47909.9,930650,15790,5762.6,338450,24590,42147.3,592200
40120,59046,930650,15300,12887.6,338450,24820,46158.4,592200
39880,72733.5,930650,14820,22494.2,338450,25060,50239.3,592200
40800,64523.6,930650,14620,15345.4,338450,26180,49178.2,592200
41620,54576.4,930650,14410,7702.2,338450,27210,46874.2,592200
42520,64638.3,930650,14220,12518.4,338450,28300,52119.9,592200
43420,65782.6,930650,14030,14856.2,338450,29390,50926.4,592200
44770,68077.3,930650,14060,16404.8,338450,30710,51672.5,592200
45990,71068.6,930650,14100,17204.4,338450,31890,53864.2,592200
47260,73783.9,930650,14130,16091.3,338450,33130,57692.6,592200
48610,79632.9,930650,14170,16595.9,338450,34440,63037,592200
50210,81514.8,930650,14010,17844.6,338450,36200,63670.2,592200
51780,76576.5,930650,13830,13573.7,338450,37950,63002.8,592200
53390,74482.7,930650,13670,11732.3,338450,39720,62750.4,592200
54930,63168.1,930650,13490,12011.6,338450,41440,51156.5,592200
57910,60945.8,930650,13850,14389.5,338450,44060,46556.3,592200
60900,77464.1,930650,14190,22513.8,338450,46710,54950.3,592200
63840,104074.2,930650,14520,22393.8,338450,49320,81680.4,592200
66860,101355.5,930650,14890,21001.2,338450,51970,80354.3,592200
70470,93152.5,930650,15830,23053.4,338450,54640,70099.1,592200
74060,92393.9,930650,16770,22974.9,338450,57290,69419,592200
77730,128871,930650,17740,28952.5,338450,59990,99918.5,592200
69010,155944.9,930650,11440,38878,338450,57570,117066.9,592200
72910,145811,930650,12100,45173.1,338450,60810,100637.9,592200
76800,175682.2,930650,12770,50086.1,338450,64030,125596.1,592200
80800,175746.1,930650,13460,57204,338450,67340,118542.1,592200
84730,168861.2,930650,14120,59891.3,338450,70610,108969.9,592200
88500,172432.8,930650,15170,61796.9,338450,73330,110635.9,592200
92150,178241.5,930650,16180,64324.6,338450,75970,113916.9,592200
95900,183355.8,930650,17210,70204,338450,78690,113151.8,592200
99600,194015.1,930650,18230,76955.5,338450,81370,117059.6,592200
102680,189774.5,930650,19070,76545.2,338450,83610,113229.3,592200
105740,179671.3,930650,19930,72750.5,338450,85810,106920.8,592200
108790,167578.5,930650,20760,66221.5,338450,88030,101357,592200
111910,165358.8,930650,21600,67056.5,338450,90310,98302.3,592200
115260,169737.6,930650,22570,68757.9,338450,92690,100979.7,592200
118590,174131.9,930650,23540,69716.6,338450,95050,104415.3,592200
121960,176468,930650,24500,71008.2,338450,97460,105459.8,592200
125300,182847.6,930650,25430,75538.4,338450,99870,107309.2,592200
126620,193016.6,930650,25920,80489.5,338450,100700,112527.1,592200
127870,204076,930650,26410,84272.3,338450,101460,119803.7,592200
129280,208549.5,930650,26910,87999.2,338450,102370,120550.3,592200
130530,219260.1,930650,27350,94388.2,338450,103180,124871.9,592200
132080,225513,930650,27890,93652.2,338450,104190,131860.8,592200
133670,235753.2,930650,28430,93737.5,338450,105240,142015.7,592200
135210,241356.5,930650,28980,93366.4,338450,106230,147990.1,592200
136780,232803.3,930650,29510,86855.4,338450,107270,145947.9,592200
138170,226273,930650,29980,78994.2,338450,108190,147278.8,592200
139670,226455.6,930650,30470,77932.7,338450,109200,148522.9,592200
141090,219806.2,930650,30930,72760.8,338450,110160,147045.4,592200
142520,223091.9,930650,31390,75043.8,338450,111130,148048.1,592200
143290,226844.2,930650,31760,77789.4,338450,111530,149054.8,592200
144090,217560,930650,32090,73296.3,338450,112000,144263.7,592200
144830,222308.7,930650,32450,82182.5,338450,112380,140126.2,592200
145660,221613.2,930650,32820,81631.1,338450,112840,139982.1,592200
146040,229188.3,930650,33160,85155.7,338450,112880,144032.6,592200
146450,226983.2,930650,33490,82170.8,338450,112960,144812.4,592200
146820,224813.3,930650,33830,77644.7,338450,112990,147168.6,592200
147170,228360.8,930650,34180,77305.3,338450,112990,151055.5,592200
147470,234354.1,930650,34550,80004.2,338450,112920,154349.9,592200
147630,235656.7,930650,34880,79349,338450,112750,156307.7,592200
147820,243268.9,930650,35220,76785.8,338450,112600,166483.1,592200
148080,232227.6,930650,35600,75423.3,338450,112480,156804.3,592200
141700,220763.6,930650,34310,73709.3,338450,107390,147054.3,592200
135270,206885.6,930650,33000,71762,338450,102270,135123.6,592200
128880,191056.4,930650,31720,67155.2,338450,97160,123901.2,592200
122430,184916.1,930650,30410,65400,338450,92020,119516.1,592200
116040,173921.9,930650,29160,65748.2,338450,86880,108173.7,592200
109600,167558.5,930650,27880,64953.7,338450,81720,102604.8,592200
103300,164284.8,930650,26660,65792.1,338450,76640,98492.7,592200
96830,158210.2,930650,25400,65868.8,338450,71430,92341.4,592200
90690,166728.9,930650,24170,73481.3,338450,66520,93247.6,592200
84530,162338.7,930650,22920,71664.6,338450,61610,90674.1,592200
78440,164161.9,930650,21700,74459.9,338450,56740,89702,592200
72260,161531.2,930650,20460,73093.2,338450,51800,88438,592200
70810,160286.9,930650,20100,74527,338450,50710,85759.9,592200
69390,156798.5,930650,19760,72994.8,338450,49630,83803.7,592200
67930,150907.1,930650,19390,68996.1,338450,48540,81911,592200
66500,145091.5,930650,19030,64799.1,338450,47470,80292.4,592200
65280,145753.8,930650,18760,65864.4,338450,46520,79889.4,592200
64010,145428.4,930650,18470,65964.3,338450,45540,79464.1,592200
62690,132614.2,930650,18140,57593.9,338450,44550,75020.3,592200
61450,126985.6,930650,17860,54388.9,338450,43590,72596.7,592200
60430,120545.4,930650,17810,50180.9,338450,42620,70364.5,592200
59440,114630.6,930650,17750,46558.2,338450,41690,68072.4,592200
58440,124865.9,930650,17710,53558.1,338450,40730,71307.8,592200
57380,140825.3,930650,17660,64939.7,338450,39720,75885.6,592200
61040,162518.2,930650,18410,79766.2,338450,42630,82752,592200
64690,167026.4,930650,19160,81087.8,338450,45530,85938.6,592200
68350,167874.4,930650,19910,77934,338450,48440,89940.4,592200
72000,169567.5,930650,20660,76851.9,338450,51340,92715.6,592200
75270,168770.3,930650,21170,73325.9,338450,54100,95444.4,592200
78560,168573.1,930650,21690,72052.6,338450,56870,96520.5,592200
81890,169414.1,930650,22250,72744.7,338450,59640,96669.4,592200
85200,157231.6,930650,22760,71378.1,338450,62440,85853.5,592200
88480,176509.3,930650,23370,70968.5,338450,65110,105540.8,592200
91680,193582.5,930650,24000,70808.4,338450,67680,122774.1,592200
94990,182351.9,930650,24590,69103.4,338450,70400,113248.5,592200
98240,165640.7,930650,25200,68173.9,338450,73040,97466.8,592200
101150,163629.2,930650,25940,66141.2,338450,75210,97488,592200
103970,177294.6,930650,26680,67737.7,338450,77290,109556.9,592200
106870,190086.9,930650,27400,70839.7,338450,79470,119247.2,592200
109790,186735.3,930650,28160,67375.1,338450,81630,119360.2,592200
112770,177971.2,930650,28900,61813.5,338450,83870,116157.7,592200
115780,169023.5,930650,29640,56754.4,338450,86140,112269.1,592200
118710,180287.9,930650,30380,61957.7,338450,88330,118330.2,592200
121690,184854.6,930650,31110,66028.4,338450,90580,118826.2,592200
125090,188925.8,930650,31980,68816.9,338450,93110,120108.9,592200
128530,199217,930650,32870,73782.1,338450,95660,125434.9,592200
131960,201576.3,930650,33780,74012.5,338450,98180,127563.8,592200
135310,202583.2,930650,34640,71699.9,338450,100670,130883.3,592200
138780,208640,930650,35030,70632.4,338450,103750,138007.6,592200
142230,216572.2,930650,35420,71737,338450,106810,144835.2,592200
145660,223508.1,930650,35810,73919.3,338450,109850,149588.8,592200
149020,229756.6,930650,36200,75771.6,338450,112820,153985,592200
152410,235453.1,930650,36600,78551.1,338450,115810,156902,592200
155880,241835,930650,36970,80303.7,338450,118910,161531.3,592200
159290,261385.3,930650,37400,87600.5,338450,121890,173784.8,592200
121320,274350.9,930650,25060,92570.8,338450,96260,181780.1,592200
124720,266806.4,930650,25420,84725.2,338450,99300,182081.2,592200
128150,272083,930650,25790,83019.1,338450,102360,189063.9,592200
131640,286720.9,930650,26170,84800.5,338450,105470,201920.4,592200
135080,275221.3,930650,26520,77907.8,338450,108560,197313.5,592200
136210,280135.8,930650,26550,79031.1,338450,109660,201104.7,592200
137350,279226.3,930650,26560,75319.5,338450,110790,203906.8,592200
138600,256068,930650,26620,66751.2,338450,111980,189316.8,592200
139810,240260.8,930650,26640,59430,338450,113170,180830.8,592200
141150,237022.4,930650,26690,55453.1,338450,114460,181569.3,592200
142580,228759.4,930650,26740,53041.1,338450,115840,175718.3,592200
143980,210280,930650,26810,53689.7,338450,117170,156590.3,592200
145370,227873.3,930650,26830,54028,338450,118540,173845.3,592200
146710,245275.9,930650,26940,53349.8,338450,119770,191926.1,592200
147990,252176.3,930650,27030,56531.3,338450,120960,195645,592200
149290,241544,930650,27120,52095.5,338450,122170,189448.5,592200
150620,236060.3,930650,27220,48432.1,338450,123400,187628.2,592200
152110,237067.4,930650,27730,49531.5,338450,124380,187535.9,592200
153650,253449.5,930650,28230,58109.4,338450,125420,195340.1,592200
155160,255995.3,930650,28750,64942.9,338450,126410,191052.4,592200
156690,272247.1,930650,29260,70952.1,338450,127430,201295,592200
158490,262324.6,930650,29790,73524.8,338450,128700,188799.8,592200
160250,269929.8,930650,30330,81026.7,338450,129920,188903.1,592200
161930,255958.2,930650,30850,76278.2,338450,131080,179680,592200
163770,251701.9,930650,31410,69716.1,338450,132360,181985.8,592200
165670,271715.6,930650,31750,74880.4,338450,133920,196835.2,592200
167570,267945.5,930650,32090,78830.8,338450,135480,189114.7,592200
169450,281521.6,930650,32450,79006.7,338450,137000,202514.9,592200
171350,288511,930650,32770,81661,338450,138580,206850,592200
173770,279546.8,930650,33650,79083.8,338450,140120,200463,592200
176080,248681.2,930650,34540,70614.8,338450,141540,178066.4,592200
178520,268561.6,930650,35420,76525.9,338450,143100,192035.7,592200
180910,283524.1,930650,36300,81945.5,338450,144610,201578.6,592200
183810,279753.9,930650,37190,77892.2,338450,146620,201861.7,592200
186650,281021.5,930650,38080,80684.4,338450,148570,200337.1,592200
189580,289746.6,930650,38970,76642.5,338450,150610,213104.1,592200
192510,306625.1,930650,39870,76530.4,338450,152640,230094.7,592200
195230,298685.2,930650,40900,77756.2,338450,154330,220929,592200
198090,319321.1,930650,41960,85363.3,338450,156130,233957.8,592200
200970,315700.6,930650,43000,89745.8,338450,157970,225954.8,592200
249810,288847.7,930650,90060,84250.1,338450,159750,204597.6,592200
244100,286539.8,930650,87530,85033.4,338450,156570,201506.4,592200
238270,265780.5,930650,84960,68909.6,338450,153310,196870.9,592200
232470,245016.2,930650,82450,63640.9,338450,150020,181375.3,592200
226790,232112.8,930650,79890,59508.4,338450,146900,172604.4,592200
219200,212330.2,930650,76840,57303.7,338450,142360,155026.5,592200
211650,192259.2,930650,73800,54043.9,338450,137850,138215.3,592200
204080,174939,930650,70720,50018.7,338450,133360,124920.3,592200
196450,167642.7,930650,67660,44946.5,338450,128790,122696.2,592200
188250,166110.3,930650,64640,38939.4,338450,123610,127170.9,592200
179920,164251,930650,61600,37689.9,338450,118320,126561.1,592200
171650,156128.6,930650,58570,37413.1,338450,113080,118715.5,592200
163410,156334.3,930650,55520,37078.3,338450,107890,119256,592200
163600,159567.9,930650,55810,40927.6,338450,107790,118640.3,592200
163740,162567.2,930650,56080,38299.8,338450,107660,124267.4,592200
163960,163872.3,930650,56390,37340,338450,107570,126532.3,592200
164140,165326.4,930650,56640,36515.2,338450,107500,128811.2,592200
165580,171885.8,930650,57160,39807,338450,108420,132078.8,592200
167100,186359.3,930650,57680,47807.8,338450,109420,138551.5,592200
168570,198226.3,930650,58170,50540.4,338450,110400,147685.9,592200
169990,208287,930650,58680,54299.5,338450,111310,153987.5,592200
170460,202572.9,930650,58440,50822.9,338450,112020,151750,592200
170800,205539.2,930650,58170,52002.7,338450,112630,153536.5,592200
171300,225405.6,930650,57920,59204.8,338450,113380,166200.8,592200
171610,241843.7,930650,57650,68336.4,338450,113960,173507.3,592200
177280,256231.5,930650,59880,69172.2,338450,117400,187059.3,592200
182940,254169.6,930650,62080,63880.5,338450,120860,190289.1,592200
188540,264635.5,930650,64270,69626.2,338450,124270,195009.3,592200
194250,283562.6,930650,66520,72467,338450,127730,211095.6,592200
199200,279310,930650,68160,69415.2,338450,131040,209894.8,592200
204180,253087,930650,69810,74103.2,338450,134370,178983.8,592200
209070,256964.7,930650,71440,82546.1,338450,137630,174418.6,592200
214050,283539.7,930650,73100,88645.1,338450,140950,194894.6,592200
217420,278128.9,930650,74020,84742.4,338450,143400,193386.5,592200
220780,277979.1,930650,74930,84286.9,338450,145850,193692.2,592200
224150,275525.9,930650,75870,81284.8,338450,148280,194241.1,592200
227560,263822.7,930650,76790,71746,338450,150770,192076.7,592200
227620,259773.4,930650,76730,76215.6,338450,150890,183557.8,592200
227680,278582.9,930650,76660,85268.8,338450,151020,193314.1,592200
227770,269212.3,930650,76610,82396.9,338450,151160,186815.4,592200
227890,265947.1,930650,76570,83023.2,338450,151320,182923.9,592200
227450,235643.1,930650,75530,71980,338450,151920,163663.1,592200
227070,209456.1,930650,74470,58896.6,338450,152600,150559.5,592200
226650,204960.1,930650,73450,55592,338450,153200,149368.1,592200
226270,195945.8,930650,72400,53955.6,338450,153870,141990.2,592200
228770,193498.9,930650,72820,56309.3,338450,155950,137189.6,592200
231330,203016.8,930650,73270,59125.7,338450,158060,143891.1,592200
233800,206646.7,930650,73670,62636.4,338450,160130,144010.3,592200
236350,193665.4,930650,74100,53934.1,338450,162250,139731.3,592200
236270,190282.5,930650,74940,55299.3,338450,161330,134983.2,592200
236090,190725.9,930650,75750,55233.7,338450,160340,135492.2,592200
235930,184225.4,930650,76580,51286,338450,159350,132939.4,592200
235860,175161.7,930650,77380,48916.9,338450,158480,126244.8,592200
234130,170177.9,930650,76950,42439.6,338450,157180,127738.3,592200
232400,169026,930650,76520,40956.6,338450,155880,128069.4,592200
230650,178581.3,930650,76080,43128.3,338450,154570,135453,592200
206510,193135.7,930650,64160,50875,338450,142350,142260.7,592200
207320,181771.3,930650,65400,49337.5,338450,141920,132433.8,592200
208070,182855.6,930650,66640,49908.3,338450,141430,132947.3,592200
208840,175703.5,930650,67840,52631.4,338450,141000,123072.1,592200
209690,152996.1,930650,69100,53936.2,338450,140590,99059.9,592200
217170,165517.3,930650,73630,63445.4,338450,143540,102071.9,592200
224680,198777.4,930650,78140,78183.7,338450,146540,120593.7,592200
232280,213136,930650,82690,89494.5,338450,149590,123641.5,592200
239830,226005.8,930650,87190,93452.6,338450,152640,132553.2,592200
247030,249271.8,930650,91930,101210.1,338450,155100,148061.7,592200
254250,265920,930650,96660,113911.5,338450,157590,152008.5,592200
261440,289585.9,930650,101390,124586.1,338450,160050,164999.8,592200
268640,299515.7,930650,106130,125439.2,338450,162510,174076.5,592200
277410,297129.4,930650,111690,117889.1,338450,165720,179240.3,592200
286210,302469.4,930650,117270,123035.7,338450,168940,179433.7,592200
294950,294796,930650,122830,123572.5,338450,172120,171223.5,592200
303750,286681.3,930650,128420,120501.8,338450,175330,166179.5,592200
315740,277273.5,930650,132450,118819.7,338450,183290,158453.8,592200
327690,308445.1,930650,136480,117633.3,338450,191210,190811.8,592200
339680,296599.2,930650,140510,107852.1,338450,199170,188747.1,592200
351710,271095.2,930650,144550,107355.3,338450,207160,163739.9,592200
367430,272022.4,930650,152110,111517.9,338450,215320,160504.5,592200
383120,288320.2,930650,159640,121966.4,338450,223480,166353.8,592200
398810,316016.2,930650,167170,139981.7,338450,231640,176034.5,592200
414590,331098.4,930650,174750,142803,338450,239840,188295.4,592200
430310,347339.9,930650,181130,154029.6,338450,249180,193310.3,592200
444890,352695.5,930650,186380,153176.6,338450,258510,199518.9,592200
457130,386823.9,930650,189250,164663.1,338450,267880,222160.8,592200
469320,417921.4,930650,192130,171935.7,338450,277190,245985.7,592200
484170,465043.8,930650,195580,193173.5,338450,288590,271870.3,592200
499040,475131.6,930650,199030,187923,338450,300010,287208.6,592200
513910,482398.5,930650,202470,185712.5,338450,311440,296686,592200
528810,483097.2,930650,205930,181792.5,338450,322880,301304.7,592200
542140,496380.7,930650,208880,186833.4,338450,333260,309547.3,592200
555450,493219.5,930650,211830,184062.5,338450,343620,309157,592200
568820,500840.6,930650,214770,189420.2,338450,354050,311420.4,592200
582200,503763.6,930650,217720,193460,338450,364480,310303.6,592200
595680,517269.3,930650,221220,201928.2,338450,374460,315341.1,592200
609110,521842.5,930650,224700,193636.9,338450,384410,328205.6,592200
622540,552036.5,930650,228180,204709.4,338450,394360,347327.1,592200
636070,590290.3,930650,231670,222166.3,338450,404400,368124,592200
642980,609298.9,930650,233220,234337.2,338450,409760,374961.7,592200
649900,610757.6,930650,234730,231196.1,338450,415170,379561.5,592200
656880,642328.8,930650,236270,235203.4,338450,420610,407125.4,592200
663830,655372.2,930650,237800,233339.8,338450,426030,422032.4,592200
671520,645516.2,930650,239940,228909.6,338450,431580,416606.6,592200
679170,650061.2,930650,242040,229887.5,338450,437130,420173.7,592200
686850,664958,930650,244150,233090.1,338450,442700,431867.9,592200
694530,648928.2,930650,246260,227226.1,338450,448270,421702.1,592200
703390,670326.4,930650,248660,244687.3,338450,454730,425639.1,592200
712260,702592.5,930650,251040,257094.1,338450,461220,445498.4,592200
721060,730406.8,930650,253420,261142,338450,467640,469264.8,592200
729960,743198.7,930650,255800,262971.2,338450,474160,480227.5,592200
734870,738116.6,930650,256600,264520.1,338450,478270,473596.5,592200
739800,744260.5,930650,257410,263815.8,338450,482390,480444.7,592200
744750,746761,930650,258240,264795.9,338450,486510,481965.1,592200
749740,741904.4,930650,259050,262552.8,338450,490690,479351.6,592200
753930,770281.5,930650,259850,266384.7,338450,494080,503896.8,592200
758220,760980.5,930650,260640,265665.6,338450,497580,495314.9,592200
762390,787517.6,930650,261410,268502.5,338450,500980,519015.1,592200
766650,771086.3,930650,262230,268244.3,338450,504420,502842,592200
770800,767099.9,930650,263240,267759,338450,507560,499340.9,592200
774960,782341.6,930650,264300,268944.1,338450,510660,513397.5,592200
779080,763880.6,930650,265340,267750.5,338450,513740,496130.1,592200
783170,775784.2,930650,266360,269345.5,338450,516810,506438.7,592200
783540,782758.7,930650,266490,270484.5,338450,517050,512274.2,592200
783890,792923.7,930650,266660,272633.3,338450,517230,520290.4,592200
784220,796457.7,930650,266780,272907.6,338450,517440,523550.1,592200
784540,814044.2,930650,266920,275109.4,338450,517620,538934.8,592200
784940,797092.2,930650,267010,274238.1,338450,517930,522854.1,592200
785320,790512,930650,267120,270729.9,338450,518200,519782.1,592200
785790,780594.1,930650,267250,260847.7,338450,518540,519746.4,592200
786110,778988.7,930650,267310,259095.1,338450,518800,519893.6,592200
786140,789642.2,930650,267250,259612.7,338450,518890,530029.5,592200
786130,774909.9,930650,267190,258493.6,338450,518940,516416.3,592200
786150,793719.4,930650,267120,260257.8,338450,519030,533461.6,592200
786140,779669.5,930650,267070,257699.6,338450,519070,521969.9,592200
783260,765773.2,930650,266500,256542.8,338450,516760,509230.4,592200
780270,771653.8,930650,265890,258854,338450,514380,512799.8,592200
777340,776550.4,930650,265330,266947.9,338450,512010,509602.5,592200
774470,770581.7,930650,264730,265673.4,338450,509740,504908.3,592200
771460,781954.9,930650,264120,265700.7,338450,507340,516254.2,592200
768440,764952.4,930650,263520,266798.7,338450,504920,498153.7,592200
765450,759703.1,930650,262890,263920.7,338450,502560,495782.4,592200
762430,750101.5,930650,262280,264932.2,338450,500150,485169.3,592200
759520,745209,930650,261720,262217.8,338450,497800,482991.2,592200
756730,760681.2,930650,261180,263593.3,338450,495550,497087.9,592200
753820,741565.1,930650,260640,262632.9,338450,493180,478932.2,592200
750980,758699.5,930650,260090,262965.8,338450,490890,495733.7,592200
747390,741244.8,930650,259520,260756.4,338450,487870,480488.4,592200
743900,755485.6,930650,258950,259600,338450,484950,495885.6,592200
740360,753525.1,930650,258380,260187.6,338450,481980,493337.5,592200
736800,752579,930650,257790,265093.7,338450,479010,487485.3,592200
733930,757211.1,930650,257510,266211.4,338450,476420,490999.7,592200
731100,735347.2,930650,257220,264701.2,338450,473880,470646,592200
728240,739101.7,930650,256950,262835.1,338450,471290,476266.6,592200
724630,712268.5,930650,254380,261691.9,338450,470250,450576.6,592200
722100,694664.4,930650,253780,258996.1,338450,468320,435668.3,592200
719610,696441.7,930650,253170,259286.7,338450,466440,437155,592200
717040,726460.2,930650,252560,259849.4,338450,464480,466610.8,592200
714520,721262.4,930650,251960,256877.4,338450,462560,464385,592200
713480,699087.3,930650,252240,255704.1,338450,461240,443383.2,592200
712460,700180,930650,252550,252967.4,338450,459910,447212.6,592200
711360,693844.4,930650,252820,251078.7,338450,458540,442765.7,592200
710380,701738.4,930650,253140,251527.1,338450,457240,450211.3,592200
708140,693246.9,930650,252750,246939.9,338450,455390,446307,592200
705880,688929.9,930650,252370,244346.7,338450,453510,444583.2,592200
703580,665662,930650,251990,240274.7,338450,451590,425387.3,592200
701320,640822.2,930650,251620,230556.4,338450,449700,410265.8,592200
698980,617829.8,930650,251470,221933.2,338450,447510,395896.6,592200
696630,614063.3,930650,251330,224436.1,338450,445300,389627.2,592200
694270,577444.4,930650,251190,212799.3,338450,443080,364645.1,592200
691930,571912.6,930650,251050,211535.2,338450,440880,360377.4,592200
683050,576921.8,930650,248860,216976.9,338450,434190,359944.9,592200
674240,569959.5,930650,246680,219838,338450,427560,350121.5,592200
665350,582803.9,930650,244480,224211.4,338450,420870,358592.5,592200
656500,574242.5,930650,242280,229653.5,338450,414220,344589,592200
647410,598526.7,930650,239910,240548.9,338450,407500,357977.8,592200
638280,610399.8,930650,237560,243798.9,338450,400720,366600.9,592200
629130,616648,930650,235180,244539,338450,393950,372109,592200
620050,632866.6,930650,232840,242464.1,338450,387210,390402.5,592200
612010,610222.8,930650,230830,237530.7,338450,381180,372692.1,592200
603870,616737.5,930650,228830,235219.5,338450,375040,381518,592200
595770,623876,930650,226830,243699.9,338450,368940,380176.1,592200
587730,617961.2,930650,224850,243740.9,338450,362880,374220.3,592200
583940,604806.7,930650,224160,242130.5,338450,359780,362676.2,592200
580230,583458,930650,223500,235341.5,338450,356730,348116.5,592200
576530,595634.3,930650,222830,234885.3,338450,353700,360749,592200
572760,604309.2,930650,222160,236239.1,338450,350600,368070.1,592200
568720,583507.3,930650,221370,223372.5,338450,347350,360134.8,592200
564590,571301.6,930650,220550,217174.1,338450,344040,354127.5,592200
560600,570923.7,930650,219760,217502.5,338450,340840,353421.2,592200
556470,572564.9,930650,218960,221275.5,338450,337510,351289.4,592200
552680,572893.4,930650,218220,226131,338450,334460,346762.4,592200
548900,555901.3,930650,217470,216572,338450,331430,339329.3,592200
545090,549510.2,930650,216740,220302.9,338450,328350,329207.3,592200
541310,576564.6,930650,216000,228309.2,338450,325310,348255.4,592200
542310,590546.6,930650,215930,229539.5,338450,326380,361007.1,592200
543280,608752.9,930650,215890,234686.6,338450,327390,374066.3,592200
544280,614758.3,930650,215820,240000.2,338450,328460,374758.1,592200
545220,615105.6,930650,215770,241903.1,338450,329450,373202.5,592200
545830,626276,930650,216160,246709.1,338450,329670,379566.9,592200
546450,626953.5,930650,216540,243993.6,338450,329910,382959.9,592200
547080,632129.3,930650,216930,240679.7,338450,330150,391449.6,592200
547630,608398.9,930650,217320,236888.5,338450,330310,371510.4,592200
548390,612718.6,930650,216820,240887.6,338450,331570,371831,592200
549110,607690.9,930650,216340,241496.2,338450,332770,366194.7,592200
549720,604067.4,930650,215820,241443,338450,333900,362624.4,592200
550440,606186.4,930650,215330,241938.5,338450,335110,364247.9,592200
550740,592035.8,930650,215810,237031.8,338450,334930,355004,592200
551070,591969.6,930650,216290,241089.1,338450,334780,350880.5,592200
551410,588006.3,930650,216790,239510.4,338450,334620,348495.9,592200
551650,599158.4,930650,217260,240068.4,338450,334390,359090,592200
550850,589623.9,930650,217650,236081.5,338450,333200,353542.4,592200
550050,597003.2,930650,218070,234642.2,338450,331980,362361,592200
549230,589026.5,930650,218460,231445.9,338450,330770,357580.6,592200
548450,560894.7,930650,218860,223151.7,338450,329590,337743,592200
547440,535899.6,930650,218430,212889.3,338450,329010,323010.3,592200
546440,529729.3,930650,218020,205016.1,338450,328420,324713.2,592200
545470,515748.8,930650,217610,202328.2,338450,327860,313420.6,592200
544450,504542.4,930650,217170,195179.9,338450,327280,309362.5,592200
541480,514084.7,930650,216580,198182.7,338450,324900,315902,592200
538520,550162.5,930650,215960,218590.3,338450,322560,331572.2,592200
535570,543103.4,930650,215350,214240.1,338450,320220,328863.3,592200
532660,524958.8,930650,214750,198211,338450,317910,326747.8,592200
530400,513817.5,930650,214160,192152,338450,316240,321665.5,592200
528120,521863.4,930650,213590,201089.2,338450,314530,320774.2,592200
525950,517846.7,930650,213000,199512.5,338450,312950,318334.2,592200
523710,520470,930650,212430,197851.8,338450,311280,322618.2,592200
522120,520758.9,930650,212180,190574.8,338450,309940,330184.1,592200
520520,518113.4,930650,211950,186492.5,338450,308570,331620.9,592200
519000,499816,930650,211710,186075.9,338450,307290,313740.1,592200
517480,500915.2,930650,211470,186386.3,338450,306010,314528.9,592200
519850,529250.7,930650,211550,200253.4,338450,308300,328997.3,592200
522330,531054.2,930650,211640,205727.6,338450,310690,325326.6,592200
524700,557944.4,930650,211720,217233.8,338450,312980,340710.6,592200
527110,552243.5,930650,211790,214435.6,338450,315320,337807.9,592200
529340,569127.5,930650,211670,216122.6,338450,317670,353004.9,592200
531500,559331.5,930650,211580,211775.8,338450,319920,347555.7,592200
533640,571555.5,930650,211430,216115.1,338450,322210,355440.4,592200
535910,551635.2,930650,211350,202494.3,338450,324560,349140.9,592200
537050,505991.7,930650,211320,187191.5,338450,325730,318800.2,592200
538180,496566.2,930650,211270,184143.8,338450,326910,312422.4,592200
539360,477835.7,930650,211260,182768.9,338450,328100,295066.8,592200
540480,513236.5,930650,211240,189223,338450,329240,324013.5,592200
541540,521648.4,930650,211460,189439.2,338450,330080,332209.2,592200
542600,543552.9,930650,211680,199540.3,338450,330920,344012.6,592200
543670,578167.1,930650,211880,225081.1,338450,331790,353086,592200
544720,582178,930650,212090,233371.7,338450,332630,348806.3,592200
545190,571531.8,930650,212180,214523.5,338450,333010,357008.3,592200
545600,567362.7,930650,212200,198776.3,338450,333400,368586.4,592200
545210,552809.9,930650,211400,192689.2,338450,333810,360120.7,592200
554090,559699.3,930650,216750,199717.2,338450,337340,359982.1,592200
561760,589013.1,930650,218130,212479.4,338450,343630,376533.7,592200
569290,595637.7,930650,219470,212686.2,338450,349820,382951.5,592200
576920,605174.1,930650,220850,221880.4,338450,356070,383293.7,592200
584530,598431.7,930650,222240,221477.2,338450,362290,376954.5,592200
590020,606383.5,930650,223230,226022.7,338450,366790,380360.8,592200
595460,609687.2,930650,224240,225025.2,338450,371220,384662,592200
600880,601055.7,930650,225250,219455.4,338450,375630,381600.3,592200
606350,603314.1,930650,226250,221994.6,338450,380100,381319.5,592200
610820,599797.6,930650,227030,212019.9,338450,383790,387777.7,592200
615280,604397.8,930650,227800,211970,338450,387480,392427.8,592200
619760,609596.5,930650,228590,214028.5,338450,391170,395568,592200
624210,556287.9,930650,229360,174573.5,338450,394850,381714.4,592200
627230,619431.5,930650,229920,221125.9,338450,397310,398305.6,592200
630280,611931.6,930650,230470,211660.4,338450,399810,400271.2,592200
633340,617842.4,930650,231020,215283.9,338450,402320,402558.5,592200
636440,622967.8,930650,231570,215625.9,338450,404870,407341.9,592200
631080,607600.1,930650,230450,214411.5,338450,400630,393188.6,592200
625810,594578.3,930650,229310,210214.5,338450,396500,384363.8,592200
620560,579119.6,930650,228190,207947.2,338450,392370,371172.4,592200
615210,578471.2,930650,227060,208476.6,338450,388150,369994.6,592200
610570,568086.4,930650,226050,207272.5,338450,384520,360813.9,592200
605770,559615.5,930650,225020,206532.7,338450,380750,353082.8,592200
601050,568018.1,930650,223990,210034.6,338450,377060,357983.5,592200
596290,549700.8,930650,222950,208968.2,338450,373340,340732.6,592200
591430,541520.9,930650,221710,206713.5,338450,369720,334807.4,592200
586530,528286.8,930650,220470,191478.5,338450,366060,336808.3,592200
581680,542030.2,930650,219240,202086.1,338450,362440,339944.1,592200
576800,557582,930650,217990,217401.7,338450,358810,340180.3,592200
573720,543534.4,930650,217500,208969.1,338450,356220,334565.3,592200
570610,520571.1,930650,217010,196321.5,338450,353600,324249.6,592200
567520,512497.3,930650,216510,198233,338450,351010,314264.3,592200
564410,497674.8,930650,216020,190071.3,338450,348390,307603.5,592200
561290,521313.7,930650,215100,211084.4,338450,346190,310229.3,592200
556220,508101.8,930650,212240,204553.2,338450,343980,303548.6,592200
551100,479497.6,930650,209330,189454.9,338450,341770,290042.7,592200
546030,473871.8,930650,206450,189377.6,338450,339580,284494.2,592200
540810,459633,930650,203490,184647.1,338450,337320,274985.9,592200
535610,451687.9,930650,200530,173398.5,338450,335080,278289.4,592200
530340,456920.4,930650,197550,188358.5,338450,332790,268561.9,592200
525160,457337.1,930650,194610,190800.5,338450,330550,266536.6,592200
526100,426614.1,930650,193700,177307.3,338450,332400,249306.8,592200
527010,430404.1,930650,192800,168890.3,338450,334210,261513.8,592200
528020,399550.1,930650,191920,141870.6,338450,336100,257679.5,592200
528980,374107.3,930650,190990,128517.6,338450,337990,245589.7,592200
530160,384266,930650,190680,139534.1,338450,339480,244731.9,592200
531400,375441.4,930650,190370,141013.7,338450,341030,234427.7,592200
532600,389118.7,930650,190040,147054.6,338450,342560,242064.1,592200
533780,383013.6,930650,189710,153268.6,338450,344070,229745,592200
534400,361735.5,930650,188660,143926.3,338450,345740,217809.2,592200
535010,371646.1,930650,187590,145942.6,338450,347420,225703.5,592200
535610,371355.8,930650,186520,134557.6,338450,349090,236798.2,592200
536200,376941.5,930650,185450,137186.8,338450,350750,239754.7,592200
524190,386112.4,930650,183560,144585.7,338450,340630,241526.7,592200
512110,368026.8,930650,181640,134571.4,338450,330470,233455.4,592200
500160,337237.4,930650,179760,114660,338450,320400,222577.4,592200
488130,338140.3,930650,177880,104969.4,338450,310250,233170.9,592200
476320,296768.4,930650,176300,99553.1,338450,300020,197215.3,592200
464570,309148.1,930650,174750,118541,338450,289820,190607.1,592200
452800,323321.7,930650,173160,122598.1,338450,279640,200723.6,592200
441040,332521,930650,171590,120362.3,338450,269450,212158.7,592200
426760,309370.7,930650,167990,117641.4,338450,258770,191729.3,592200
412510,250800.4,930650,164390,97909.2,338450,248120,152891.2,592200
398310,255001,930650,160780,102816.1,338450,237530,152184.9,592200
384120,250278.4,930650,157210,105429.8,338450,226910,144848.6,592200
378660,279607.3,930650,155850,113828.7,338450,222810,165778.6,592200
373170,285888.6,930650,154510,115333.3,338450,218660,170555.3,592200
367700,319256.1,930650,153170,135420.3,338450,214530,183835.8,592200
362200,295971.3,930650,151820,132401.3,338450,210380,163570,592200
360030,326492.6,930650,152750,145244.6,338450,207280,181248,592200
357840,317405.6,930650,153670,149313.9,338450,204170,168091.7,592200
355690,321381.7,930650,154610,137934.7,338450,201080,183447,592200
353560,318726,930650,155540,129135.3,338450,198020,189590.7,592200
350400,329879,930650,155040,143620.3,338450,195360,186258.7,592200
347210,329913,930650,154490,140763.1,338450,192720,189149.9,592200
344110,338236.1,930650,153990,154532.1,338450,190120,183704,592200
340910,327576.7,930650,153490,152499.2,338450,187420,175077.5,592200
342390,302682.1,930650,154640,132330.7,338450,187750,170351.4,592200
343860,275121.7,930650,155810,117801.1,338450,188050,157320.6,592200
345250,256242.1,930650,156950,115082.6,338450,188300,141159.5,592200
346720,274739.1,930650,158090,113451.3,338450,188630,161287.8,592200
345390,262610.6,930650,156970,99097.7,338450,188420,163512.9,592200
344140,244189,930650,155840,99979.8,338450,188300,144209.2,592200
342800,262274.3,930650,154690,118285.9,338450,188110,143988.4,592200
341480,264254,930650,153570,123790.2,338450,187910,140463.8,592200
341120,288335.3,930650,153150,141737,338450,187970,146598.3,592200
340780,252535.4,930650,152750,118334.5,338450,188030,134200.9,592200
340400,195949.2,930650,152370,81301.5,338450,188030,114647.7,592200
340090,189369.4,930650,151960,78294.6,338450,188130,111074.8,592200
344100,160567.6,930650,154810,71110.2,338450,189290,89457.4,592200
348110,164968,930650,157660,68165.1,338450,190450,96802.9,592200
352090,167959,930650,160470,70196.9,338450,191620,97762.1,592200
356100,177222.4,930650,163320,77541.5,338450,192780,99680.9,592200
361120,197785.1,930650,167070,88983.1,338450,194050,108802,592200
366100,219356.8,930650,170850,94808.3,338450,195250,124548.5,592200
371160,208032.6,930650,174630,87903.7,338450,196530,120128.9,592200
282170,239116,930650,131260,93639.3,338450,150910,145476.7,592200
285160,264420.4,930650,133650,104011.3,338450,151510,160409.1,592200
288190,270072.8,930650,136030,109012.4,338450,152160,161060.4,592200
291180,284634.2,930650,138390,122619.4,338450,152790,162014.8,592200
294140,288340,930650,140770,124952.3,338450,153370,163387.7,592200
300450,271365.6,930650,143630,109942.9,338450,156820,161422.7,592200
306740,279742.7,930650,146470,112388.3,338450,160270,167354.4,592200
313030,254569.1,930650,149310,109260.5,338450,163720,145308.6,592200
319400,249960.9,930650,152170,116283.4,338450,167230,133677.5,592200
325450,249287.7,930650,154520,111135.6,338450,170930,138152.1,592200
331620,251278.4,930650,156890,103779.6,338450,174730,147498.8,592200
337670,234659.9,930650,159220,108083.4,338450,178450,126576.5,592200
343780,228953,930650,161560,106867.7,338450,182220,122085.3,592200
351310,223038,930650,165270,107063.7,338450,186040,115974.3,592200
358750,257700.8,930650,168960,123994.9,338450,189790,133705.9,592200
366300,287589.4,930650,172630,131860.9,338450,193670,155728.5,592200
373780,290790.2,930650,176330,137067.1,338450,197450,153723.1,592200
378760,279612.9,930650,176580,130435.6,338450,202180,149177.3,592200
383680,253030.8,930650,176820,112664.7,338450,206860,140366.1,592200
388680,261204.2,930650,177100,117364.1,338450,211580,143840.1,592200
393560,286500.4,930650,177350,132848.7,338450,216210,153651.7,592200
399040,315836.1,930650,177590,146797.8,338450,221450,169038.3,592200
404470,313305.6,930650,177820,143806.5,338450,226650,169499.1,592200
409880,305492.6,930650,178050,142881.8,338450,231830,162610.8,592200
415290,308852.4,930650,178260,141310.1,338450,237030,167542.3,592200
420580,333096.6,930650,178540,149673.5,338450,242040,183423.1,592200
425810,336527.6,930650,178810,150507,338450,247000,186020.6,592200
431070,336894.8,930650,179060,143978.3,338450,252010,192916.5,592200
436400,358607.3,930650,179350,162000.6,338450,257050,196606.7,592200
433840,341658,930650,177990,149892.6,338450,255850,191765.4,592200
431320,361007.2,930650,176640,159193.6,338450,254680,201813.6,592200
428760,360764.7,930650,175270,160867,338450,253490,199897.7,592200
426190,382611.1,930650,173920,171439.3,338450,252270,211171.8,592200
423420,411907,930650,172190,190555,338450,251230,221352,592200
420620,370089.6,930650,170470,161200.1,338450,250150,208889.5,592200
417690,301227.7,930650,168720,107925.1,338450,248970,193302.6,592200
414910,304317.4,930650,166980,106722.4,338450,247930,197595,592200
412960,320255.6,930650,165110,119871.7,338450,247850,200383.9,592200
411080,303215.5,930650,163230,113254.4,338450,247850,189961.1,592200
409130,328727.5,930650,161370,130809.5,338450,247760,197918,592200
407210,343934.4,930650,159490,138328,338450,247720,205606.4,592200
407600,342047.3,930650,159390,134761.4,338450,248210,207285.9,592200
408040,330206.2,930650,159310,132473.7,338450,248730,197732.5,592200
408530,340591,930650,159230,138923.1,338450,249300,201667.9,592200
408920,359055.8,930650,159140,148673.4,338450,249780,210382.4,592200
407890,376271.7,930650,158220,148545.4,338450,249670,227726.3,592200
406970,364563.6,930650,157320,139824.6,338450,249650,224739,592200
406010,352024.6,930650,156400,122446.8,338450,249610,229577.8,592200
405040,320529.2,930650,155480,109297.6,338450,249560,211231.6,592200
402260,337893.5,930650,153700,125035.1,338450,248560,212858.4,592200
399410,328291.6,930650,151890,119920.6,338450,247520,208371,592200
396590,290579.3,930650,150100,108520.9,338450,246490,182058.4,592200
393760,290491.9,930650,148310,115560.9,338450,245450,174931,592200
389250,300731.1,930650,147770,120090.1,338450,241480,180641,592200
384640,307541.7,930650,147190,115692.8,338450,237450,191848.9,592200
380050,312119.4,930650,146640,120887.6,338450,233410,191231.8,592200
375540,314057.6,930650,146090,124494.8,338450,229450,189562.8,592200
369960,295763.7,930650,145890,111063.5,338450,224070,184700.2,592200
364460,321502.4,930650,145700,119564,338450,218760,201938.4,592200
358840,331452.4,930650,145520,126995.4,338450,213320,204457,592200
353260,315606.6,930650,145270,124483,338450,207990,191123.6,592200
348780,313044.9,930650,145040,129460.7,338450,203740,183584.2,592200
344210,319434.4,930650,144750,133474.4,338450,199460,185960,592200
339680,316974.9,930650,144510,126199.7,338450,195170,190775.2,592200
335090,327171.3,930650,144230,126930.7,338450,190860,200240.6,592200
332770,307646.8,930650,144140,129718.1,338450,188630,177928.7,592200
330510,308298.9,930650,144060,131811.2,338450,186450,176487.7,592200
328180,310251.2,930650,143960,125958.4,338450,184220,184292.8,592200
325890,331584.7,930650,143860,137120.4,338450,182030,194464.3,592200
323880,345710.9,930650,143320,145131,338450,180560,200579.9,592200
321790,336716,930650,142740,144796.9,338450,179050,191919.1,592200
319760,332793,930650,142210,148124.4,338450,177550,184668.6,592200
317780,337547.4,930650,141650,152500.6,338450,176130,185046.8,592200
315770,392014.5,930650,140710,172930.5,338450,175060,219084,592200
313840,402469.3,930650,139830,175498.2,338450,174010,226971.1,592200
311860,395841.1,930650,138910,166191.9,338450,172950,229649.2,592200
309880,376691.7,930650,137990,151594.9,338450,171890,225096.8,592200
307830,361719.1,930650,137560,150772.9,338450,170270,210946.2,592200
305840,361180.6,930650,137150,151515.6,338450,168690,209665,592200
303770,341760.6,930650,136760,141827.8,338450,167010,199932.8,592200
301740,357735.6,930650,136340,146700.9,338450,165400,211034.7,592200
300160,363411.2,930650,136610,151871.3,338450,163550,211539.9,592200
298640,358112.7,930650,136860,154047,338450,161780,204065.7,592200
297000,347998.4,930650,137130,149726.5,338450,159870,198271.9,592200
295440,352853.9,930650,137380,150398.4,338450,158060,202455.5,592200
294650,340339.9,930650,137880,144291.2,338450,156770,196048.7,592200
293700,329685.8,930650,138340,143990.4,338450,155360,185695.4,592200
292800,332512.6,930650,138810,144785.3,338450,153990,187727.3,592200
291910,320721.8,930650,139280,139966,338450,152630,180755.8,592200
286470,320676.7,930650,135810,138794,338450,150660,181882.7,592200
281110,331637.7,930650,132340,142559.6,338450,148770,189078.1,592200
275660,355056.1,930650,128860,153816.3,338450,146800,201239.8,592200
270240,345816.7,930650,125390,149421.6,338450,144850,196395.1,592200
267310,339655.1,930650,124040,144703.9,338450,143270,194951.2,592200
264340,319061.7,930650,122710,129693.6,338450,141630,189368.1,592200
261360,323023.9,930650,121360,131189.8,338450,140000,191834.1,592200
287730,319648.3,930650,124130,129148.5,338450,163600,190499.8,592200
286320,313497.4,930650,122200,127536.6,338450,164120,185960.8,592200
284850,299653.3,930650,120260,118786.2,338450,164590,180867.1,592200
283390,283163.6,930650,118340,109578.3,338450,165050,173585.3,592200
281930,267781,930650,116380,96465,338450,165550,171316,592200
277830,292790.2,930650,112020,115926,338450,165810,176864.2,592200
273730,316142.6,930650,107640,132345.2,338450,166090,183797.4,592200
269700,310219.6,930650,103280,126194.4,338450,166420,184025.2,592200
265610,276180.8,930650,98890,108677,338450,166720,167503.8,592200
263370,253647.5,930650,96630,95926.3,338450,166740,157721.2,592200
261090,256244.1,930650,94360,97770.2,338450,166730,158473.9,592200
258870,247093,930650,92100,87487.9,338450,166770,159605.1,592200
256690,230157,930650,89830,76596.5,338450,166860,153560.5,592200
255670,224775.8,930650,88790,76462.3,338450,166880,148313.5,592200
254650,217066,930650,87740,74384.4,338450,166910,142681.6,592200
253710,220829.2,930650,86700,72635.7,338450,167010,148193.5,592200
252640,219022.5,930650,85660,71722.1,338450,166980,147300.4,592200
246770,214190.5,930650,84090,72396.7,338450,162680,141793.8,592200
240860,222791,930650,82460,80839.6,338450,158400,141951.4,592200
234960,212822.9,930650,80860,78106.8,338450,154100,134716.1,592200
229010,211133.8,930650,79250,79244.9,338450,149760,131888.9,592200
222280,208929.1,930650,77240,78641.9,338450,145040,130287.2,592200
215640,223452.7,930650,75220,90029.1,338450,140420,133423.6,592200
208970,219994.5,930650,73240,87926.7,338450,135730,132067.8,592200
202340,215235.6,930650,71220,87384.6,338450,131120,127851,592200
194800,176054.7,930650,69040,60725.1,338450,125760,115329.6,592200
187240,144715.3,930650,66870,36553.9,338450,120370,108161.4,592200
179720,142132,930650,64690,37871.2,338450,115030,104260.8,592200
172110,130566.6,930650,62490,35815.6,338450,109620,94751,592200
168880,105499.9,930650,62500,39412.7,338450,106380,66087.2,592200
165660,114820.3,930650,62540,47615,338450,103120,67205.3,592200
162390,114434.8,930650,62550,47184.1,338450,99840,67250.7,592200
159080,113935.3,930650,62560,42979.9,338450,96520,70955.4,592200
156320,121833.8,930650,63080,38849.2,338450,93240,82984.6,592200
153640,158563.8,930650,63610,47672.9,338450,90030,110890.9,592200
150870,169349.1,930650,64150,57681.1,338450,86720,111668,592200
148050,163850,930650,64700,54956,338450,83350,108894,592200
144660,148806.9,930650,64830,45032.7,338450,79830,103774.2,592200
141300,140083.5,930650,64970,41159.5,338450,76330,98924,592200
137950,126228.7,930650,65160,33206.3,338450,72790,93022.4,592200
134550,113473.6,930650,65270,28675.7,338450,69280,84797.9,592200
135200,108812.4,930650,64990,28345.7,338450,70210,80466.7,592200
135820,112577.8,930650,64700,33145.7,338450,71120,79432.1,592200
136460,119984.1,930650,64430,38278.7,338450,72030,81705.4,592200
137140,110948.5,930650,64170,33255.7,338450,72970,77692.8,592200
138140,103695.4,930650,64590,27640.7,338450,73550,76054.7,592200
139130,103546.7,930650,65020,26193.7,338450,74110,77353,592200
140140,105460.8,930650,65470,24638.8,338450,74670,80822,592200
141220,107497.3,930650,65910,25332.7,338450,75310,82164.6,592200
141590,99460.9,930650,66280,20272.9,338450,75310,79188,592200
142000,95499.2,930650,66630,18649.9,338450,75370,76849.3,592200
142440,92763.7,930650,67000,19405.7,338450,75440,73358,592200
142830,87887.2,930650,67340,16533.4,338450,75490,71353.8,592200
140450,86426.5,930650,66280,14943.1,338450,74170,71483.4,592200
138080,84549.9,930650,65190,13074.7,338450,72890,71475.2,592200
135740,82546,930650,64140,13081,338450,71600,69465,592200
133410,79046.1,930650,63060,11990.1,338450,70350,67056,592200
131550,76223.9,930650,62180,11077.5,338450,69370,65146.4,592200
129640,73149,930650,61260,9565.8,338450,68380,63583.2,592200
127800,70552.4,930650,60370,8928.5,338450,67430,61623.9,592200
125920,71083.7,930650,59460,9822.7,338450,66460,61261,592200
124470,73994.5,930650,58650,12113.9,338450,65820,61880.6,592200
123030,75090.4,930650,57830,12467.9,338450,65200,62622.5,592200
121670,88184.1,930650,57020,20686,338450,64650,67498.1,592200
120210,117624.4,930650,56190,43133.3,338450,64020,74491.1,592200
117630,144803.9,930650,54050,61818.8,338450,63580,82985.1,592200
114990,149392.2,930650,51910,63468.1,338450,63080,85924.1,592200
112280,157808.4,930650,49750,69331,338450,62530,88477.4,592200
109710,154352.6,930650,47610,69639.8,338450,62100,84712.8,592200
106970,153421.5,930650,45410,65085.5,338450,61560,88336,592200
104290,144692.9,930650,43200,58172.6,338450,61090,86520.3,592200
101550,143976.7,930650,41020,57562.2,338450,60530,86414.5,592200
98760,135694.3,930650,38790,52694.6,338450,59970,82999.7,592200
96470,132955.5,930650,36860,51479.4,338450,59610,81476.1,592200
94220,128001,930650,34920,47618.1,338450,59300,80382.9,592200
91810,117254.2,930650,32990,41575.8,338450,58820,75678.4,592200
89500,95090.7,930650,31040,26495.6,338450,58460,68595.1,592200
85360,70025.8,930650,29470,8322.9,338450,55890,61702.9,592200
81220,65684.9,930650,27910,5007.1,338450,53310,60677.8,592200
77010,66462.1,930650,26320,5522.7,338450,50690,60939.4,592200
72850,66344.6,930650,24760,6283.7,338450,48090,60060.9,592200
68870,68790,930650,23200,6316.8,338450,45670,62473.2,592200
64810,69089.1,930650,21660,6051.1,338450,43150,63038,592200
60760,69063.5,930650,20100,6674.3,338450,40660,62389.2,592200
56830,71419.2,930650,18550,7615.4,338450,38280,63803.8,592200
52820,71319.8,930650,16960,6833,338450,35860,64486.8,592200
48890,72375.7,930650,15390,6764.3,338450,33500,65611.4,592200
44910,74037.6,930650,13800,7782.3,338450,31110,66255.3,592200
40960,70693.1,930650,12240,5073.7,338450,28720,65619.4,592200
38040,69760.8,930650,11340,4625,338450,26700,65135.8,592200
35130,68282.2,930650,10460,4551,338450,24670,63731.2,592200
32240,68740.6,930650,9570,4626,338450,22670,64114.6,592200
29430,70310.1,930650,8680,4901,338450,20750,65409.1,592200
26520,71094.4,930650,7790,5026,338450,18730,66068.4,592200
23570,70401.7,930650,6850,4963.5,338450,16720,65438.2,592200
20640,69545.5,930650,5920,4926,338450,14720,64619.5,592200
11450,68770.4,930650,2460,4913.5,338450,8990,63856.9,592200
11420,68250.3,930650,2240,4813.5,338450,9180,63436.8,592200
11340,67553.3,930650,2020,4701,338450,9320,62852.3,592200
11330,68217.1,930650,1820,4715.3,338450,9510,63501.8,592200
11300,67468.1,930650,1610,4601,338450,9690,62867.1,592200
11320,67133.4,930650,1590,4563.5,338450,9730,62569.9,592200
11400,66632.3,930650,1610,4513.5,338450,9790,62118.8,592200
11460,66266.4,930650,1630,4501,338450,9830,61765.4,592200
11570,66110.3,930650,1640,4501,338450,9930,61609.3,592200
11410,66163,930650,1620,4601,338450,9790,61562,592200
11230,66517.1,930650,1610,4701,338450,9620,61816.1,592200
11050,66403.8,930650,1600,4701,338450,9450,61702.8,592200
10900,66492.3,930650,1570,4726,338450,9330,61766.3,592200
10850,66093.3,930650,1660,4701,338450,9190,61392.3,592200
10780,66838.4,930650,1760,4776,338450,9020,62062.4,592200
10770,66977.5,930650,1860,4801,338450,8910,62176.5,592200
10700,66612.6,930650,1940,4788.5,338450,8760,61824.1,592200
11270,66398.8,930650,2060,4701,338450,9210,61697.8,592200
11850,66436.5,930650,2190,4688.5,338450,9660,61748,592200
12420,66266,930650,2310,5051.2,338450,10110,61214.8,592200
12970,66600.5,930650,2440,5045.5,338450,10530,61555,592200
13760,66601.5,930650,2600,4917,338450,11160,61684.5,592200
14560,66222.5,930650,2770,4598.4,338450,11790,61624.1,592200
15400,68719.1,930650,2950,4949.1,338450,12450,63770,592200
16170,69726.1,930650,3130,5186.4,338450,13040,64539.7,592200
17630,71514.2,930650,3730,5789.8,338450,13900,65724.4,592200
19060,70832.6,930650,4290,5708.9,338450,14770,65123.7,592200
20510,70180.3,930650,4870,5862.6,338450,15640,64317.7,592200
21980,71603,930650,5470,6032.8,338450,16510,65570.2,592200
27230,70711.5,930650,8660,5526.9,338450,18570,65184.6,592200
32500,70044.5,930650,11860,6083,338450,20640,63961.5,592200
37800,71235.7,930650,15070,7430.6,338450,22730,63805.1,592200
43020,73747.6,930650,18240,9181.3,338450,24780,64566.3,592200
46130,75925.7,930650,19330,11007.2,338450,26800,64918.5,592200
49270,78964.2,930650,20380,13040.3,338450,28890,65923.9,592200
52380,81176,930650,21450,13989.1,338450,30930,67186.9,592200
55460,84364.3,930650,22510,16512.6,338450,32950,67851.7,592200
60130,85043.3,930650,25390,17154.3,338450,34740,67889,592200
64860,87961.3,930650,28280,18295.5,338450,36580,69665.8,592200
69630,88901,930650,31200,18453.7,338450,38430,70447.3,592200
74290,88298.9,930650,34060,18662.9,338450,40230,69636,592200
79610,86492.7,930650,37640,18573.8,338450,41970,67918.9,592200
84790,82884.8,930650,41210,16159.6,338450,43580,66725.2,592200
90010,73066.1,930650,44760,10228,338450,45250,62838.1,592200
95340,71991.1,930650,48360,10247.6,338450,46980,61743.5,592200
99150,74199.8,930650,51500,11324,338450,47650,62875.8,592200
103030,75672,930650,54650,11612,338450,48380,64060,592200
106810,73521.5,930650,57800,11910.6,338450,49010,61610.9,592200
110650,73854.2,930650,60940,12828.2,338450,49710,61026,592200
114150,75582.2,930650,63610,14721.3,338450,50540,60860.9,592200
117590,75716.6,930650,66280,15234.1,338450,51310,60482.5,592200
121090,74858.2,930650,68940,15087.2,338450,52150,59771,592200
124630,65725.2,930650,71620,14062.8,338450,53010,51662.4,592200
131330,71359.9,930650,75230,12897.5,338450,56100,58462.4,592200
138050,71223.2,930650,78820,13110.9,338450,59230,58112.3,592200
144780,70415.7,930650,82430,12130.8,338450,62350,58284.9,592200
151610,70086,930650,86060,11165.1,338450,65550,58920.9,592200
158410,70502,930650,89790,10935,338450,68620,59567,592200
165210,70760.8,930650,93530,11300.2,338450,71680,59460.6,592200
171970,71191.4,930650,97260,12095.3,338450,74710,59096.1,592200
178800,73589.9,930650,101000,13495.7,338450,77800,60094.2,592200
186440,76726.5,930650,105770,15758.6,338450,80670,60967.9,592200
194130,79485.1,930650,110540,16404.2,338450,83590,63080.9,592200
201780,86050.1,930650,115310,19261.1,338450,86470,66789,592200
209460,93136.6,930650,120110,22072.7,338450,89350,71063.9,592200
222540,101624.2,930650,125330,25430,338450,97210,76194.2,592200
235580,111467.2,930650,130550,27852.4,338450,105030,83614.8,592200
248690,122115.9,930650,135780,29812.2,338450,112910,92303.7,592200
261720,123947.7,930650,140990,34482,338450,120730,89465.7,592200
275430,154242.7,930650,146450,58373,338450,128980,95869.7,592200
289100,238820.3,930650,151870,110758.1,338450,137230,128062.2,592200
302690,259909.6,930650,157280,120402.3,338450,145410,139507.3,592200
316370,262588.2,930650,162700,119451.5,338450,153670,143136.7,592200
329910,295645.7,930650,167990,133771.4,338450,161920,161874.3,592200
343400,302656.3,930650,173230,136239.4,338450,170170,166416.9,592200
356910,311942.2,930650,178500,143371.9,338450,178410,168570.3,592200
370410,331411.6,930650,183770,153537.2,338450,186640,177874.4,592200
379500,353323.8,930650,187050,161251,338450,192450,192072.8,592200
388490,361585.9,930650,190370,165713.8,338450,198120,195872.1,592200
397510,345249.2,930650,193640,153225.9,338450,203870,192023.3,592200
406560,353127.8,930650,196940,155196,338450,209620,197931.8,592200
414970,378903.4,930650,200120,168858.5,338450,214850,210044.9,592200
423390,379540.2,930650,203300,166719,338450,220090,212821.2,592200
431800,407556,930650,206480,180540.2,338450,225320,227015.8,592200
440260,422650.6,930650,209660,183962.1,338450,230600,238688.5,592200
448890,412585.9,930650,213000,173240.7,338450,235890,239345.2,592200
457450,398890.3,930650,216360,159190.2,338450,241090,239700.1,592200
466010,371571.9,930650,219650,143631.7,338450,246360,227940.2,592200
474680,355433.3,930650,223000,138801.4,338450,251680,216631.9,592200
478950,374496,930650,223950,156542.5,338450,255000,217953.5,592200
483120,366747.5,930650,224860,156592.6,338450,258260,210154.9,592200
487400,370862.2,930650,225790,159739.2,338450,261610,211123,592200
491620,377448.9,930650,226690,159492.8,338450,264930,217956.1,592200
495810,379017.1,930650,227510,158593.3,338450,268300,220423.8,592200
499960,377540.6,930650,228310,157377.8,338450,271650,220162.8,592200
504080,390513.8,930650,229110,160813.1,338450,274970,229700.7,592200
431470,408921.3,930650,199690,167603.9,338450,231780,241317.4,592200
438080,408386.1,930650,202350,168697.4,338450,235730,239688.7,592200
444700,431066.9,930650,205000,184388.1,338450,239700,246678.8,592200
451320,471594.6,930650,207670,206255.2,338450,243650,265339.4,592200
457990,487169,930650,210350,212414.2,338450,247640,274754.8,592200
463960,488944.9,930650,212420,209637.9,338450,251540,279307,592200
469980,527569.8,930650,214490,229556.6,338450,255490,298013.2,592200
475970,529992.8,930650,216510,232594.8,338450,259460,297398,592200
481990,518045.1,930650,218600,225352.3,338450,263390,292692.8,592200
486560,510612.6,930650,220330,221487.5,338450,266230,289125.1,592200
491140,520326,930650,222050,226113.1,338450,269090,294212.9,592200
495760,531425.7,930650,223780,226391.6,338450,271980,305034.1,592200
500290,553297.6,930650,225470,234951.7,338450,274820,318345.9,592200
505490,557990.9,930650,227760,236603,338450,277730,321387.9,592200
510510,570470.2,930650,230020,241176.3,338450,280490,329293.9,592200
515570,570233.5,930650,232310,241374.8,338450,283260,328858.7,592200
520630,559749.6,930650,234570,239408.8,338450,286060,320340.8,592200
522830,562628.1,930650,235790,239415.6,338450,287040,323212.5,592200
525050,550604,930650,237000,232829.9,338450,288050,317774.1,592200
527160,544798,930650,238210,230578,338450,288950,314220,592200
529330,541310.5,930650,239430,228490.8,338450,289900,312819.7,592200
531740,555620.3,930650,240180,229149.1,338450,291560,326471.2,592200
534120,565964.2,930650,240940,233767,338450,293180,332197.2,592200
536480,565862.7,930650,241660,241771,338450,294820,324091.7,592200
538890,568219.4,930650,242410,238775.9,338450,296480,329443.5,592200
540720,582120.5,930650,242930,243690.8,338450,297790,338429.7,592200
542500,582632.9,930650,243430,246737.1,338450,299070,335895.8,592200
544280,575875.1,930650,243950,243845.2,338450,300330,332029.9,592200
546090,573248.5,930650,244460,242376.4,338450,301630,330872.1,592200
547810,563402.8,930650,244640,235647.9,338450,303170,327754.9,592200
549550,565690.9,930650,244860,234601.3,338450,304690,331089.6,592200
551300,558564.2,930650,245050,232860,338450,306250,325704.2,592200
553050,561096.4,930650,245270,236284.7,338450,307780,324811.7,592200
554620,575808.5,930650,245490,243043.8,338450,309130,332764.7,592200
556150,592113.6,930650,245690,249942.7,338450,310460,342170.9,592200
557680,604708.2,930650,245910,249890.1,338450,311770,354818.1,592200
559210,608078,930650,246120,251787.4,338450,313090,356290.6,592200
561000,603638.9,930650,246260,253443.7,338450,314740,350195.2,592200
562750,600124.6,930650,246410,251197.2,338450,316340,348927.4,592200
564500,596118.2,930650,246570,251070.5,338450,317930,345047.7,592200
566300,609175.4,930650,246720,251423.4,338450,319580,357752,592200
567640,611688.7,930650,247190,254579.8,338450,320450,357108.9,592200
568930,606162.6,930650,247640,256875.1,338450,321290,349287.5,592200
570250,623259.1,930650,248100,273867.5,338450,322150,349391.6,592200
571620,630494.3,930650,248600,280664.1,338450,323020,349830.2,592200
572710,603482.7,930650,248990,266655.1,338450,323720,336827.6,592200
573870,577907.5,930650,249390,249368.9,338450,324480,328538.6,592200
575050,569177.2,930650,249780,241142.3,338450,325270,328034.9,592200
576140,539435.2,930650,250190,234110.7,338450,325950,305324.5,592200
577780,528221.3,930650,250610,222340.3,338450,327170,305881,592200
579490,510072.4,930650,251030,213507.1,338450,328460,296565.3,592200
581120,492681.9,930650,251450,208586.4,338450,329670,284095.5,592200
582770,492360.6,930650,251840,207976.8,338450,330930,284383.8,592200
575810,480816.1,930650,249100,198450.7,338450,326710,282365.4,592200
568950,490300.7,930650,246340,200297.6,338450,322610,290003.1,592200
562000,495817.1,930650,243570,206171.6,338450,318430,289645.5,592200
555070,482345.3,930650,240840,193186.5,338450,314230,289158.8,592200
548600,486076.1,930650,238220,192465.9,338450,310380,293610.2,592200
541970,500347.1,930650,235580,208714.3,338450,306390,291632.8,592200
535460,502242,930650,232960,209328.2,338450,302500,292913.8,592200
528920,505039.4,930650,230330,217851.5,338450,298590,287187.9,592200
522360,524628.2,930650,228080,227107,338450,294280,297521.2,592200
515910,518551.9,930650,225830,222705.4,338450,290080,295846.5,592200
509310,516233.3,930650,223550,229862.6,338450,285760,286370.7,592200
502870,507274.5,930650,221300,228746,338450,281570,278528.5,592200
484870,499931.4,930650,212940,219771.7,338450,271930,280159.7,592200
466850,482088.2,930650,204570,209210.5,338450,262280,272877.7,592200
448890,479752.9,930650,196240,205424.3,338450,252650,274328.6,592200
430850,478648.2,930650,187880,205285,338450,242970,273363.2,592200
413850,489214.8,930650,179950,209078.9,338450,233900,280135.9,592200
396740,501227,930650,172000,214205.5,338450,224740,287021.5,592200
379660,518925.4,930650,164060,227492.9,338450,215600,291432.5,592200
362610,490145,930650,156120,216041.1,338450,206490,274103.9,592200
344390,499577.4,930650,147700,219134.3,338450,196690,280443.1,592200
326130,497881.9,930650,139270,222927.8,338450,186860,274954.1,592200
307970,476290.4,930650,130880,209264.4,338450,177090,267026,592200
289710,467676.9,930650,122470,200545.5,338450,167240,267131.4,592200
276400,468976.7,930650,116410,207154.7,338450,159990,261822,592200
263260,467730.1,930650,110380,208336.2,338450,152880,259393.9,592200
249940,454708.6,930650,104320,201828.4,338450,145620,252880.2,592200
236730,443308.7,930650,98290,197011.6,338450,138440,246297.1,592200
222930,432262.7,930650,91260,196615.7,338450,131670,235647,592200
209050,437203.5,930650,84210,201646.6,338450,124840,235556.9,592200
195300,423022.8,930650,77200,194075.3,338450,118100,228947.5,592200
181490,413631.2,930650,70160,185427.3,338450,111330,228203.9,592200
173590,400209.5,930650,68480,176858.7,338450,105110,223350.8,592200
165780,387852.7,930650,66800,171320.5,338450,98980,216532.2,592200
157890,355557.9,930650,65140,151010.6,338450,92750,204547.3,592200
150040,339671.5,930650,63460,141539.6,338450,86580,198131.9,592200
148960,327360.4,930650,62190,138389.3,338450,86770,188971.1,592200
147880,309796.2,930650,60930,124823.7,338450,86950,184972.5,592200
146780,318624.4,930650,59680,134674.1,338450,87100,183950.3,592200
145730,312092.1,930650,58430,135652.9,338450,87300,176439.2,592200
143970,312695.3,930650,57470,133911.7,338450,86500,178783.6,592200
142180,307531.9,930650,56500,131463.8,338450,85680,176068.1,592200
140410,311009.7,930650,55520,138999.4,338450,84890,172010.3,592200
300930,335985.6,930650,163460,176593.6,338450,137470,159392,592200
299640,329539.2,930650,164100,174026.1,338450,135540,155513.1,592200
298390,321919.6,930650,164720,168200.6,338450,133670,153719,592200
297100,297669.2,930650,165360,153336.3,338450,131740,144332.9,592200
295870,273399.2,930650,166010,138813.2,338450,129860,134586,592200
294890,263317.2,930650,164790,131854.7,338450,130100,131462.5,592200
293890,244813.8,930650,163580,116999.6,338450,130310,127814.2,592200
292820,206981.8,930650,162360,92990.6,338450,130460,113991.2,592200
291870,254332.9,930650,161140,125555.5,338450,130730,128777.4,592200
290450,247954.8,930650,159570,119183,338450,130880,128771.8,592200
288980,223602.5,930650,157980,106478.4,338450,131000,117124.1,592200
287620,218301.1,930650,156420,105677.2,338450,131200,112623.9,592200
286250,239353,930650,154870,122855.7,338450,131380,116497.3,592200
284540,226528.5,930650,153160,114088.3,338450,131380,112440.2,592200
282860,208720.7,930650,151460,98450.4,338450,131400,110270.3,592200
281250,197388.3,930650,149810,91631.1,338450,131440,105757.2,592200
279560,203641.7,930650,148100,96079,338450,131460,107562.7,592200
276750,211218,930650,146220,100891.4,338450,130530,110326.6,592200
273970,213871.4,930650,144380,102565,338450,129590,111306.4,592200
271130,224949.8,930650,142510,108148.1,338450,128620,116801.7,592200
268310,217316.9,930650,140620,101713.2,338450,127690,115603.7,592200
264910,200821.3,930650,138460,91930.3,338450,126450,108891,592200
261540,199831.6,930650,136300,91834.4,338450,125240,107997.2,592200
258130,217952.5,930650,134120,102269.7,338450,124010,115682.8,592200
254700,216570.5,930650,131970,98763.6,338450,122730,117806.9,592200
251380,188246.6,930650,129630,78413.6,338450,121750,109833,592200
248050,171236,930650,127260,67223.9,338450,120790,104012.1,592200
244690,176098.4,930650,124920,69051.6,338450,119770,107046.8,592200
241330,174447,930650,122560,66357.6,338450,118770,108089.4,592200
240920,186028.7,930650,122380,71924.1,338450,118540,114104.6,592200
240360,186796.6,930650,122190,75669.1,338450,118170,111127.5,592200
239870,177325,930650,121990,75475.6,338450,117880,101849.4,592200
239440,168914.6,930650,121830,71232.2,338450,117610,97682.4,592200
240150,166361.9,930650,121990,72108,338450,118160,94253.9,592200
240970,176429,930650,122160,80874.3,338450,118810,95554.7,592200
241670,175873.5,930650,122340,80471.4,338450,119330,95402.1,592200
242440,178922.3,930650,122510,83541.5,338450,119930,95380.8,592200
242200,167857.8,930650,122140,78456.3,338450,120060,89401.5,592200
241950,155882.4,930650,121750,67677.8,338450,120200,88204.6,592200
241700,169274.6,930650,121350,61092.8,338450,120350,108181.8,592200
241440,175213.7,930650,120970,63304.1,338450,120470,111909.6,592200
241830,176354.6,930650,120650,66134.2,338450,121180,110220.4,592200
242220,163295.8,930650,120360,58289.9,338450,121860,105005.9,592200
242640,160006.3,930650,120060,57551.1,338450,122580,102455.2,592200
243120,157472.1,930650,119760,54425.2,338450,123360,103046.9,592200
244570,156752.9,930650,119960,55990.8,338450,124610,100762.1,592200
246160,149370.5,930650,120190,50062.6,338450,125970,99307.9,592200
247640,148298.6,930650,120360,50370.9,338450,127280,97927.7,592200
249180,156025.9,930650,120550,56879.8,338450,128630,99146.1,592200
250940,164211.4,930650,120480,62152.1,338450,130460,102059.3,592200
252820,165546.4,930650,120420,63697.2,338450,132400,101849.2,592200
254580,154265.9,930650,120350,54367.6,338450,134230,99898.3,592200
256450,162195.3,930650,120280,55750,338450,136170,106445.3,592200
256600,166491.4,930650,121090,57273.9,338450,135510,109217.5,592200
256690,168662.2,930650,121900,57016,338450,134790,111646.2,592200
256890,169424,930650,122720,57954.6,338450,134170,111469.4,592200
256990,165720.9,930650,123540,56541.3,338450,133450,109179.6,592200
257170,165623.6,930650,123950,56241.8,338450,133220,109381.8,592200
257240,163187,930650,124350,56100.9,338450,132890,107086.1,592200
257340,166200.6,930650,124760,58312.6,338450,132580,107888,592200
257420,171161.7,930650,125150,59392.8,338450,132270,111768.9,592200
258450,178822.2,930650,126680,59658.2,338450,131770,119164,592200
259430,172880.6,930650,128210,54569.7,338450,131220,118310.9,592200
260510,165733.7,930650,129780,52316,338450,130730,113417.7,592200
261380,172672.9,930650,131290,58533.9,338450,130090,114139,592200
264440,185328.4,930650,132580,70589.7,338450,131860,114738.7,592200
267500,206105.9,930650,133860,85859.7,338450,133640,120246.2,592200
270510,214720.9,930650,135160,95087.9,338450,135350,119633,592200
273590,211490.3,930650,136420,92530,338450,137170,118960.3,592200
274560,212146.8,930650,136090,89302.2,338450,138470,122844.6,592200
275600,250704.9,930650,135760,109857.7,338450,139840,140847.2,592200
276640,279647.6,930650,135440,126765.8,338450,141200,152881.8,592200
277650,278810.1,930650,135090,127742.8,338450,142560,151067.3,592200
279260,285086.8,930650,135210,133704.4,338450,144050,151382.4,592200
280810,274177.7,930650,135340,118345.2,338450,145470,155832.5,592200
282350,283767.1,930650,135440,120356.7,338450,146910,163410.4,592200
283890,289336.7,930650,135550,127756.4,338450,148340,161580.3,592200
282350,288449.4,930650,133560,124807.7,338450,148790,163641.7,592200
280860,320628.4,930650,131560,144488.7,338450,149300,176139.7,592200
279310,315917.4,930650,129550,146424.9,338450,149760,169492.5,592200
277770,285082,930650,127570,127646.1,338450,150200,157435.9,592200
275980,297003.4,930650,125470,133037.2,338450,150510,163966.2,592200
274070,309603.8,930650,123350,145313,338450,150720,164290.8,592200
272270,305307.5,930650,121250,148212.1,338450,151020,157095.4,592200
270370,320758.7,930650,119140,144843.2,338450,151230,175915.5,592200
267570,310393.3,930650,116100,139034.9,338450,151470,171358.4,592200
264710,315153.3,930650,113050,138987.7,338450,151660,176165.6,592200
261900,314182.3,930650,110010,144190.6,338450,151890,169991.7,592200
259090,324564.1,930650,106970,145465.2,338450,152120,179098.9,592200
253910,337975.5,930650,103480,149937,338450,150430,188038.5,592200
248670,351367.1,930650,99990,156764.3,338450,148680,194602.8,592200
243520,347404.3,930650,96500,151058.2,338450,147020,196346.1,592200
238340,310262.3,930650,92970,128783.9,338450,145370,181478.4,592200
231610,262305.5,930650,88810,105591.7,338450,142800,156713.8,592200
224950,286775.3,930650,84650,114422.9,338450,140300,172352.4,592200
218190,281456.7,930650,80470,105253.6,338450,137720,176203.1,592200
172460,274348.2,930650,76910,103514.3,338450,95550,170833.9,592200
173540,242743.5,930650,77020,95889.5,338450,96520,146854,592200
174600,261192.1,930650,77130,108453.8,338450,97470,152738.3,592200
175690,269783.4,930650,77250,110144.4,338450,98440,159639,592200
176770,268667.8,930650,77380,114933.4,338450,99390,153734.4,592200
179780,252425,930650,77990,105304.8,338450,101790,147120.2,592200
182830,240117.7,930650,78600,95368.2,338450,104230,144749.5,592200
185800,225794.2,930650,79210,83063,338450,106590,142731.2,592200
188870,212708.5,930650,79820,71288.3,338450,109050,141420.2,592200
189570,199409.3,930650,79320,62066.9,338450,110250,137342.4,592200
190290,182528.5,930650,78800,52016.5,338450,111490,130512,592200
190950,177761.2,930650,78250,49109.3,338450,112700,128651.9,592200
191740,178463.2,930650,77770,52249.4,338450,113970,126213.8,592200
194610,171242.6,930650,79140,50108.6,338450,115470,121134,592200
197430,172840.7,930650,80470,52288.8,338450,116960,120551.9,592200
200290,193101.7,930650,81820,62051.2,338450,118470,131050.5,592200
203150,207449.2,930650,83160,70476.7,338450,119990,136972.5,592200
210410,234259.3,930650,86440,76171.7,338450,123970,158087.6,592200
217580,246990.6,930650,89700,80155.4,338450,127880,166835.2,592200
224780,246942.2,930650,92980,81473.1,338450,131800,165469.1,592200
231990,257100.6,930650,96230,86205.2,338450,135760,170895.4,592200
240100,235130.3,930650,100460,89562.3,338450,139640,145568,592200
248120,215667.1,930650,104700,80115.3,338450,143420,135551.8,592200
256270,231834.8,930650,108930,90739,338450,147340,141095.8,592200
264300,260736.2,930650,113110,102874.2,338450,151190,157862,592200
273950,268017.2,930650,118350,111636.6,338450,155600,156380.6,592200
283660,308629.2,930650,123540,125546.7,338450,160120,183082.5,592200
293370,297313.9,930650,128750,118816.4,338450,164620,178497.5,592200
303040,306684.6,930650,133960,125369.7,338450,169080,181314.9,592200
317990,323982.2,930650,139600,137202.3,338450,178390,186779.9,592200
332950,357130.9,930650,145240,152469.7,338450,187710,204661.2,592200
348020,371133.8,930650,150900,169781.1,338450,197120,201352.7,592200
362920,391340.8,930650,156540,177970.2,338450,206380,213370.6,592200
378100,404062.1,930650,162370,177716.6,338450,215730,226345.5,592200
393300,387389.8,930650,168240,163887.5,338450,225060,223502.3,592200
408530,401307.5,930650,174090,168597.5,338450,234440,232710,592200
423690,391626.4,930650,179920,164296.2,338450,243770,227330.2,592200
437790,380079.7,930650,185130,156674.5,338450,252660,223405.2,592200
451900,405572.1,930650,190350,171986.2,338450,261550,233585.9,592200
466030,402224.1,930650,195600,163349,338450,270430,238875.1,592200
480110,370910.8,930650,200810,139923.3,338450,279300,230987.5,592200
493960,385700.2,930650,206420,150564.1,338450,287540,235136.1,592200
507890,437376,930650,212040,179871.1,338450,295850,257504.9,592200
521790,476767.9,930650,217650,204324.5,338450,304140,272443.4,592200
535740,509453.6,930650,223250,223460.6,338450,312490,285993,592200
551500,565256.9,930650,229210,248373.7,338450,322290,316883.2,592200
567250,612964.6,930650,235130,274747.7,338450,332120,338216.9,592200
583090,665945.2,930650,241090,297680.3,338450,342000,368264.9,592200
598820,705378.8,930650,247040,306536.7,338450,351780,398842.1,592200
615660,715607.5,930650,253520,306910.8,338450,362140,408696.7,592200
632390,733498.3,930650,260030,308376.6,338450,372360,425121.7,592200
649140,741046.9,930650,266530,310457.2,338450,382610,430589.7,592200
665900,757515.2,930650,273010,315822.1,338450,392890,441693.1,592200
673540,778939.7,930650,273990,319724.3,338450,399550,459215.4,592200
681100,777889.5,930650,274930,322130.5,338450,406170,455759,592200
688710,783935,930650,275910,317445.9,338450,412800,466489.1,592200
696240,781994.7,930650,276860,317100.7,338450,419380,464894,592200
702700,785323.1,930650,277420,319339.9,338450,425280,465983.2,592200
709150,805992.5,930650,277960,322015.6,338450,431190,483976.9,592200
715560,804549.1,930650,278520,322337.3,338450,437040,482211.8,592200
722000,791795.3,930650,279070,322624.9,338450,442930,469170.4,592200
727780,792788.6,930650,279310,319511,338450,448470,473277.6,592200
733520,806991.8,930650,279500,320248.5,338450,454020,486743.3,592200
739300,799466.6,930650,279740,311948.8,338450,459560,487517.8,592200
745090,783726.7,930650,279940,309039.5,338450,465150,474687.2,592200
740400,755718,930650,279500,300026.1,338450,460900,455691.9,592200
735810,733185.2,930650,279050,277097.8,338450,456760,456087.4,592200
731160,684867.5,930650,278610,264919.5,338450,452550,419948,592200
726490,677094.9,930650,278160,265787.6,338450,448330,411307.3,592200
719950,651272.5,930650,276200,253769.5,338450,443750,397503,592200
713410,598871.9,930650,274250,231637.6,338450,439160,367234.3,592200
706820,594937.3,930650,272260,235071.4,338450,434560,359865.9,592200
700210,600184.2,930650,270290,242626.6,338450,429920,357557.6,592200
695380,609769.5,930650,270300,250654,338450,425080,359115.5,592200
690490,642922.2,930650,270300,271056.4,338450,420190,371865.8,592200
685640,681722.6,930650,270280,293003.6,338450,415360,388719,592200
680750,684376.6,930650,270300,293236.8,338450,410450,391139.8,592200
678940,663389.2,930650,270620,277419.1,338450,408320,385970.1,592200
677150,640032.4,930650,270930,261957.7,338450,406220,378074.7,592200
675360,654574.9,930650,271280,266809.6,338450,404080,387765.3,592200
673520,655303.5,930650,271590,268908.2,338450,401930,386395.3,592200
672410,653477.1,930650,272480,264232.5,338450,399930,389244.6,592200
671280,667034.3,930650,273350,270486.9,338450,397930,396547.4,592200
670210,717729.8,930650,274200,297646.3,338450,396010,420083.5,592200
669130,734134.6,930650,275080,303046.1,338450,394050,431088.5,592200
668810,762727.3,930650,275730,310776.2,338450,393080,451951.1,592200
668530,770330.2,930650,276410,320432,338450,392120,449898.2,592200
668300,785519.7,930650,277040,314291.1,338450,391260,471228.6,592200
668010,767569.7,930650,277730,310385.1,338450,390280,457184.6,592200
672560,760304.1,930650,278630,317056.3,338450,393930,443247.8,592200
677070,758453.5,930650,279510,314538.4,338450,397560,443915.1,592200
681590,771444.9,930650,280410,317444.5,338450,401180,454000.4,592200
686170,781491.9,930650,281280,320530.4,338450,404890,460961.5,592200
690260,789792.8,930650,282120,317996.9,338450,408140,471795.9,592200
694500,796770.4,930650,282950,318268.1,338450,411550,478502.3,592200
698620,798965.5,930650,283790,320416.7,338450,414830,478548.8,592200
769120,795302.5,930650,300600,314505.7,338450,468520,480796.8,592200
773590,808921.5,930650,301370,321457,338450,472220,487464.5,592200
778040,819820.4,930650,302140,331117.2,338450,475900,488703.2,592200
782520,831252.4,930650,302900,331605.5,338450,479620,499646.9,592200
786940,837902.6,930650,303650,328144.4,338450,483290,509758.2,592200
787380,857775.3,930650,304180,331247.5,338450,483200,526527.8,592200
787900,851073.8,930650,304710,332994.4,338450,483190,518079.4,592200
788380,850708.3,930650,305230,329802.2,338450,483150,520906.1,592200
788860,820883.5,930650,305770,320861.9,338450,483090,500021.6,592200
789220,830126.7,930650,306510,320934.1,338450,482710,509192.6,592200
789510,831810.4,930650,307200,324139,338450,482310,507671.4,592200
789870,838602.4,930650,307930,322558.3,338450,481940,516044.1,592200
790280,755073.4,930650,308650,270390.9,338450,481630,484682.5,592200
790490,828829.1,930650,309270,325365.9,338450,481220,503463.2,592200
790700,828562.5,930650,309890,322095.7,338450,480810,506466.8,592200
790870,830746.4,930650,310530,320737.9,338450,480340,510008.5,592200
791090,836481.1,930650,311140,321236.5,338450,479950,515244.6,592200
792710,834636.4,930650,311290,318908.7,338450,481420,515727.7,592200
794250,843117.7,930650,311430,323291.9,338450,482820,519825.8,592200
795820,841672.4,930650,311550,326763.8,338450,484270,514908.6,592200
797420,839524.1,930650,311730,329291.1,338450,485690,510233,592200
798910,838541.7,930650,311900,322176.9,338450,487010,516364.8,592200
800370,851692.5,930650,312050,323822.2,338450,488320,527870.3,592200
801850,829965.6,930650,312230,320468.3,338450,489620,509497.3,592200
803310,839112.8,930650,312420,319791,338450,490890,519321.8,592200
804810,851922.7,930650,312570,322354.5,338450,492240,529568.2,592200
806330,851759.4,930650,312730,321506.1,338450,493600,530253.3,592200
807800,838713.7,930650,312900,321396.1,338450,494900,517317.6,592200
809240,836385.4,930650,313060,320813.5,338450,496180,515571.9,592200
807860,839461.9,930650,312640,318238,338450,495220,521223.9,592200
806390,841747.1,930650,312200,319276.5,338450,494190,522470.6,592200
805030,837535.6,930650,311780,317750.3,338450,493250,519785.3,592200
803600,857421.9,930650,311360,322508.2,338450,492240,534913.7,592200
802090,859813.5,930650,310930,323914.1,338450,491160,535899.4,592200
800690,847140.3,930650,310530,323900,338450,490160,523240.3,592200
799280,846818.1,930650,310120,323168.2,338450,489160,523649.9,592200
797860,866483.7,930650,309710,323492.4,338450,488150,542991.3,592200
796180,856169.4,930650,309220,322543.2,338450,486960,533626.2,592200
794420,849015.7,930650,308730,321959.7,338450,485690,527056,592200
792810,861404.9,930650,308280,327680.7,338450,484530,533724.2,592200
791140,865760.7,930650,307800,329647.7,338450,483340,536113,592200
790090,862720.1,930650,307580,330157.2,338450,482510,532562.9,592200
789090,852836.2,930650,307350,327648.6,338450,481740,525187.6,592200
788000,847497.1,930650,307130,327865,338450,480870,519632.1,592200
786940,843161.4,930650,306910,325543.8,338450,480030,517617.6,592200
786080,835420,930650,306680,321146.8,338450,479400,514273.2,592200
784990,816125.4,930650,306410,324964,338450,478580,491161.4,592200
784060,812652.3,930650,306170,321968.6,338450,477890,490683.7,592200
783100,807153.7,930650,305930,320733.8,338450,477170,486419.9,592200
782050,812386.4,930650,305680,321771.7,338450,476370,490614.7,592200
781140,833243.5,930650,305480,320891.2,338450,475660,512352.3,592200
780150,825506.8,930650,305280,320572.9,338450,474870,504933.9,592200
779210,813730.7,930650,305070,315916.1,338450,474140,497814.6,592200
772730,807824.3,930650,302990,319656.5,338450,469740,488167.8,592200
766230,803305,930650,300900,320083.9,338450,465330,483221.1,592200
759770,797970.9,930650,298830,320980.9,338450,460940,476990,592200
753240,806221.4,930650,296730,319052.8,338450,456510,487168.6,592200
746600,785858.2,930650,294600,311051.6,338450,452000,474806.6,592200
740010,783172.1,930650,292500,311755.2,338450,447510,471416.9,592200
733300,774958.4,930650,290360,297570.4,338450,442940,477388,592200
726730,785910.7,930650,288240,308739.8,338450,438490,477170.9,592200
720160,765448.5,930650,286100,306743.1,338450,434060,458705.4,592200
713600,766416.8,930650,283970,306047.8,338450,429630,460369,592200
707050,748605.2,930650,281800,292348.9,338450,425250,456256.3,592200
700460,754923.2,930650,279670,307434.9,338450,420790,447488.3,592200
686390,695021.3,930650,274030,266268.8,338450,412360,428752.5,592200
672210,678821.3,930650,268390,264498,338450,403820,414323.3,592200
658120,651721.2,930650,262760,250611.7,338450,395360,401109.5,592200
644010,628660.8,930650,257110,242586.3,338450,386900,386074.5,592200
629150,602700.2,930650,251300,234900.7,338450,377850,367799.5,592200
614290,579017.5,930650,245490,230876.2,338450,368800,348141.3,592200
599370,542881.7,930650,239710,217477.3,338450,359660,325404.4,592200
584540,497661.7,930650,233920,201086,338450,350620,296575.7,592200
567890,513652.7,930650,227390,207993.5,338450,340500,305659.2,592200
551370,526014.5,930650,220900,212810.1,338450,330470,313204.4,592200
534780,523466.6,930650,214400,225721.1,338450,320380,297745.5,592200
518200,488895.6,930650,207890,208069.5,338450,310310,280826.1,592200
508390,481064.9,930650,204150,211962,338450,304240,269102.9,592200
498570,466877.3,930650,200410,212616.4,338450,298160,254260.9,592200
488810,423370,930650,196670,185273.9,338450,292140,238096.1,592200
478980,401066.6,930650,192920,176984.8,338450,286060,224081.8,592200
468410,386728.2,930650,188620,177005.9,338450,279790,209722.3,592200
457810,391662.5,930650,184300,183324.8,338450,273510,208337.7,592200
447270,372872.7,930650,180000,173469.1,338450,267270,199403.6,592200
436660,378907,930650,175660,178724.4,338450,261000,200182.6,592200
427130,393552.1,930650,171720,181835.3,338450,255410,211716.8,592200
417640,426860.9,930650,167770,189390.6,338450,249870,237470.3,592200
408090,408318.3,930650,163850,178234.2,338450,244240,230084.1,592200
398580,383378.2,930650,159910,158822.8,338450,238670,224555.4,592200
401350,394533.3,930650,158240,165699.5,338450,243110,228833.8,592200
404120,404009.5,930650,156560,173114.3,338450,247560,230895.2,592200
406900,404177.3,930650,154900,164322.4,338450,252000,239854.9,592200
409580,397123.7,930650,153220,162259.8,338450,256360,234863.9,592200
412790,372938.3,930650,151900,145538.2,338450,260890,227400.1,592200
416010,447014.3,930650,150600,173320.8,338450,265410,273693.5,592200
419190,460220,930650,149280,178297.2,338450,269910,281922.8,592200
361370,433703.5,930650,143490,162873.7,338450,217880,270829.8,592200
362410,427406,930650,140930,160548.9,338450,221480,266857.1,592200
363500,437240.9,930650,138380,158655.2,338450,225120,278585.7,592200
364550,456975.6,930650,135830,165414.6,338450,228720,291561,592200
365570,454010.3,930650,133270,157622.4,338450,232300,296387.9,592200
375200,437326.9,930650,132310,146139.7,338450,242890,291187.2,592200
384840,418888,930650,131340,130492.1,338450,253500,288395.9,592200
394420,407401.7,930650,130390,122226.1,338450,264030,285175.6,592200
404060,416450.8,930650,129440,123029.9,338450,274620,293420.9,592200
415660,420667.4,930650,128660,122978.4,338450,287000,297689,592200
427190,406756,930650,127860,114600.1,338450,299330,292155.9,592200
438810,439275.6,930650,127080,124518.7,338450,311730,314756.9,592200
450410,465470.8,930650,126290,129052.3,338450,324120,336418.5,592200
461820,479625.1,930650,125750,134872.5,338450,336070,344752.6,592200
473260,474067.9,930650,125220,133469.4,338450,348040,340598.5,592200
484650,470215.3,930650,124670,124523.2,338450,359980,345692.1,592200
496050,481313.8,930650,124140,124488.4,338450,371910,356825.4,592200
508240,476484.8,930650,133720,120942.7,338450,374520,355542.1,592200
520510,482087.9,930650,143330,119136.6,338450,377180,362951.3,592200
532710,463231.8,930650,152940,109639.6,338450,379770,353592.2,592200
545010,462710.3,930650,162540,110476.9,338450,382470,352233.4,592200
556100,452817.2,930650,171530,106149,338450,384570,346668.2,592200
567300,446191.3,930650,180540,108862.7,338450,386760,337328.6,592200
578500,450816.9,930650,189540,115740.6,338450,388960,335076.3,592200
589640,442025.5,930650,198520,106767.2,338450,391120,335258.3,592200
601020,450744.2,930650,208760,101917.8,338450,392260,348826.4,592200
612320,454596.3,930650,218970,101608.4,338450,393350,352987.9,592200
623680,464862.6,930650,229200,108084.1,338450,394480,356778.5,592200
635010,450756.9,930650,239420,105419,338450,395590,345337.9,592200
645630,451649.4,930650,248010,105900.4,338450,397620,345749,592200
656350,433685.1,930650,256650,101472.6,338450,399700,332212.5,592200
667000,422803.5,930650,265260,98188.9,338450,401740,324614.6,592200
677670,402043.4,930650,273870,101763.7,338450,403800,300279.7,592200
681910,400425.5,930650,276140,114919.2,338450,405770,285506.3,592200
686120,407567.1,930650,278450,120473.9,338450,407670,287093.2,592200
690390,429561.4,930650,280710,140203.7,338450,409680,289357.7,592200
694590,450390.6,930650,282990,149907.4,338450,411600,300483.2,592200
698550,462354,930650,285310,155749.2,338450,413240,306604.8,592200
702580,493484.1,930650,287650,177668.1,338450,414930,315816,592200
706550,506955.4,930650,289980,186671.4,338450,416570,320284,592200
710520,492047.5,930650,292300,181008.3,338450,418220,311039.2,592200
713220,497529.7,930650,292900,191305.8,338450,420320,306223.9,592200
715940,505206.2,930650,293500,199455,338450,422440,305751.2,592200
718740,500478.4,930650,294100,208235.4,338450,424640,292243,592200
721450,528386.6,930650,294700,228651.7,338450,426750,299734.9,592200
724160,567146.4,930650,295250,249968.4,338450,428910,317178,592200
726860,562187.5,930650,295840,250714.9,338450,431020,311472.6,592200
729610,533935.4,930650,296400,239087.5,338450,433210,294847.9,592200
732330,519209.9,930650,296980,236749.5,338450,435350,282460.4,592200
734780,531789.3,930650,297250,250006.1,338450,437530,281783.2,592200
737170,560936.5,930650,297540,258765.5,338450,439630,302171,592200
739600,597550.4,930650,297830,269378,338450,441770,328172.4,592200
741990,679636.8,930650,298100,288352.7,338450,443890,391284.1,592200
744020,696824.8,930650,297900,282078.9,338450,446120,414745.9,592200
746050,685265.6,930650,297720,260061.6,338450,448330,425204,592200
748040,668493.1,930650,297490,251770,338450,450550,416723.1,592200
750170,666189.5,930650,297310,261758.2,338450,452860,404431.3,592200
750980,707379.3,930650,296870,284913.3,338450,454110,422466,592200
751790,757323.5,930650,296440,303231.9,338450,455350,454091.6,592200
752700,798702.2,930650,296010,316835.2,338450,456690,481867,592200
753540,816028.2,930650,295580,320567.7,338450,457960,495460.5,592200
752970,830827.3,930650,294020,317103.1,338450,458950,513724.2,592200
752470,831102.2,930650,292450,316280.7,338450,460020,514821.5,592200
751950,820945.6,930650,290900,314531.3,338450,461050,506414.3,592200
751350,814922.6,930650,289330,312717.7,338450,462020,502204.9,592200
740830,814798.6,930650,281530,315564.1,338450,459300,499234.5,592200
730260,823464.4,930650,273740,319668,338450,456520,503796.4,592200
719690,832903.9,930650,265970,324807.2,338450,453720,508096.7,592200
709130,837762.6,930650,258160,327025.4,338450,450970,510737.2,592200
699160,848319.5,930650,250760,328993.6,338450,448400,519325.9,592200
689160,847822.9,930650,243370,329397.5,338450,445790,518425.4,592200
679210,828732.5,930650,235990,324976.9,338450,443220,503755.6,592200
669230,817050.5,930650,228600,318922.2,338450,440630,498128.3,592200
661000,820046.3,930650,222300,321308.3,338450,438700,498738,592200
652790,827600,930650,215960,322019.7,338450,436830,505580.3,592200
644600,830300.8,930650,209690,321638,338450,434910,508662.8,592200
636360,811757.2,930650,203380,312580.7,338450,432980,499176.5,592200
626170,815073.4,930650,200240,311163.8,338450,425930,503909.6,592200
615850,813669.8,930650,197100,309989.5,338450,418750,503680.3,592200
605640,814790,930650,193960,306349.8,338450,411680,508440.2,592200
595320,810559.1,930650,190840,303919.6,338450,404480,506639.5,592200
588150,786910.7,930650,191370,297724.5,338450,396780,489186.2,592200
580940,755112.9,930650,191940,274942.7,338450,389000,480170.2,592200
573770,725376.6,930650,192480,267601.3,338450,381290,457775.3,592200
566620,729805.1,930650,193060,284499.9,338450,373560,445305.2,592200
562040,682919.6,930650,194180,276435.6,338450,367860,406484,592200
557340,616727.6,930650,195290,248555.6,338450,362050,368172,592200
552790,621462.3,930650,196420,249185.2,338450,356370,372277.1,592200
548150,591308.6,930650,197540,236436.6,338450,350610,354872,592200
548810,599981.2,930650,198600,241361.7,338450,350210,358619.5,592200
549520,582341.9,930650,199710,230105.1,338450,349810,352236.8,592200
550210,547222.7,930650,200810,210581.2,338450,349400,336641.5,592200
550900,586661.1,930650,201890,230638.9,338450,349010,356022.2,592200
550400,601769,930650,202470,228394.8,338450,347930,373374.2,592200
550000,564073.6,930650,203030,208099.8,338450,346970,355973.8,592200
549560,533640.4,930650,203630,185339.6,338450,345930,348300.8,592200
709680,512120.4,930650,282070,169006.1,338450,427610,343114.3,592200
700280,518499.2,930650,280090,174561.1,338450,420190,343938.1,592200
690920,501366.9,930650,278140,168106.7,338450,412780,333260.2,592200
681550,504524.8,930650,276170,171570.6,338450,405380,332954.2,592200
672180,525532.2,930650,274220,183968.4,338450,397960,341563.8,592200
662590,534978.7,930650,271220,185560.1,338450,391370,349418.6,592200
652940,520699.1,930650,268220,178547.7,338450,384720,342151.4,592200
643300,564270,930650,265190,197174.6,338450,378110,367095.4,592200
633710,566789.3,930650,262190,201210.3,338450,371520,365579,592200
624690,553997.1,930650,259320,197927.3,338450,365370,356069.8,592200
615710,531385.2,930650,256460,186111.8,338450,359250,345273.4,592200
606730,555305.5,930650,253600,186420.1,338450,353130,368885.4,592200
597690,592151.4,930650,250720,209403.9,338450,346970,382747.5,592200
590010,625988.6,930650,249170,231553.5,338450,340840,394435.1,592200
582240,678778.7,930650,247570,269808.7,338450,334670,408970,592200
574550,673800.8,930650,245970,248851.4,338450,328580,424949.4,592200
566870,673294.5,930650,244390,250324.6,338450,322480,422969.9,592200
563410,637116.7,930650,242400,232660.1,338450,321010,404456.6,592200
559900,615982.7,930650,240370,214728,338450,319530,401254.7,592200
556470,639791.8,930650,238370,220193.8,338450,318100,419598,592200
552890,596538,930650,236330,194128.7,338450,316560,402409.3,592200
552640,471313.4,930650,236830,133408.8,338450,315810,337904.6,592200
552310,454304.3,930650,237300,130987.5,338450,315010,323316.8,592200
552000,388274.8,930650,237770,84823.6,338450,314230,303451.2,592200
551700,396157.1,930650,238260,91343.1,338450,313440,304814,592200
548780,426636.4,930650,237730,108449,338450,311050,318187.4,592200
545900,436383.2,930650,237200,112373.4,338450,308700,324009.8,592200
542990,410283.2,930650,236650,103434.2,338450,306340,306849,592200
540050,419412.6,930650,236080,118138.1,338450,303970,301274.5,592200
546190,428315.8,930650,237190,135895.5,338450,309000,292420.3,592200
552270,430005.8,930650,238260,152199.4,338450,314010,277806.4,592200
558390,406753,930650,239350,155981.6,338450,319040,250771.4,592200
564560,414298.7,930650,240440,165656.7,338450,324120,248642,592200
569420,409632,930650,240190,165658.8,338450,329230,243973.2,592200
574350,425028.5,930650,239940,179253.1,338450,334410,245775.4,592200
579240,461770.3,930650,239670,191673,338450,339570,270097.3,592200
584150,507313.5,930650,239460,222213.1,338450,344690,285100.4,592200
591320,535910.2,930650,240670,246624.4,338450,350650,289285.8,592200
598410,544946.7,930650,241910,257156,338450,356500,287790.7,592200
605540,564272.6,930650,243120,271561.8,338450,362420,292710.8,592200
612700,575196.7,930650,244350,275961.3,338450,368350,299235.4,592200
628100,600771.9,930650,249860,282768.2,338450,378240,318003.7,592200
643520,623256.9,930650,255370,288508.1,338450,388150,334748.8,592200
658940,639085.8,930650,260850,286714.3,338450,398090,352371.5,592200
674330,653519.5,930650,266340,282602.7,338450,407990,370916.8,592200
689850,713212.7,930650,272080,300294.1,338450,417770,412918.6,592200
705290,757344.8,930650,277820,307805.4,338450,427470,449539.4,592200
720790,772522.2,930650,283530,312662.9,338450,437260,459859.3,592200
736280,797156.1,930650,289280,316944.6,338450,447000,480211.5,592200
750680,798858.9,930650,294200,309978.7,338450,456480,488880.2,592200
765190,775590.7,930650,299130,293650.4,338450,466060,481940.3,592200
779550,776744.9,930650,304040,294649.9,338450,475510,482095,592200
794000,795913.8,930650,308990,311131.6,338450,485010,484782.2,592200
797980,823559.5,930650,309890,317055.3,338450,488090,506504.2,592200
801950,833715.1,930650,310780,316549.1,338450,491170,517166,592200
805930,839833.6,930650,311680,319679.7,338450,494250,520153.9,592200
809950,829717.4,930650,312580,322826.3,338450,497370,506891.1,592200
813780,835336,930650,313490,323150.4,338450,500290,512185.6,592200
817600,847584.6,930650,314390,320081.1,338450,503210,527503.5,592200
821490,832770.9,930650,315280,320241.9,338450,506210,512529,592200
825320,830108.2,930650,316200,316517.3,338450,509120,513590.9,592200
829080,829593,930650,317040,317725.5,338450,512040,511867.5,592200
832900,836576,930650,317860,316119.8,338450,515040,520456.2,592200
836690,827239.3,930650,318690,304012.1,338450,518000,523227.2,592200
840420,841074.3,930650,319530,314868.9,338450,520890,526205.4,592200
840940,834919.2,930650,319740,317133.6,338450,521200,517785.6,592200
841360,846503.6,930650,319960,319439.6,338450,521400,527064,592200
841830,852081.6,930650,320190,320670.2,338450,521640,531411.4,592200
842370,854770.2,930650,320400,321177.8,338450,521970,533592.4,592200
842730,865144.9,930650,320590,322301.3,338450,522140,542843.6,592200
843110,834152.3,930650,320780,312758.9,338450,522330,521393.4,592200
843510,835826.6,930650,320970,304018.2,338450,522540,531808.4,592200
843900,834842.8,930650,321160,306657,338450,522740,528185.8,592200
844110,814854.3,930650,321280,306559.3,338450,522830,508295,592200
844420,811746.9,930650,321440,305684.4,338450,522980,506062.5,592200
844750,791204.9,930650,321580,295882.3,338450,523170,495322.6,592200
845060,810529.1,930650,321710,302741.1,338450,523350,507788,592200
841950,811688.5,930650,320750,302409.3,338450,521200,509279.2,592200
838850,806203.5,930650,319770,302392.5,338450,519080,503811,592200
835830,798495.6,930650,318800,300110.4,338450,517030,498385.2,592200
832760,804581.4,930650,317810,304185.7,338450,514950,500395.7,592200
829630,786346.4,930650,316880,300785.4,338450,512750,485561,592200
826430,798133,930650,315910,300433.2,338450,510520,497699.8,592200
823330,785851.3,930650,314960,293876.8,338450,508370,491974.5,592200
820180,766757.1,930650,314000,295299.3,338450,506180,471457.8,592200
817010,760608.7,930650,312970,298403.8,338450,504040,462204.9,592200
813820,766761.8,930650,311950,299969.9,338450,501870,466791.9,592200
810660,770579.5,930650,310960,300268.2,338450,499700,470311.3,592200
807490,729889.8,930650,309960,287617.8,338450,497530,442272,592200
800980,740195.1,930650,308000,287291.2,338450,492980,452903.9,592200
794520,755015.4,930650,306020,293974.2,338450,488500,461041.2,592200
788000,746126.4,930650,304080,289276.6,338450,483920,456849.8,592200
781520,732532.6,930650,302130,290735.9,338450,479390,441796.7,592200
774080,727138.2,930650,299570,283612.8,338450,474510,443525.4,592200
766620,696077.4,930650,297060,273419.3,338450,469560,422658.1,592200
759200,672277.1,930650,294520,262805.8,338450,464680,409471.3,592200
682690,684308,930650,264590,265325.8,338450,418100,418982.2,592200
670540,705396.6,930650,260280,270276.7,338450,410260,435119.9,592200
658460,689685.6,930650,255990,257456.7,338450,402470,432228.9,592200
646380,667345.9,930650,251700,243657.4,338450,394680,423688.5,592200
634260,621011.5,930650,247410,222394,338450,386850,398617.5,592200
620770,608619,930650,242020,224573.7,338450,378750,384045.3,592200
607290,624715.5,930650,236670,243525.9,338450,370620,381189.6,592200
593810,612281.5,930650,231320,250920.9,338450,362490,361360.6,592200
580310,594355.3,930650,225950,247257.9,338450,354360,347097.4,592200
566880,589319.3,930650,220250,232078.9,338450,346630,357240.4,592200
553500,591790.9,930650,214590,220684.7,338450,338910,371106.2,592200
540110,575021.9,930650,208880,209810.1,338450,331230,365211.8,592200
526670,562694.5,930650,203200,201355,338450,323470,361339.5,592200
516490,531363.5,930650,199870,202033.7,338450,316620,329329.8,592200
506330,522130.8,930650,196550,198156.5,338450,309780,323974.3,592200
496150,491018.9,930650,193210,178996.7,338450,302940,312022.2,592200
486000,497766.3,930650,189880,183537.8,338450,296120,314228.5,592200
486120,515838.4,930650,191750,195584.1,338450,294370,320254.3,592200
486330,501279.6,930650,193620,190849,338450,292710,310430.6,592200
486550,477505.7,930650,195490,166379.4,338450,291060,311126.3,592200
486730,443091.5,930650,197390,145629.7,338450,289340,297461.8,592200
486360,451086,930650,198910,135418.4,338450,287450,315667.6,592200
485950,438141.1,930650,200430,131288.2,338450,285520,306852.9,592200
485520,474673.9,930650,201950,160378.9,338450,283570,314295,592200
485110,478645.4,930650,203470,177992.3,338450,281640,300653.1,592200
483510,460867.3,930650,204560,169529.4,338450,278950,291337.9,592200
481740,463814.3,930650,205620,177716.6,338450,276120,286097.7,592200
480030,489130.9,930650,206690,197790.2,338450,273340,291340.7,592200
478320,458942.9,930650,207770,199574.1,338450,270550,259368.8,592200
489550,517882.3,930650,212310,230009.1,338450,277240,287873.2,592200
500720,480999.8,930650,216860,209467.9,338450,283860,271531.9,592200
511870,466505.3,930650,221390,189675.4,338450,290480,276829.9,592200
523090,494032.7,930650,225950,203670.6,338450,297140,290362.1,592200
535180,498923,930650,230400,215535.6,338450,304780,283387.4,592200
547290,518448.3,930650,234850,229127,338450,312440,289321.3,592200
559360,552554.3,930650,239290,245256.6,338450,320070,307297.7,592200
571440,560756.4,930650,243730,247500.1,338450,327710,313256.3,592200
584810,586245.4,930650,248680,256809.4,338450,336130,329436,592200
598110,586422.8,930650,253630,248722.4,338450,344480,337700.4,592200
611470,569861.7,930650,258560,233188,338450,352910,336673.7,592200
624800,577579.1,930650,263510,241957.4,338450,361290,335621.7,592200
633090,619910.7,930650,264650,262482.4,338450,368440,357428.3,592200
641380,638922.1,930650,265800,269053.2,338450,375580,369868.9,592200
649610,632976.3,930650,266940,268048.4,338450,382670,364927.9,592200
657860,644120.6,930650,268060,274611,338450,389800,369509.6,592200
668000,618137,930650,269770,261367,338450,398230,356770,592200
678130,608217.9,930650,271500,250369.6,338450,406630,357848.3,592200
688290,619264.9,930650,273200,253947,338450,415090,365317.9,592200
698460,624856.6,930650,274910,260181.2,338450,423550,364675.4,592200
707210,629403.5,930650,276310,250375.3,338450,430900,379028.2,592200
715930,635366.4,930650,277710,257384.9,338450,438220,377981.5,592200
724770,668183.4,930650,279130,280136.4,338450,445640,388047,592200
733530,655373.3,930650,280530,272735.3,338450,453000,382638,592200
732310,629749.3,930650,280190,248187.6,338450,452120,381561.7,592200
731230,654162.6,930650,279850,263903.4,338450,451380,390259.2,592200
730040,672552.6,930650,279510,276786.8,338450,450530,395765.8,592200
728870,705399.8,930650,279190,289295.7,338450,449680,416104.1,592200
727600,731945.2,930650,279050,291741.4,338450,448550,440203.8,592200
726370,755242.8,930650,278960,304166.2,338450,447410,451076.6,592200
725130,756225.4,930650,278860,310633.8,338450,446270,445591.6,592200
723900,750471.6,930650,278730,307420.8,338450,445170,443050.8,592200
720780,743818.4,930650,277870,294688.5,338450,442910,449129.9,592200
717700,710419.9,930650,277030,279353.6,338450,440670,431066.3,592200
714550,707036.3,930650,276170,267559.5,338450,438380,439476.8,592200
711470,751087.6,930650,275320,290300.7,338450,436150,460786.9,592200
715970,773292.1,930650,276940,300183.3,338450,439030,473108.8,592200
720420,788211,930650,278540,310369.1,338450,441880,477841.9,592200
724920,777263.4,930650,280160,308489.9,338450,444760,468773.5,592200
729340,771553.6,930650,281780,307931.5,338450,447560,463622.1,592200
734600,788541.6,930650,283020,305653.5,338450,451580,482888.1,592200
739770,781715.8,930650,284240,302319.7,338450,455530,479396.1,592200
744960,788104.6,930650,285500,302327.9,338450,459460,485776.7,592200
750140,799585.5,930650,286740,305725.9,338450,463400,493859.6,592200
756810,805837,930650,288380,308502.3,338450,468430,497334.7,592200
763360,817701,930650,289990,307072.4,338450,473370,510628.6,592200
769990,832589.3,930650,291600,311000.8,338450,478390,521588.5,592200
776640,837880.8,930650,293230,313075.8,338450,483410,524805,592200
779200,850313.6,930650,293340,314832.6,338450,485860,535481,592200
781730,857862.1,930650,293440,321007.2,338450,488290,536854.9,592200
784250,875043.7,930650,293560,325027.7,338450,490690,550016,592200
786830,881936.2,930650,293670,326321.7,338450,493160,555614.5,592200
790520,881045.6,930650,295190,326763.9,338450,495330,554281.7,592200
794390,874536.2,930650,296710,326181,338450,497680,548355.2,592200
798160,880926.2,930650,298230,324344.2,338450,499930,556582,592200
801920,872694.6,930650,299740,325898.7,338450,502180,546795.9,592200
805740,862751.2,930650,301400,325453.2,338450,504340,537298,592200
809530,864010,930650,303050,324669.8,338450,506480,539340.2,592200
813330,856114.5,930650,304740,318734.6,338450,508590,537379.9,592200
817160,841948.9,930650,306410,317701.3,338450,510750,524247.6,592200
818480,820688.8,930650,307720,309527.4,338450,510760,511161.4,592200
819850,826233.1,930650,309060,307551.4,338450,510790,518681.7,592200
821140,824422.3,930650,310360,306952.3,338450,510780,517470,592200
822430,833609.3,930650,311670,308302.4,338450,510760,525306.9,592200
824520,814526.3,930650,313220,306443.6,338450,511300,508082.7,592200
826650,829131.9,930650,314790,307590.4,338450,511860,521541.5,592200
828780,819336.9,930650,316360,307575.5,338450,512420,511761.4,592200
831000,838539.6,930650,317180,309756.3,338450,513820,528783.3,592200
828640,820992.7,930650,316500,309479,338450,512140,511513.7,592200
826160,822521.8,930650,315800,309005.4,338450,510360,513516.4,592200
823800,838915.2,930650,315130,310021.8,338450,508670,528893.4,592200
821440,790935.4,930650,314440,306690.1,338450,507000,484245.3,592200
813820,774843.4,930650,312300,306114.1,338450,501520,468729.3,592200
806310,758037.3,930650,310180,304117.5,338450,496130,453919.8,592200
798630,734682.7,930650,308050,298304.3,338450,490580,436378.4,592200
791090,730667.5,930650,305940,295698.9,338450,485150,434968.6,592200
783440,701777.7,930650,303610,288996.1,338450,479830,412781.6,592200
775680,713351.2,930650,301260,287375.6,338450,474420,425975.6,592200
768010,729156.4,930650,298900,291379.4,338450,469110,437777,592200
760290,707893.9,930650,296550,285131.9,338450,463740,422762,592200
752330,706295.5,930650,294170,284648.4,338450,458160,421647.1,592200
744270,693744.6,930650,291770,288105.9,338450,452500,405638.7,592200
736320,697393.3,930650,289360,293359.6,338450,446960,404033.7,592200
728430,697192.6,930650,286980,294215.5,338450,441450,402977.1,592200
718490,692212.9,930650,283490,286711.6,338450,435000,405501.3,592200
708600,695216.6,930650,280000,289493,338450,428600,405723.6,592200
698730,659612.1,930650,276540,280433.7,338450,422190,379178.4,592200
688800,660967.7,930650,273040,282408.4,338450,415760,378559.3,592200
678900,654541.1,930650,269260,273801.1,338450,409640,380740,592200
668880,647731.3,930650,265440,269053.6,338450,403440,378677.7,592200
658910,637854.1,930650,261650,265801.4,338450,397260,372052.7,592200
648940,636809.9,930650,257850,256979.8,338450,391090,379830.1,592200
638600,623311.7,930650,253480,258361,338450,385120,364950.7,592200
628220,642225.8,930650,249100,267367.7,338450,379120,374858.1,592200
617930,649046.8,930650,244730,270529.7,338450,373200,378517.1,592200
607570,618645.1,930650,240350,258191.4,338450,367220,360453.7,592200
591800,566360.3,930650,233530,232523.9,338450,358270,333836.4,592200
576040,525640.2,930650,226660,216056.4,338450,349380,309583.8,592200
560180,529577.9,930650,219830,217544.9,338450,340350,312033,592200
544420,538382.3,930650,212960,217958.8,338450,331460,320423.5,592200
530440,513083.8,930650,206470,192290.4,338450,323970,320793.4,592200
516440,471324.7,930650,199950,172352.6,338450,316490,298972.1,592200
502520,434167.4,930650,193440,149857.9,338450,309080,284309.5,592200
488480,435282.5,930650,186920,156162.5,338450,301560,279120,592200
476140,466777,930650,181710,178094.2,338450,294430,288682.8,592200
463720,430230.3,930650,176520,161639.5,338450,287200,268590.8,592200
451340,392144.5,930650,171310,149464.5,338450,280030,242680,592200
438920,388373.7,930650,166100,140819.7,338450,272820,247554,592200
441400,394854.1,930650,164850,133727.7,338450,276550,261126.4,592200
443810,380941.7,930650,163600,124869.7,338450,280210,256072,592200
446240,349915.7,930650,162350,101458.9,338450,283890,248456.8,592200
448670,344095.5,930650,161090,93445.3,338450,287580,250650.2,592200
450480,353997.6,930650,160140,92662.7,338450,290340,261334.9,592200
452380,345975,930650,159230,90348.7,338450,293150,255626.3,592200
454190,403435.6,930650,158280,105309.5,338450,295910,298126.1,592200
456070,400425.2,930650,157330,103054.5,338450,298740,297370.7,592200
457330,448757.3,930650,157040,145225.7,338450,300290,303531.6,592200
458680,552240.8,930650,156750,206787.8,338450,301930,345453,592200
460040,474296.8,930650,156470,163544.2,338450,303570,310752.6,592200
461310,370168.4,930650,156160,94808.5,338450,305150,275359.9,592200
478890,344105,930650,162500,78641.2,338450,316390,265463.8,592200
496440,439030.9,930650,168850,144880.3,338450,327590,294150.6,592200
513960,419226.3,930650,175170,118398.9,338450,338790,300827.4,592200
531500,442500.5,930650,181490,121536.8,338450,350010,320963.7,592200
547600,421803,930650,187510,110051.9,338450,360090,311751.1,592200
563780,437139.5,930650,193560,114382.6,338450,370220,322756.9,592200
579900,475831.5,930650,199580,132233.8,338450,380320,343597.7,592200
596030,531636.9,930650,205600,167717.4,338450,390430,363919.5,592200
611260,659432.9,930650,211150,253541.3,338450,400110,405891.6,592200
626600,663805.6,930650,216690,245584.4,338450,409910,418221.2,592200
641920,566464.1,930650,222230,166946.6,338450,419690,399517.5,592200
657120,522985.6,930650,227760,150445.7,338450,429360,372539.9,592200
650470,544537.5,930650,226220,174585.5,338450,424250,369952,592200
643750,591459.1,930650,224660,188532.6,338450,419090,402926.5,592200
637140,618660.2,930650,223130,224792.2,338450,414010,393868,592200
630410,606078.6,930650,221580,229600.2,338450,408830,376478.4,592200
623870,574394,930650,218980,196983.6,338450,404890,377410.4,592200
617250,559578.8,930650,216400,195934.5,338450,400850,363644.3,592200
610620,587054.4,930650,213800,223049.2,338450,396820,364005.2,592200
604030,628878.1,930650,211220,255050.4,338450,392810,373827.7,592200
599290,658601.4,930650,211080,268180.4,338450,388210,390421,592200
594530,662049.3,930650,210960,271498.8,338450,383570,390550.5,592200
589810,657702.4,930650,210830,265792.9,338450,378980,391909.5,592200
584970,659466,930650,210690,263637.9,338450,374280,395828.1,592200
573560,628260.5,930650,206110,255852.4,338450,367450,372408.1,592200
562210,606306.5,930650,201540,247117.9,338450,360670,359188.6,592200
550840,586135.7,930650,196960,226987.1,338450,353880,359148.6,592200
539420,583486.1,930650,192370,223973.6,338450,347050,359512.5,592200
528140,552367.5,930650,187850,195333.2,338450,340290,357034.3,592200
516870,526220.7,930650,183310,178321.4,338450,333560,347899.3,592200
505610,440031.2,930650,178810,131562.2,338450,326800,308469,592200
494360,432760.2,930650,174300,115411.6,338450,320060,317348.6,592200
481650,472916.4,930650,169550,148113.9,338450,312100,324802.5,592200
468940,473195.8,930650,164820,150138.2,338450,304120,323057.6,592200
456330,439638,930650,160080,131991.9,338450,296250,307646.1,592200
443620,418066.2,930650,155330,123420.5,338450,288290,294645.7,592200
426330,381985.9,930650,148360,109696.5,338450,277970,272289.4,592200
409080,417261.1,930650,141390,124554.7,338450,267690,292706.4,592200
391920,382003.2,930650,134430,101659.2,338450,257490,280344,592200
374680,372378.3,930650,127460,89118.3,338450,247220,283260,592200
356570,368026.1,930650,120550,84245.9,338450,236020,283780.2,592200
338420,348551.6,930650,113640,78118.9,338450,224780,270432.7,592200
320390,344219.7,930650,106730,68388.7,338450,213660,275831,592200
410620,328970.4,930650,126690,61980.3,338450,283930,266990.1,592200
393020,288536.6,930650,117070,55915.7,338450,275950,232620.9,592200
375450,286456.4,930650,107470,63118.9,338450,267980,223337.5,592200
357920,299222.3,930650,97890,68747.2,338450,260030,230475.1,592200
340280,299926,930650,88270,74918.1,338450,252010,225007.9,592200
323940,303692.4,930650,83250,77746.6,338450,240690,225945.8,592200
307570,276882.9,930650,78160,66718,338450,229410,210164.9,592200
291130,237443.3,930650,73110,56149.5,338450,218020,181293.8,592200
274750,225450,930650,68050,54691.1,338450,206700,170758.9,592200
258070,209250.3,930650,62960,49673.1,338450,195110,159577.2,592200
241250,204328.9,930650,57880,44239.4,338450,183370,160089.5,592200
224490,206665,930650,52770,44878.4,338450,171720,161786.6,592200
207760,193566.2,930650,47700,41752.2,338450,160060,151814,592200
191970,189766.1,930650,42950,36600,338450,149020,153166.1,592200
176230,184321.9,930650,38210,36384.6,338450,138020,147937.3,592200
160490,179896.6,930650,33450,40926.8,338450,127040,138969.8,592200
144760,183451.5,930650,28730,43211.4,338450,116030,140240.1,592200
139620,185431.7,930650,28540,46092.2,338450,111080,139339.5,592200
134480,171694.9,930650,28380,36558,338450,106100,135136.9,592200
129320,183546.3,930650,28200,41398.2,338450,101120,142148.1,592200
124140,174623.9,930650,28010,41531.6,338450,96130,133092.3,592200
119500,198272.5,930650,27890,56039.1,338450,91610,142233.4,592200
114880,198412.5,930650,27800,61558.6,338450,87080,136853.9,592200
110190,156618.4,930650,27670,52286,338450,82520,104332.4,592200
105620,145425,930650,27590,48771.4,338450,78030,96653.6,592200
102470,166292.2,930650,28420,41870.6,338450,74050,124421.6,592200
99310,182339.8,930650,29260,52074.6,338450,70050,130265.2,592200
96230,196921.5,930650,30100,62977.2,338450,66130,133944.3,592200
93140,187934.2,930650,30940,60411.4,338450,62200,127522.8,592200
106410,180076.9,930650,39440,59401.5,338450,66970,120675.4,592200
119740,183516.6,930650,47950,60823.6,338450,71790,122693,592200
133140,191969.6,930650,56460,64763.2,338450,76680,127206.4,592200
146480,194104,930650,64970,66175.8,338450,81510,127928.2,592200
160320,183702.2,930650,73500,60979.7,338450,86820,122722.5,592200
174200,190473.2,930650,82030,63956.6,338450,92170,126516.6,592200
187960,199014.2,930650,90520,70281.1,338450,97440,128733.1,592200
201830,203279,930650,99060,84536.1,338450,102770,118742.9,592200
216650,251559.4,930650,108250,111342.5,338450,108400,140216.9,592200
231440,284454.9,930650,117460,124405,338450,113980,160049.9,592200
246220,267137.4,930650,126650,116644.1,338450,119570,150493.3,592200
261060,294862,930650,135870,128974.9,338450,125190,165887.1,592200
283830,386134.3,930650,144720,186420.6,338450,139110,199713.7,592200
306740,391241.3,930650,153590,186401.7,338450,153150,204839.6,592200
329580,375167.2,930650,162470,177533.2,338450,167110,197634,592200
352380,408284.5,930650,171340,200976.9,338450,181040,207307.6,592200
376590,435149.1,930650,181550,219093.4,338450,195040,216055.7,592200
400720,450488.9,930650,191750,223143.8,338450,208970,227345.1,592200
424870,472759.4,930650,201960,228709.9,338450,222910,244049.5,592200
449100,483570.6,930650,212170,230858.7,338450,236930,252711.9,592200
475350,510384.9,930650,222750,242623.4,338450,252600,267761.5,592200
501590,550292.7,930650,233360,263300.5,338450,268230,286992.2,592200
527920,594012.1,930650,243960,285591.3,338450,283960,308420.8,592200
554180,631376.3,930650,254560,298943.8,338450,299620,332432.5,592200
564330,663419.1,930650,256420,300474.6,338450,307910,362944.5,592200
574360,681043.1,930650,258280,298421.7,338450,316080,382621.4,592200
584410,697291.9,930650,260150,296431.1,338450,324260,400860.8,592200
594460,700145.1,930650,262000,299394.7,338450,332460,400750.4,592200
603040,700602.8,930650,263200,297818.2,338450,339840,402784.6,592200
611600,701242.2,930650,264360,298784.9,338450,347240,402457.3,592200
620270,689892.5,930650,265570,288701.1,338450,354700,401191.4,592200
628790,683744.4,930650,266760,282254,338450,362030,401490.4,592200
636460,677363.9,930650,267620,284789.4,338450,368840,392574.5,592200
644050,681415.1,930650,268450,290303.5,338450,375600,391111.6,592200
651720,663412.1,930650,269300,280281.1,338450,382420,383131,592200
659360,658050.4,930650,270140,278526.3,338450,389220,379524.1,592200
657380,645511,930650,269650,267491.5,338450,387730,378019.5,592200
655420,663445.9,930650,269170,281160,338450,386250,382285.9,592200
653530,669616.3,930650,268680,284690.8,338450,384850,384925.5,592200
651590,666500.5,930650,268220,287825,338450,383370,378675.5,592200
650050,632523.9,930650,268430,272989.8,338450,381620,359534.1,592200
648490,628264.2,930650,268650,271162.2,338450,379840,357102,592200
646940,610389.3,930650,268860,264859.1,338450,378080,345530.2,592200
645360,624994.8,930650,269090,275933.4,338450,376270,349061.4,592200
644710,630495.8,930650,269320,282360.5,338450,375390,348135.3,592200
644120,607749.7,930650,269540,269272.5,338450,374580,338477.2,592200
643420,605663.4,930650,269740,269251.3,338450,373680,336412.1,592200
642800,620913.3,930650,269970,273933.4,338450,372830,346979.9,592200
646200,605504,930650,271570,263043.7,338450,374630,342460.3,592200
649550,584681.4,930650,273150,252573.3,338450,376400,332108.1,592200
652880,569178.6,930650,274740,237239.4,338450,378140,331939.2,592200
656300,610544.2,930650,276310,257570.6,338450,379990,352973.6,592200
659690,634797.9,930650,277840,267736.2,338450,381850,367061.7,592200
663180,636485.8,930650,279350,271510.3,338450,383830,364975.5,592200
666630,633950.7,930650,280880,275085.9,338450,385750,358864.8,592200
670070,612419.3,930650,282410,260648.1,338450,387660,351771.2,592200
673250,569670.4,930650,283450,228629.6,338450,389800,341040.8,592200
676300,558514.9,930650,284500,216761.4,338450,391800,341753.5,592200
679460,586427.6,930650,285570,236566.6,338450,393890,349861,592200
682570,611834.7,930650,286620,257640.2,338450,395950,354194.5,592200
684610,627066.6,930650,287030,271450.9,338450,397580,355615.7,592200
686530,593656.4,930650,287420,248702.8,338450,399110,344953.6,592200
688530,570279.6,930650,287830,232521.8,338450,400700,337757.8,592200
690540,593924.2,930650,288240,248711.4,338450,402300,345212.8,592200
692300,616640.6,930650,288570,259954.9,338450,403730,356685.7,592200
694060,641016.9,930650,288880,277077.8,338450,405180,363939.1,592200
695830,646800,930650,289220,282862.9,338450,406610,363937.1,592200
656270,645746.4,930650,280570,280368.6,338450,375700,365377.8,592200
657880,641042.2,930650,281300,285028,338450,376580,356014.2,592200
659510,597272,930650,282040,262850.6,338450,377470,334421.4,592200
661090,609683.7,930650,282800,266015.9,338450,378290,343667.8,592200
662790,620725.4,930650,283540,272237.8,338450,379250,348487.6,592200
662710,631295.5,930650,283410,274371,338450,379300,356924.5,592200
662740,644698.9,930650,283290,278900,338450,379450,365798.9,592200
662760,631941.9,930650,283180,269386.4,338450,379580,362555.5,592200
662750,645343.1,930650,283070,280961.6,338450,379680,364381.5,592200
662070,669228.9,930650,282660,299944.1,338450,379410,369284.8,592200
661470,642495.4,930650,282260,278636.8,338450,379210,363858.6,592200
660840,652901,930650,281880,269993.8,338450,378960,382907.2,592200
660230,681988.1,930650,281510,283451.8,338450,378720,398536.3,592200
658700,702949.2,930650,280220,296329.3,338450,378480,406619.9,592200
657170,670974,930650,278930,289860.2,338450,378240,381113.8,592200
655620,669446.7,930650,277620,288897.6,338450,378000,380549.1,592200
654110,683078.4,930650,276370,297805.7,338450,377740,385272.7,592200
656520,675869.6,930650,277560,300372.3,338450,378960,375497.3,592200
658950,686017.7,930650,278770,301248,338450,380180,384769.7,592200
661410,688343.5,930650,280000,296993,338450,381410,391350.5,592200
663820,678497.2,930650,281210,294976.7,338450,382610,383520.5,592200
665050,673887.3,930650,281650,290237.5,338450,383400,383649.8,592200
666280,690322.7,930650,282070,292115.4,338450,384210,398207.3,592200
667520,696158.1,930650,282520,291430.7,338450,385000,404727.4,592200
668760,710269.5,930650,282950,293793.1,338450,385810,416476.4,592200
670780,700840.5,930650,283630,293500.9,338450,387150,407339.6,592200
672770,703031.7,930650,284290,293536.6,338450,388480,409495.1,592200
674850,697612,930650,284970,296061.3,338450,389880,401550.7,592200
676860,707138.5,930650,285630,298528.3,338450,391230,408610.2,592200
680930,690925.5,930650,286410,290591.4,338450,394520,400334.1,592200
684890,683245.1,930650,287200,291002,338450,397690,392243.1,592200
688900,668725.5,930650,287970,289282.7,338450,400930,379442.8,592200
692920,674104.7,930650,288760,286255.4,338450,404160,387849.3,592200
696050,692874.8,930650,289210,295305,338450,406840,397569.8,592200
699320,727051.2,930650,289660,301461.3,338450,409660,425589.9,592200
702430,737118,930650,290110,302344.1,338450,412320,434773.9,592200
705670,727084.9,930650,290580,300460.6,338450,415090,426624.3,592200
709520,757969.3,930650,291400,311296.1,338450,418120,446673.2,592200
713520,756017.7,930650,292250,309632.7,338450,421270,446385,592200
717460,749579.7,930650,293080,309295.1,338450,424380,440284.6,592200
721350,760394.7,930650,293900,309504.4,338450,427450,450890.3,592200
725170,731950.1,930650,294590,301181.6,338450,430580,430768.5,592200
729070,721939.9,930650,295260,288402.9,338450,433810,433537,592200
732870,719395.2,930650,295930,282953.5,338450,436940,436441.7,592200
736720,734599,930650,296600,290081.2,338450,440120,444517.8,592200
739880,722206,930650,297300,286996.4,338450,442580,435209.6,592200
743230,722405.6,930650,298020,286151.5,338450,445210,436254.1,592200
746440,718866.3,930650,298770,283288.2,338450,447670,435578.1,592200
749670,709472.1,930650,299460,284468,338450,450210,425004.1,592200
753170,693726.7,930650,300510,282397.3,338450,452660,411329.4,592200
756760,699675.3,930650,301550,281006.3,338450,455210,418669,592200
760290,683333.9,930650,302600,274147,338450,457690,409186.9,592200
763840,696173.9,930650,303640,276635.4,338450,460200,419538.5,592200
763050,728501.4,930650,303650,284362.1,338450,459400,444139.3,592200
762240,719601.7,930650,303700,277417,338450,458540,442184.7,592200
761480,725427.3,930650,303740,276093.2,338450,457740,449334.1,592200
760670,729189.6,930650,303770,278298.5,338450,456900,450891.1,592200
760710,747532.6,930650,303960,285420.9,338450,456750,462111.7,592200
760790,760772.9,930650,304180,292988.3,338450,456610,467784.6,592200
760820,767917.2,930650,304400,292241.7,338450,456420,475675.5,592200
760940,765971.3,930650,304620,292855.8,338450,456320,473115.5,592200
760310,779618.8,930650,304380,299228.1,338450,455930,480390.7,592200
759680,778946.5,930650,304110,299264,338450,455570,479682.5,592200
759080,775039.1,930650,303830,301320.2,338450,455250,473718.9,592200
758420,784857.5,930650,303590,304689.1,338450,454830,480168.4,592200
760020,784638.5,930650,303910,307409.6,338450,456110,477228.9,592200
761590,801678.1,930650,304200,308960.6,338450,457390,492717.5,592200
763200,804249.1,930650,304520,303622.3,338450,458680,500626.8,592200
764800,800507.9,930650,304820,298526.7,338450,459980,501981.2,592200
765640,791358.1,930650,304930,297418.6,338450,460710,493939.5,592200
766470,821335.9,930650,305070,309226.5,338450,461400,512109.4,592200
767290,825626.7,930650,305170,308808.7,338450,462120,516818,592200
768130,827162.8,930650,305290,308617.3,338450,462840,518545.5,592200
768830,835364.8,930650,305220,312479.3,338450,463610,522885.5,592200
769610,834796.2,930650,305170,314034.5,338450,464440,520761.7,592200
770320,821596.9,930650,305080,310309.7,338450,465240,511287.2,592200
771030,815491.2,930650,305040,306459.3,338450,465990,509031.9,592200
764780,811400.7,930650,302330,310187.4,338450,462450,501213.3,592200
758450,823205.2,930650,299580,314841,338450,458870,508364.2,592200
752160,807534,930650,296860,312114.2,338450,455300,495419.8,592200
745820,808857.7,930650,294130,316790.7,338450,451690,492067,592200
738970,817684,930650,291110,316392.4,338450,447860,501291.6,592200
732120,813570.7,930650,288060,315758.7,338450,444060,497812,592200
725270,804073.7,930650,285020,315587.7,338450,440250,488486,592200
718450,786326.1,930650,281970,305452,338450,436480,480874.1,592200
712370,755252.9,930650,279560,289315,338450,432810,465937.9,592200
706280,747906,930650,277140,288053.3,338450,429140,459852.7,592200
700170,745123.9,930650,274720,286032.5,338450,425450,459091.4,592200
694200,748134.5,930650,272300,291956.8,338450,421900,456177.7,592200
695830,765961.4,930650,273800,299802.1,338450,422030,466159.3,592200
697390,771120.2,930650,275250,302404.5,338450,422140,468715.7,592200
699020,756025.5,930650,276720,299037.8,338450,422300,456987.7,592200
700580,771361.5,930650,278170,303515.3,338450,422410,467846.2,592200
702720,796029.9,930650,279420,302077.2,338450,423300,493952.7,592200
704790,789658,930650,280670,301858.3,338450,424120,487799.7,592200
706790,789485.3,930650,281900,308628.4,338450,424890,480856.9,592200
745390,784356.6,930650,296270,302416.1,338450,449120,481940.5,592200
746080,804929.2,930650,296530,309047.9,338450,449550,495881.3,592200
746780,816407.2,930650,296780,311007.9,338450,450000,505399.3,592200
747340,808629.3,930650,297020,314316.4,338450,450320,494312.9,592200
747990,791145.5,930650,297240,310945.7,338450,450750,480199.8,592200
752900,803432.5,930650,298430,312896.9,338450,454470,490535.6,592200
757890,785517.5,930650,299610,309491.8,338450,458280,476025.7,592200
762760,801599.8,930650,300790,311785.8,338450,461970,489814,592200
767670,806300.2,930650,301960,311813.3,338450,465710,494486.9,592200
771920,831370.7,930650,303010,318816,338450,468910,512554.7,592200
776110,858174,930650,304060,320705.1,338450,472050,537468.9,592200
780280,845709.7,930650,305110,319326.3,338450,475170,526383.4,592200
784490,778306.4,930650,306190,273606.8,338450,478300,504699.6,592200
788820,843710.2,930650,307310,319017,338450,481510,524693.2,592200
793290,812132,930650,308420,312878.3,338450,484870,499253.7,592200
797740,818567.6,930650,309560,312683.4,338450,488180,505884.2,592200
802100,820749.5,930650,310690,311463.7,338450,491410,509285.8,592200
799340,829018.3,930650,309860,310591,338450,489480,518427.3,592200
796640,836405,930650,309040,311868.5,338450,487600,524536.5,592200
793900,818928.6,930650,308220,308454.6,338450,485680,510474,592200
791100,814067.4,930650,307390,311069.9,338450,483710,502997.5,592200
788430,810614.1,930650,306720,310375.3,338450,481710,500238.8,592200
785790,803787,930650,306020,310248.4,338450,479770,493538.6,592200
783100,806553,930650,305340,305906.3,338450,477760,500646.7,592200
780440,814780.1,930650,304650,306183.4,338450,475790,508596.7,592200
777690,803908.9,930650,303740,305997.9,338450,473950,497911,592200
775030,807049.8,930650,302850,303464.6,338450,472180,503585.2,592200
772310,803034.1,930650,301950,300639.7,338450,470360,502394.4,592200
769540,794099.7,930650,301040,298010.2,338450,468500,496089.5,592200
770680,787917.3,930650,301430,298222.6,338450,469250,489694.7,592200
771890,780154.1,930650,301860,296673.1,338450,470030,483481,592200
773200,783066.4,930650,302270,298233,338450,470930,484833.4,592200
774350,783242.3,930650,302660,300311.3,338450,471690,482931,592200
775250,804826.3,930650,303000,308629.7,338450,472250,496196.6,592200
776230,811658.5,930650,303320,307453.2,338450,472910,504205.3,592200
777220,800447,930650,303650,304312.5,338450,473570,496134.5,592200
778150,796224.5,930650,303950,303960.4,338450,474200,492264.1,592200
779790,807072.9,930650,304500,305913.6,338450,475290,501159.3,592200
781410,801287.2,930650,305030,306182.7,338450,476380,495104.5,592200
783170,808301.7,930650,305600,313905.7,338450,477570,494396,592200
784760,807060.6,930650,306120,317894.9,338450,478640,489165.7,592200
788080,790000.8,930650,306840,311296.9,338450,481240,478703.9,592200
791520,791172.8,930650,307580,303835.2,338450,483940,487337.6,592200
794850,789837.7,930650,308270,302630.2,338450,486580,487207.5,592200
798300,799952.5,930650,309000,304269,338450,489300,495683.5,592200
801370,811045.5,930650,309770,312095.7,338450,491600,498949.8,592200
804390,787230.1,930650,310500,310833.9,338450,493890,476396.2,592200
807460,763779,930650,311280,306558.2,338450,496180,457220.8,592200
810550,779841.7,930650,312020,310565.8,338450,498530,469275.9,592200
813580,775824.5,930650,312740,305443.6,338450,500840,470380.9,592200
816630,774745.2,930650,313470,302641.3,338450,503160,472103.9,592200
819680,789059.6,930650,314200,300984.9,338450,505480,488074.7,592200
822780,771350.6,930650,314920,296595.9,338450,507860,474754.7,592200
821220,777781.9,930650,314640,299002.7,338450,506580,478779.2,592200
819660,772578.3,930650,314360,301993.1,338450,505300,470585.2,592200
818190,788514.3,930650,314070,306180.1,338450,504120,482334.2,592200
816620,805269.8,930650,313810,306592.1,338450,502810,498677.7,592200
814880,795007.1,930650,313420,301866.6,338450,501460,493140.5,592200
813060,792333.9,930650,313030,302170.8,338450,500030,490163.1,592200
811280,799863.9,930650,312640,305639,338450,498640,494224.9,592200
809500,787699.4,930650,312230,300612.3,338450,497270,487087.1,592200
807730,783527.9,930650,312020,294730.3,338450,495710,488797.6,592200
805960,789814.7,930650,311780,300138.4,338450,494180,489676.3,592200
804150,814480.9,930650,311550,310815.7,338450,492600,503665.2,592200
802370,807788.7,930650,311320,311432.9,338450,491050,496355.8,592200
800900,790558.4,930650,310910,304682.4,338450,489990,485876,592200
799470,773442.2,930650,310500,300440.7,338450,488970,473001.5,592200
797940,794431.3,930650,310080,308838.4,338450,487860,485592.9,592200
796470,792532.8,930650,309690,309898.6,338450,486780,482634.2,592200
794690,777287.8,930650,309200,305567.5,338450,485490,471720.3,592200
792990,775122.6,930650,308760,301137,338450,484230,473985.6,592200
791200,762437.9,930650,308290,294518.7,338450,482910,467919.2,592200
789520,787540,930650,307830,310870,338450,481690,476670,592200
787980,798427.1,930650,307270,314162.9,338450,480710,484264.2,592200
786460,819585.8,930650,306740,318444.8,338450,479720,501141,592200
784940,804454.5,930650,306170,311384.7,338450,478770,493069.8,592200
783490,798613.1,930650,305630,308391.6,338450,477860,490221.5,592200
782720,788102.4,930650,305570,304834.3,338450,477150,483268.1,592200
781970,808780.2,930650,305480,308168.8,338450,476490,500611.4,592200
781230,811245.8,930650,305440,313068.5,338450,475790,498177.3,592200
780490,805878.6,930650,305350,312744,338450,475140,493134.6,592200
779690,808530.4,930650,305220,313826.5,338450,474470,494703.9,592200
778930,826923.3,930650,305050,317111.2,338450,473880,509812.1,592200
778130,815560.7,930650,304890,314928.9,338450,473240,500631.8,592200
777410,818804.6,930650,304740,315453.9,338450,472670,503350.7,592200
776570,809129.8,930650,304570,314227.3,338450,472000,494902.5,592200
775800,813325.2,930650,304420,310954.7,338450,471380,502370.5,592200
774970,821720.6,930650,304260,314060.4,338450,470710,507660.2,592200
774190,828031.1,930650,304110,312666.9,338450,470080,515364.2,592200
774240,828873.3,930650,304210,313361,338450,470030,515512.3,592200
774310,819915.9,930650,304280,312125.2,338450,470030,507790.7,592200
774470,817616.9,930650,304370,313413.2,338450,470100,504203.7,592200
774460,824908.1,930650,304460,314166.9,338450,470000,510741.2,592200
774400,831447.3,930650,304470,318549.2,338450,469930,512898.1,592200
774360,816894.1,930650,304490,316135,338450,469870,500759.1,592200
774340,820813.7,930650,304500,318421.3,338450,469840,502392.4,592200
746480,822916.3,930650,298410,318644.3,338450,448070,504272,592200
744240,825483.6,930650,297820,321501.8,338450,446420,503981.8,592200
741920,822571.2,930650,297220,320228.8,338450,444700,502342.4,592200
739640,817950.3,930650,296650,319018.9,338450,442990,498931.4,592200
737360,808773.2,930650,296060,313389.2,338450,441300,495384,592200
737280,801659.9,930650,295970,312399.9,338450,441310,489260,592200
737190,785207.8,930650,295860,308489.8,338450,441330,476718,592200
737060,778434.4,930650,295770,303945.8,338450,441290,474488.6,592200
736980,783966.5,930650,295670,305375.6,338450,441310,478590.9,592200
737500,771945.8,930650,295700,302881.1,338450,441800,469064.7,592200
738000,771713.1,930650,295730,302867.3,338450,442270,468845.8,592200
738540,780539.7,930650,295760,307527.7,338450,442780,473012,592200
739040,785227.1,930650,295770,312243.9,338450,443270,472983.2,592200
739160,785967.6,930650,295890,313973,338450,443270,471994.6,592200
739220,773141.2,930650,295990,309402.1,338450,443230,463739.1,592200
739280,787624.1,930650,296110,312078.6,338450,443170,475545.5,592200
739400,806470.8,930650,296220,319580.6,338450,443180,486890.2,592200
741260,810326.4,930650,296660,320861.6,338450,444600,489464.8,592200
743140,811764.4,930650,297090,321542.8,338450,446050,490221.6,592200
745110,820638.1,930650,297540,322355.1,338450,447570,498283,592200
746910,811948.1,930650,297970,319076.6,338450,448940,492871.5,592200
749060,814573.5,930650,298500,316414.3,338450,450560,498159.2,592200
751160,819918.3,930650,299030,317221.1,338450,452130,502697.2,592200
753330,827838.3,930650,299590,316852,338450,453740,510986.3,592200
755440,820808.1,930650,300100,315498.9,338450,455340,505309.2,592200
758040,827990.6,930650,300830,317172.1,338450,457210,510818.5,592200
760750,814702.3,930650,301580,314247.1,338450,459170,500455.2,592200
763450,817924.8,930650,302330,316625.9,338450,461120,501298.9,592200
766100,821911.2,930650,303050,314714.7,338450,463050,507196.5,592200
769100,822344.2,930650,304010,314447.5,338450,465090,507896.7,592200
772210,830806.5,930650,304950,315841.6,338450,467260,514964.9,592200
775280,839061.6,930650,305920,323037.6,338450,469360,516024,592200
778370,839624.8,930650,306890,321540.4,338450,471480,518084.4,592200
780900,844148.7,930650,307630,321983.8,338450,473270,522164.9,592200
783430,838277.7,930650,308400,319203.1,338450,475030,519074.6,592200
786030,827817.7,930650,309160,313448.2,338450,476870,514369.5,592200
788570,839402.6,930650,309930,314674.7,338450,478640,524727.9,592200
791140,838574.4,930650,310670,315136,338450,480470,523438.4,592200
793720,830028.5,930650,311420,307953,338450,482300,522075.5,592200
796340,832792.2,930650,312160,310551.1,338450,484180,522241.1,592200
798910,838970.1,930650,312900,318284.8,338450,486010,520685.3,592200
800930,833056.8,930650,313360,321749.6,338450,487570,511307.2,592200
802960,833755.1,930650,313840,317115.5,338450,489120,516639.6,592200
804950,828459.3,930650,314290,309458.4,338450,490660,519000.9,592200
806960,849521.6,930650,314770,320161.9,338450,492190,529359.7,592200
809550,865512.1,930650,315140,321941.7,338450,494410,543570.4,592200
812120,871171.8,930650,315520,321613.3,338450,496600,549558.5,592200
814630,871593.3,930650,315870,322948.8,338450,498760,548644.5,592200
817220,873614.8,930650,316260,324294.3,338450,500960,549320.5,592200
819600,870331,930650,316830,325427.8,338450,502770,544903.2,592200
822080,864877.9,930650,317410,324939.5,338450,504670,539938.4,592200
824490,872117.1,930650,317980,325883.2,338450,506510,546233.9,592200
826950,857816.9,930650,318560,322896.6,338450,508390,534920.3,592200
825820,856802.9,930650,318420,321666.6,338450,507400,535136.3,592200
824750,856625.8,930650,318290,319583.5,338450,506460,537042.3,592200
823580,838589.5,930650,318170,319965.7,338450,505410,518623.8,592200
822470,844781.5,930650,318040,317334,338450,504430,527447.5,592200
821910,832431.7,930650,318040,313785.7,338450,503870,518646,592200
821390,832442.8,930650,318020,312746.4,338450,503370,519696.4,592200
820890,842877.3,930650,318030,318415.3,338450,502860,524462,592200
820430,841141.8,930650,318010,319563.5,338450,502420,521578.3,592200
819690,840138.9,930650,317850,322953.5,338450,501840,517185.4,592200
819000,831340,930650,317680,320938.1,338450,501320,510401.9,592200
818320,838179.4,930650,317490,320910.4,338450,500830,517269,592200
817660,844331,930650,317330,322129,338450,500330,522202,592200
818260,367485,930650,317370,255176.3,338450,500890,112308.7,592200
818810,368221.9,930650,317410,254452.5,338450,501400,113769.4,592200
819470,366803,930650,317450,254467.8,338450,502020,112335.2,592200
820080,364691.2,930650,317520,254174.3,338450,502560,110516.9,592200
820640,367205.2,930650,317610,255581,338450,503030,111624.2,592200
821230,372499.1,930650,317730,257391.4,338450,503500,115107.7,592200
821780,374261,930650,317830,259209.7,338450,503950,115051.3,592200
822380,377582.3,930650,317960,260555.1,338450,504420,117027.2,592200
823090,378055,930650,318050,259863.4,338450,505040,118191.6,592200
823820,378182.3,930650,318130,260951.8,338450,505690,117230.5,592200
824480,375943.7,930650,318200,258844.5,338450,506280,117099.2,592200
825170,892375.5,930650,318270,326239.3,338450,506900,566136.2,592200
824980,859497.6,930650,318130,326890.6,338450,506850,532607,592200
824830,863490.8,930650,318000,327164.2,338450,506830,536326.6,592200
824670,868001.6,930650,317860,327271.8,338450,506810,540729.8,592200
824460,862860,930650,317690,326899.8,338450,506770,535960.2,592200
824050,872332.3,930650,317550,322961.2,338450,506500,549371.1,592200
823610,835960.3,930650,317390,318328.4,338450,506220,517631.9,592200
823210,826513.8,930650,317240,318669.2,338450,505970,507844.6,592200
822810,835835.3,930650,317120,322737,338450,505690,513098.3,592200
822490,813732.1,930650,317000,319312.5,338450,505490,494419.6,592200
822160,797872.4,930650,316880,317625.7,338450,505280,480246.7,592200
821840,818400.7,930650,316770,319868,338450,505070,498532.7,592200
821540,840177.7,930650,316670,320864.4,338450,504870,519313.3,592200
817620,839417.2,930650,313870,320319,338450,503750,519098.2,592200
813700,834757.2,930650,311060,318230.3,338450,502640,516526.9,592200
809850,816028.7,930650,308270,162223.4,338450,501580,53805.3,592200
805950,824811.2,930650,305500,318183.6,338450,500450,506627.6,592200
802130,825389.2,930650,302690,318640.7,338450,499440,506748.5,592200
798300,827194.1,930650,299900,317082.3,338450,498400,510111.8,592200
794460,835214.3,930650,297100,322938.1,338450,497360,512276.2,592200
805840,823927.2,930650,302610,319048.4,338450,503230,504878.8,592200
802950,810680.8,930650,300720,313434,338450,502230,497246.8,592200
800000,807584,930650,298820,316093,338450,501180,491491,592200
797020,791374.7,930650,296920,305100.8,338450,500100,486273.9,592200
794030,785175.5,930650,295010,301586.1,338450,499020,483589.4,592200
781430,774155,930650,286970,298491.2,338450,494460,475663.8,592200
768940,744407.5,930650,278940,278531.9,338450,490000,465875.6,592200
756440,731952.9,930650,270910,271201.5,338450,485530,460751.4,592200
743870,689916.3,930650,262900,243622,338450,480970,446294.3,592200
732400,701199.2,930650,256250,256065,338450,476150,445134.2,592200
720850,699473.6,930650,249590,260510.4,338450,471260,438963.2,592200
709380,667160.8,930650,242930,242244.9,338450,466450,424915.9,592200
697840,665551.2,930650,236260,244877.8,338450,461580,420673.4,592200
685660,644901.6,930650,229430,234335.8,338450,456230,410565.8,592200
673340,626385.7,930650,222560,226063.8,338450,450780,400321.9,592200
661170,657109.1,930650,215720,245620.6,338450,445450,411488.5,592200
648920,623536.1,930650,208840,225213.9,338450,440080,398322.2,592200
632660,604301.6,930650,203230,218896.2,338450,429430,385405.4,592200
616360,596157.7,930650,197580,215568.3,338450,418780,380589.4,592200
600160,516764,930650,191970,177662.9,338450,408190,339101.1,592200
583800,523914,930650,186300,190916.3,338450,397500,332997.7,592200
566950,503610.5,930650,180670,179068.2,338450,386280,324542.3,592200
550110,469423.9,930650,175060,153966.7,338450,375050,315457.2,592200
533200,462043.2,930650,169430,155407.5,338450,363770,306635.7,592200
516350,459732.8,930650,163800,157385.2,338450,352550,302347.6,592200
501540,455565.7,930650,160020,162839.2,338450,341520,292726.5,592200
486640,448363.1,930650,156220,167369.1,338450,330420,280994,592200
471740,452389.5,930650,152410,173917.3,338450,319330,278472.2,592200
456890,433699.2,930650,148610,162172.3,338450,308280,271526.9,592200
449090,414273.5,930650,148820,154080.7,338450,300270,260192.8,592200
441390,386727.9,930650,149070,136296.7,338450,292320,250431.2,592200
433550,368199.4,930650,149280,124065.3,338450,284270,244134.1,592200
425860,424688,930650,149510,161261.9,338450,276350,263426.1,592200
419540,443012.7,930650,150780,174217.5,338450,268760,268795.2,592200
413260,485645.5,930650,152040,208294.6,338450,261220,277350.9,592200
406960,462674.8,930650,153280,194815.2,338450,253680,267859.6,592200
400700,441163.8,930650,154550,181225.5,338450,246150,259938.3,592200
394730,443282,930650,155430,188237,338450,239300,255045,592200
388760,471770.5,930650,156360,207678.8,338450,232400,264091.7,592200
382830,491703.7,930650,157250,220685.9,338450,225580,271017.8,592200
376820,452371.3,930650,158120,204273.6,338450,218700,248097.7,592200
371290,433563.8,930650,156910,191654,338450,214380,241909.8,592200
365640,473288.2,930650,155680,214098.6,338450,209960,259189.6,592200
360090,481658.3,930650,154460,215805.1,338450,205630,265853.2,592200
354430,464820.1,930650,153220,206820.5,338450,201210,257999.6,592200
348810,469067,930650,152220,198318.3,338450,196590,270748.7,592200
343240,469919.1,930650,151200,194504.2,338450,192040,275414.9,592200
337690,443789.5,930650,150180,198776.5,338450,187510,245013,592200
332110,498015.7,930650,149160,233390.2,338450,182950,264625.5,592200
330370,461573.4,930650,150310,213551.1,338450,180060,248022.3,592200
328730,436728.8,930650,151440,206873.3,338450,177290,229855.5,592200
327050,419516.2,930650,152600,205047.8,338450,174450,214468.4,592200
325400,399999,930650,153750,195773.3,338450,171650,204225.7,592200
323310,370220.1,930650,154290,177962.7,338450,169020,192257.4,592200
321260,362920.2,930650,154840,159502.6,338450,166420,203417.6,592200
319200,321819.6,930650,155380,143930.5,338450,163820,177889.1,592200
317170,324319.3,930650,155930,149529,338450,161240,174790.3,592200
314980,349697,930650,155770,164816.9,338450,159210,184880.1,592200
312740,360779.7,930650,155600,169154.2,338450,157140,191625.5,592200
310540,345777.9,930650,155430,169035.2,338450,155110,176742.7,592200
308320,325692.7,930650,155260,169216.6,338450,153060,156476.1,592200
307960,300157.5,930650,156310,161618,338450,151650,138539.5,592200
307490,302789.1,930650,157330,167273.8,338450,150160,135515.3,592200
307190,319548.9,930650,158370,177660.2,338450,148820,141888.7,592200
306890,334808,930650,159420,192674,338450,147470,142134,592200
310290,335213.4,930650,162340,196041.6,338450,147950,139171.8,592200
313680,329136.4,930650,165280,190422.3,338450,148400,138714.1,592200
317110,340542.1,930650,168200,194157.3,338450,148910,146384.8,592200
320440,352350.7,930650,171120,204484.3,338450,149320,147866.4,592200
324030,355588.1,930650,173910,206903.9,338450,150120,148684.2,592200
327620,349663.7,930650,176720,208273.6,338450,150900,141390.1,592200
331230,348267.5,930650,179520,204876.2,338450,151710,143391.3,592200
334800,341572.1,930650,182320,196457.8,338450,152480,145114.3,592200
339480,373507.2,930650,186060,212273.9,338450,153420,161233.3,592200
344080,379602.4,930650,189740,214600.2,338450,154340,165002.2,592200
348820,406472.1,930650,193460,226707.6,338450,155360,179764.5,592200
353430,404506.4,930650,197190,226616.6,338450,156240,177889.8,592200
357250,385795.4,930650,197650,214941.3,338450,159600,170854.1,592200
361050,387734.9,930650,198100,218280.3,338450,162950,169454.6,592200
364860,379263.9,930650,198550,217566.1,338450,166310,161697.8,592200
368680,393581.8,930650,198990,224362.2,338450,169690,169219.6,592200
371850,414736.2,930650,199000,227188.5,338450,172850,187547.7,592200
375030,409179.6,930650,198980,226790.6,338450,176050,182389,592200
378240,420062.2,930650,198960,231862.7,338450,179280,188199.5,592200
381350,432730.1,930650,198950,234480.2,338450,182400,198249.9,592200
384780,431394.5,930650,199810,233913.9,338450,184970,197480.6,592200
388110,425952.6,930650,200670,230345.3,338450,187440,195607.3,592200
391500,423241.8,930650,201530,234086.6,338450,189970,189155.2,592200
394900,427854,930650,202410,233555.2,338450,192490,194298.8,592200
389820,402654.3,930650,199300,223099.4,338450,190520,179554.9,592200
384760,409518.5,930650,196210,228339.2,338450,188550,181179.3,592200
379630,416090.5,930650,193100,227864.3,338450,186530,188226.2,592200
374610,417467.2,930650,189990,230243.4,338450,184620,187223.8,592200
369310,422425.1,930650,186860,238228.7,338450,182450,184196.4,592200
364020,416173.7,930650,183720,233883.7,338450,180300,182290,592200
358630,416737.8,930650,180560,232228.7,338450,178070,184509.1,592200
382150,403252.1,930650,195680,229298.8,338450,186470,173953.3,592200
380120,409553.1,930650,193750,231273.7,338450,186370,178279.4,592200
378110,394022.5,930650,191830,226076.2,338450,186280,167946.3,592200
376040,380808.9,930650,189910,220383.5,338450,186130,160425.4,592200
373960,385723.6,930650,187970,224906.6,338450,185990,160817,592200
367510,389167.8,930650,184400,226714.3,338450,183110,162453.5,592200
361020,385503.3,930650,180830,224093.7,338450,180190,161409.6,592200
354580,386179.6,930650,177240,225697.9,338450,177340,160481.7,592200
348140,390493.7,930650,173670,226351,338450,174470,164142.7,592200
340110,365475.4,930650,169510,207406.6,338450,170600,158068.8,592200
332190,350611.4,930650,165360,193919.4,338450,166830,156692,592200
324220,335430.4,930650,161190,187651.1,338450,163030,147779.3,592200
316250,298743.2,930650,156990,161875.6,338450,159260,136867.6,592200
308770,277563.3,930650,153070,144278.9,338450,155700,133284.4,592200
301260,278254.4,930650,149130,142291.2,338450,152130,135963.2,592200
293710,289083.9,930650,145180,144923.4,338450,148530,144160.5,592200
286210,287528.5,930650,141240,146045.9,338450,144970,141482.6,592200
278520,281491.8,930650,137240,136435.5,338450,141280,145056.3,592200
270770,285248.7,930650,133220,144358.4,338450,137550,140890.3,592200
263020,279089.6,930650,129210,145905.2,338450,133810,133184.4,592200
255320,263345.6,930650,125190,137763.7,338450,130130,125581.9,592200
249620,241138.3,930650,122530,120552.6,338450,127090,120585.7,592200
243820,232573.8,930650,119850,111686.8,338450,123970,120887,592200
238130,198774.5,930650,117180,105428.5,338450,120950,93346,592200
232440,188021.8,930650,114510,100861,338450,117930,87160.8,592200
226900,168404.8,930650,111920,88058,338450,114980,80346.8,592200
221440,198910.3,930650,109300,94670.6,338450,112140,104239.7,592200
216010,197589.6,930650,106710,89826.3,338450,109300,107763.3,592200
210560,176897,930650,104120,80794.4,338450,106440,96102.6,592200
205280,146745.1,930650,101380,68085.4,338450,103900,78659.7,592200
200040,138654.1,930650,98650,64940.9,338450,101390,73713.2,592200
194810,137811.9,930650,95890,66614.8,338450,98920,71197.1,592200
189670,141568.9,930650,93200,71992.2,338450,96470,69576.7,592200
183180,135137.9,930650,89730,67578,338450,93450,67559.9,592200
176720,129163.3,930650,86300,62156.2,338450,90420,67007.1,592200
170260,118811.4,930650,82850,55398.3,338450,87410,63413.1,592200
163760,124687.3,930650,79410,49866.7,338450,84350,74820.6,592200
158690,117436.4,930650,77190,41660.3,338450,81500,75776.1,592200
153640,126846.3,930650,74980,46677.9,338450,78660,80168.4,592200
148590,115706.4,930650,72770,53590.5,338450,75820,62115.9,592200
143490,132938.7,930650,70540,47184.7,338450,72950,85754,592200
143970,117037.5,930650,70950,36082.7,338450,73020,80954.8,592200
144420,113394.5,930650,71320,36402.7,338450,73100,76991.8,592200
144890,104644.7,930650,71700,35005.7,338450,73190,69639,592200
145410,102316.5,930650,72070,35079.8,338450,73340,67236.7,592200
145390,96900.1,930650,71760,31447.4,338450,73630,65452.7,592200
145360,95588,930650,71460,30101.7,338450,73900,65486.3,592200
145310,93395.2,930650,71130,30590.6,338450,74180,62804.6,592200
145330,100909.4,930650,70830,36346,338450,74500,64563.4,592200
145260,104863.8,930650,70970,39964.8,338450,74290,64899,592200
145330,114720.7,930650,71150,47863.6,338450,74180,66857.1,592200
145280,133861.3,930650,71310,59904.7,338450,73970,73956.6,592200
145250,141561.1,930650,71460,63605.6,338450,73790,77955.5,592200
149700,141422.3,930650,75030,62952.2,338450,74670,78470.1,592200
154020,152726.5,930650,78550,70545.3,338450,75470,82181.2,592200
158480,168350,930650,82080,77591,338450,76400,90759,592200
162870,149730.4,930650,85610,73232.2,338450,77260,76498.2,592200
168360,155985.8,930650,89260,77244,338450,79100,78741.8,592200
173870,144128.4,930650,92890,77163.1,338450,80980,66965.3,592200
179390,163897.9,930650,96510,78536.6,338450,82880,85361.3,592200
184810,191015.8,930650,100120,93860,338450,84690,97155.8,592200
191270,200659.5,930650,104080,95370.9,338450,87190,105288.6,592200
197760,185360.4,930650,108030,82322.6,338450,89730,103037.8,592200
204210,136513.6,930650,111970,67743.5,338450,92240,68770.1,592200
210660,193749.4,930650,115910,85976.2,338450,94750,107773.2,592200
219070,229482.1,930650,120580,118960.9,338450,98490,110521.2,592200
227310,227363.2,930650,125250,120010.7,338450,102060,107352.5,592200
235760,238112.9,930650,129930,115705.6,338450,105830,122407.3,592200
244120,222418.2,930650,134580,120065.9,338450,109540,102352.3,592200
254850,287578.3,930650,141360,159919.1,338450,113490,127659.2,592200
265730,300434.7,930650,148160,173573.5,338450,117570,126861.2,592200
276550,335984.6,930650,154950,190494.4,338450,121600,145490.2,592200
287370,334980.9,930650,161760,185288.5,338450,125610,149692.4,592200
294770,325839.9,930650,165520,180758.5,338450,129250,145081.4,592200
302110,271451.3,930650,169310,150890.1,338450,132800,120561.2,592200
309500,286796.9,930650,173100,158343.3,338450,136400,128453.6,592200
316820,336079.7,930650,176870,189472.3,338450,139950,146607.4,592200
331250,388129.4,930650,181050,220988.4,338450,150200,167141,592200
345690,397509.7,930650,185250,225179.8,338450,160440,172329.9,592200
360140,418377.8,930650,189410,231609.7,338450,170730,186768.1,592200
374600,434800.1,930650,193600,233713.4,338450,181000,201086.7,592200
388220,436100.7,930650,197000,226734.1,338450,191220,209366.6,592200
401870,406174.3,930650,200390,201132.7,338450,201480,205041.6,592200
415590,405705.2,930650,203780,195618.4,338450,211810,210086.8,592200
429290,411680.7,930650,207190,196841.9,338450,222100,214838.8,592200
441710,426832.4,930650,210060,200266.2,338450,231650,226566.2,592200
454090,443482.7,930650,212940,214604.1,338450,241150,228878.6,592200
466530,461128.9,930650,215820,225150.1,338450,250710,235978.8,592200
478980,462707.4,930650,218730,220650.8,338450,260250,242056.6,592200
481160,467830.5,930650,217780,220903.4,338450,263380,246927.1,592200
483330,467145.9,930650,216830,223045.9,338450,266500,244100,592200
485540,452758,930650,215910,214963.9,338450,269630,237794.1,592200
487710,477112.9,930650,214960,225180.8,338450,272750,251932.1,592200
489640,495818.9,930650,214280,228169,338450,275360,267649.9,592200
491640,507832.9,930650,213540,230010.1,338450,278100,277822.8,592200
493550,503528.9,930650,212850,218292.4,338450,280700,285236.5,592200
461510,520366.7,930650,204280,234348.6,338450,257230,286018.1,592200
466350,507829.6,930650,204180,220344.1,338450,262170,287485.5,592200
471050,492531.9,930650,204030,211938.1,338450,267020,280593.8,592200
475950,505472.4,930650,203920,215104.3,338450,272030,290368.1,592200
480730,501219.7,930650,203780,218821,338450,276950,282398.7,592200
480570,509844.4,930650,203570,229112.4,338450,277000,280732,592200
480300,515574.2,930650,203330,240213.5,338450,276970,275360.7,592200
480140,480255.7,930650,203120,216333.8,338450,277020,263921.9,592200
479970,467694.2,930650,202880,202247.3,338450,277090,265446.9,592200
478560,473509.1,930650,202220,207168.8,338450,276340,266340.3,592200
477330,470902.9,930650,201580,198481.5,338450,275750,272421.4,592200
475900,469192,930650,200910,200064.7,338450,274990,269127.3,592200
474590,479277.8,930650,200270,204463.5,338450,274320,274814.3,592200
473150,463243.6,930650,199540,199307.6,338450,273610,263936,592200
471710,507111.5,930650,198870,229121.6,338450,272840,277989.9,592200
470270,535051.8,930650,198160,240734.9,338450,272110,294316.9,592200
468830,527657.4,930650,197450,235726.8,338450,271380,291930.6,592200
461850,527723.6,930650,195390,230219.8,338450,266460,297503.8,592200
454740,508551.4,930650,193320,218899.3,338450,261420,289652.1,592200
447760,493274.9,930650,191260,217212,338450,256500,276062.9,592200
440790,472553.3,930650,189160,208654.5,338450,251630,263898.8,592200
434680,469452.3,930650,186840,214998,338450,247840,254454.3,592200
428620,455592.3,930650,184530,208650.2,338450,244090,246942.1,592200
422550,442317.3,930650,182200,198160.3,338450,240350,244157,592200
416490,439904.2,930650,179910,199942.5,338450,236580,239961.7,592200
409840,432307.1,930650,177710,193245.5,338450,232130,239061.6,592200
403230,401718.5,930650,175520,180164,338450,227710,221554.5,592200
396520,394343.8,930650,173320,171008.2,338450,223200,223335.6,592200
389910,394650.3,930650,171130,165833.9,338450,218780,228816.4,592200
384920,380357.3,930650,169410,165188.6,338450,215510,215168.7,592200
380060,391428.3,930650,167710,178326.4,338450,212350,213101.9,592200
375120,382452.3,930650,165990,181804.4,338450,209130,200647.9,592200
370190,361149.3,930650,164260,170988.4,338450,205930,190160.9,592200
366310,370328.9,930650,163540,172517,338450,202770,197811.9,592200
362380,386171.7,930650,162800,187870.1,338450,199580,198301.6,592200
358560,392901.1,930650,162090,199542.7,338450,196470,193358.4,592200
354670,384880.8,930650,161340,201130.8,338450,193330,183750,592200
351250,394054.6,930650,161100,205158.3,338450,190150,188896.3,592200
347900,391153.4,930650,160840,198927.5,338450,187060,192225.9,592200
344540,394381.1,930650,160600,194563.9,338450,183940,199817.2,592200
341180,378240.9,930650,160350,197240.6,338450,180830,181000.3,592200
337540,380406.3,930650,159350,199486.9,338450,178190,180919.4,592200
333800,401647.9,930650,158340,199130.7,338450,175460,202517.2,592200
330190,402324.3,930650,157350,201626.9,338450,172840,200697.4,592200
326450,422990.3,930650,156320,209497,338450,170130,213493.3,592200
322540,433845.4,930650,154690,219332.8,338450,167850,214512.6,592200
318550,400792.3,930650,153050,198262.1,338450,165500,202530.2,592200
314600,416340.1,930650,151420,211885,338450,163180,204455.1,592200
310670,418139.8,930650,149780,216629.5,338450,160890,201510.3,592200
305620,406436.5,930650,147580,212148,338450,158040,194288.5,592200
300540,379162.5,930650,145380,193201.8,338450,155160,185960.7,592200
295500,382058,930650,143190,186133.7,338450,152310,195924.3,592200
290430,371853.7,930650,140980,187481.4,338450,149450,184372.3,592200
286040,355191.9,930650,138830,183802.8,338450,147210,171389.1,592200
281620,327473.8,930650,136710,170357.6,338450,144910,157116.2,592200
277170,307611.7,930650,134590,165016.2,338450,142580,142595.5,592200
272760,309478.6,930650,132440,157685.1,338450,140320,151793.5,592200
269700,285480.1,930650,131290,158539.8,338450,138410,126940.3,592200
266740,289977.4,930650,130130,160136.5,338450,136610,129840.9,592200
263670,303859.4,930650,128970,163050.9,338450,134700,140808.5,592200
260640,311972.3,930650,127800,164593.3,338450,132840,147379,592200
257230,319972.5,930650,126290,163319.6,338450,130940,156652.9,592200
253780,342978.9,930650,124790,155421,338450,128990,187557.9,592200
250340,354818.6,930650,123250,166315.3,338450,127090,188503.3,592200
246920,320771.1,930650,121750,153528.8,338450,125170,167242.3,592200
247710,314981.6,930650,122180,145253.7,338450,125530,169727.9,592200
248440,304937.9,930650,122590,138156.8,338450,125850,166781.1,592200
249180,294746.9,930650,122990,134155.7,338450,126190,160591.2,592200
249940,294354.3,930650,123420,131257.9,338450,126520,163096.4,592200
249780,288804.9,930650,123050,128142.7,338450,126730,160662.2,592200
249600,311963.1,930650,122640,133398.8,338450,126960,178564.3,592200
249510,286654.2,930650,122300,124129.9,338450,127210,162524.3,592200
249380,278347.7,930650,121910,127204.1,338450,127470,151143.6,592200
249840,265661.9,930650,122260,117446.3,338450,127580,148215.6,592200
250280,299408.3,930650,122590,129857.1,338450,127690,169551.2,592200
250800,292737.8,930650,122950,136869.8,338450,127850,155868,592200
251290,296658.8,930650,123300,140571.7,338450,127990,156087.1,592200
253080,273643,930650,124160,128659.6,338450,128920,144983.4,592200
254900,253559.5,930650,125010,120400.4,338450,129890,133159.1,592200
256670,270599.6,930650,125900,132129.1,338450,130770,138470.5,592200
258510,276494.1,930650,126790,136891,338450,131720,139603.1,592200
260250,260705.2,930650,127790,127280.1,338450,132460,133425.1,592200
262000,253997.6,930650,128800,118137,338450,133200,135860.6,592200
263730,242403.2,930650,129840,106606.5,338450,133890,135796.7,592200
265480,244220.5,930650,130860,108978.4,338450,134620,135242.1,592200
266730,276301.5,930650,131480,130755.8,338450,135250,145545.7,592200
268050,262469.4,930650,132140,121744.1,338450,135910,140725.3,592200
269310,239406.4,930650,132790,107790.5,338450,136520,131615.9,592200
270590,275921.1,930650,133420,121690.4,338450,137170,154230.7,592200
270950,284136.8,930650,133920,133207.9,338450,137030,150928.9,592200
271280,272564.3,930650,134390,133159.4,338450,136890,139404.9,592200
271660,271005.1,930650,134890,127652.4,338450,136770,143352.7,592200
271990,272771.8,930650,135370,136012.5,338450,136620,136759.3,592200
273340,306918.8,930650,136430,155015.3,338450,136910,151903.5,592200
274670,311965.2,930650,137460,146137.3,338450,137210,165827.9,592200
276020,296136,930650,138500,141914.3,338450,137520,154221.7,592200
238970,310130.4,930650,123100,142375.7,338450,115870,167754.7,592200
238110,323128.7,930650,123030,144160.7,338450,115080,178968,592200
237240,288883.1,930650,122970,127448.3,338450,114270,161434.8,592200
236400,279381.6,930650,122910,120767.4,338450,113490,158614.2,592200
235590,277726.1,930650,122850,123604.4,338450,112740,154121.7,592200
239270,285117.1,930650,124580,123657,338450,114690,161460.1,592200
242960,311425.8,930650,126290,137306.6,338450,116670,174119.2,592200
246720,314154.4,930650,128040,141954.1,338450,118680,172200.3,592200
250400,319580,930650,129770,148539.3,338450,120630,171040.7,592200
253460,291800.8,930650,131050,137566.1,338450,122410,154234.7,592200
256470,258155.2,930650,132340,118017,338450,124130,140138.2,592200
259470,249634.1,930650,133630,110033.8,338450,125840,139600.3,592200
262500,262021.4,930650,134940,119443.8,338450,127560,142577.6,592200
266270,267437.1,930650,137220,119459.1,338450,129050,147978,592200
270160,248607.8,930650,139510,119592.3,338450,130650,129015.5,592200
273930,226199.3,930650,141800,108925.7,338450,132130,117273.6,592200
277770,218986.5,930650,144100,105052.4,338450,133670,113934.1,592200
278730,235709.6,930650,144390,106756.2,338450,134340,128953.4,592200
279740,247671.1,930650,144720,109168,338450,135020,138503.1,592200
280740,217407.8,930650,145030,93389.5,338450,135710,124018.3,592200
281660,187770.4,930650,145320,78097.6,338450,136340,109672.8,592200
281880,181695.6,930650,144780,73529.9,338450,137100,108165.7,592200
282070,211434.6,930650,144260,87548.3,338450,137810,123886.3,592200
282300,236631.5,930650,143730,102254.9,338450,138570,134376.6,592200
282510,249145,930650,143210,110908.3,338450,139300,138236.7,592200
281820,258152,930650,141590,121347.8,338450,140230,136804.2,592200
281120,261099.9,930650,139990,124069.2,338450,141130,137030.7,592200
280360,256345.2,930650,138370,120433.9,338450,141990,135911.3,592200
279690,252002.4,930650,136820,117974.5,338450,142870,134027.9,592200
275970,238533,930650,135350,109368.6,338450,140620,129164.4,592200
272300,229861.5,930650,133900,103791.4,338450,138400,126070.1,592200
268620,222240.1,930650,132450,102782.6,338450,136170,119457.5,592200
264940,206631.2,930650,130980,92325.9,338450,133960,114305.3,592200
259310,204361.8,930650,128660,85596.2,338450,130650,118765.6,592200
253680,193962.2,930650,126350,80856.2,338450,127330,113106,592200
247980,187918.7,930650,124030,78330.1,338450,123950,109588.6,592200
242390,185345.4,930650,121720,74704.8,338450,120670,110640.6,592200
237730,187765.8,930650,119850,80155.1,338450,117880,107610.7,592200
233180,176525.5,930650,117980,75049.1,338450,115200,101476.4,592200
228570,180641.8,930650,116120,70042.8,338450,112450,110599,592200
223950,185011.4,930650,114240,72315.2,338450,109710,112696.2,592200
224310,202878.2,930650,113730,80244.1,338450,110580,122634.1,592200
224590,207655.8,930650,113190,83196,338450,111400,124459.8,592200
224900,193051.1,930650,112660,73761,338450,112240,119290.1,592200
225270,194493.3,930650,112130,72396.1,338450,113140,122097.2,592200
225690,200764,930650,111460,74797.3,338450,114230,125966.7,592200
226080,211298.2,930650,110750,82569.1,338450,115330,128729.1,592200
226550,195272.8,930650,110060,69321.4,338450,116490,125951.4,592200
227050,190287.1,930650,109390,65646.6,338450,117660,124640.5,592200
227510,175079.6,930650,109130,58464.2,338450,118380,116615.4,592200
228050,170172.5,930650,108900,57597.3,338450,119150,112575.2,592200
228550,174074.3,930650,108640,59133.3,338450,119910,114941,592200
229100,157953.6,930650,108400,50458.4,338450,120700,107495.2,592200
225610,160549.9,930650,106690,53028.2,338450,118920,107521.7,592200
222200,161985.7,930650,104970,53583,338450,117230,108402.7,592200
218740,169622.9,930650,103250,59297.2,338450,115490,110325.7,592200
215270,177024.8,930650,101530,64697.8,338450,113740,112327,592200
211190,173082.6,930650,98980,60571.7,338450,112210,112510.9,592200
207060,183832.1,930650,96440,68139,338450,110620,115693.1,592200
202930,182583.8,930650,93890,63664.5,338450,109040,118919.3,592200
198870,185440.5,930650,91350,65982.8,338450,107520,119457.7,592200
195190,168540.7,930650,89100,52845.2,338450,106090,115695.5,592200
191600,160782.5,930650,86840,48825.9,338450,104760,111956.6,592200
187990,169303.2,930650,84580,54165.6,338450,103410,115137.6,592200
184350,174483.5,930650,82330,56607,338450,102020,117876.5,592200
185070,183831.9,930650,82630,60080.5,338450,102440,123751.4,592200
185750,182840.8,930650,82900,57574.7,338450,102850,125266.1,592200
186490,179798.2,930650,83200,54707.9,338450,103290,125090.3,592200
187180,178228.1,930650,83490,51927.6,338450,103690,126300.5,592200
187820,172907.9,930650,83690,47180.3,338450,104130,125727.6,592200
188310,171548.8,930650,83830,49684.3,338450,104480,121864.5,592200
188860,181864.2,930650,84030,53017.8,338450,104830,128846.4,592200
189440,181092.6,930650,84190,55812.9,338450,105250,125279.7,592200
189050,195814,930650,83840,67291.4,338450,105210,128522.6,592200
188570,207737,930650,83520,78010,338450,105050,129727,592200
188240,191739.5,930650,83190,65499.8,338450,105050,126239.7,592200
187840,214893.6,930650,82840,79529.3,338450,105000,135364.3,592200
186210,213680.7,930650,82070,75257.9,338450,104140,138422.8,592200
184560,233335.8,930650,81310,84998.7,338450,103250,148337.1,592200
182900,245780.3,930650,80510,92069.3,338450,102390,153711,592200
181310,237809,930650,79720,89940.4,338450,101590,147868.6,592200
180570,245921.7,930650,79460,103593.1,338450,101110,142328.6,592200
179870,248925.8,930650,79180,104265.1,338450,100690,144660.7,592200
179140,243717.3,930650,78880,104520.2,338450,100260,139197.1,592200
178410,236318.1,930650,78590,96894.2,338450,99820,139423.9,592200
178660,219938.5,930650,79100,82234.6,338450,99560,137703.9,592200
178920,212988.1,930650,79610,82026.9,338450,99310,130961.2,592200
179240,220221.1,930650,80150,82510.2,338450,99090,137710.9,592200
179430,224545.7,930650,80640,87198.4,338450,98790,137347.3,592200
179540,223035.7,930650,81880,87575.4,338450,97660,135460.3,592200
179700,229687.3,930650,83100,93378.4,338450,96600,136308.9,592200
179900,229968.1,930650,84340,93988.6,338450,95560,135979.5,592200
180050,216759.6,930650,85560,83275.7,338450,94490,133483.9,592200
180360,224957.4,930650,87180,92022.7,338450,93180,132934.7,592200
180600,216845.7,930650,88790,88437,338450,91810,128408.7,592200
180990,217415.7,930650,90400,88386.1,338450,90590,129029.6,592200
194160,186555.5,930650,86440,76559.4,338450,107720,109996.1,592200
194060,159438.3,930650,86920,59329.1,338450,107140,100109.2,592200
193890,156078.9,930650,87400,56018,338450,106490,100060.9,592200
193660,157114.6,930650,87850,52819.5,338450,105810,104295.1,592200
193520,156428.8,930650,88340,52384.9,338450,105180,104043.9,592200
189610,151246.5,930650,87880,49247.3,338450,101730,101999.2,592200
185690,152280.6,930650,87420,50533.9,338450,98270,101746.7,592200
181750,148929.4,930650,86950,49116.9,338450,94800,99812.5,592200
177830,142707.5,930650,86510,45904.2,338450,91320,96803.3,592200
173980,150781.1,930650,85830,54066.2,338450,88150,96714.9,592200
170170,151053.9,930650,85140,53036.6,338450,85030,98017.3,592200
166340,144919.4,930650,84450,45220.6,338450,81890,99698.8,592200
162470,146388.6,930650,83770,43799.1,338450,78700,102589.5,592200
157750,140085.1,930650,82250,42670,338450,75500,97415.1,592200
153030,158207.6,930650,80720,53030.9,338450,72310,105176.7,592200
148220,149697.3,930650,79180,47493.5,338450,69040,102203.8,592200
143480,150870,930650,77660,48605,338450,65820,102265,592200
138600,152254,930650,73280,48356.4,338450,65320,103897.6,592200
133780,142143.7,930650,68890,41281.4,338450,64890,100862.3,592200
128820,132337.1,930650,64500,29548.7,338450,64320,102788.4,592200
124020,115213.4,930650,60120,18510.7,338450,63900,96702.7,592200
120230,114713.3,930650,56620,15784.3,338450,63610,98929,592200
116440,120254,930650,53110,18835.4,338450,63330,101418.6,592200
112650,131667.1,930650,49600,21962.9,338450,63050,109704.2,592200
108830,139154.5,930650,46070,22309.2,338450,62760,116845.3,592200
105870,138150,930650,43120,23894.8,338450,62750,114255.2,592200
102980,133288.6,930650,40190,22488.9,338450,62790,110799.7,592200
100030,133607.9,930650,37250,23804.7,338450,62780,109803.2,592200
97090,134445.6,930650,34300,25754.1,338450,62790,108691.5,592200
98900,136544.1,930650,36720,31119.1,338450,62180,105425,592200
100740,131401.5,930650,39140,30078.9,338450,61600,101322.6,592200
102620,141762.6,930650,41560,36575.4,338450,61060,105187.2,592200
104390,149183.8,930650,43950,46082.7,338450,60440,103101.1,592200
106800,147927,930650,46770,47158.7,338450,60030,100768.3,592200
109150,150687,930650,49600,48413.9,338450,59550,102273.1,592200
111490,154622.3,930650,52430,49360.3,338450,59060,105262,592200
113910,158004.7,930650,55250,49920.2,338450,58660,108084.5,592200
115160,145973.5,930650,57190,47176,338450,57970,98797.5,592200
116380,136882.7,930650,59130,44509.3,338450,57250,92373.4,592200
117620,138424.1,930650,61080,44566.7,338450,56540,93857.4,592200
118800,140417.4,930650,63010,42799.6,338450,55790,97617.8,592200
118530,142695,930650,62870,43903.5,338450,55660,98791.5,592200
118140,130785.1,930650,62760,37451.5,338450,55380,93333.6,592200
117920,131591.3,930650,62630,38204.8,338450,55290,93386.5,592200
117560,135531,930650,62500,40123.4,338450,55060,95407.6,592200
117290,134985.6,930650,62070,39017.7,338450,55220,95967.9,592200
116990,141014.8,930650,61620,41434.2,338450,55370,99580.6,592200
116720,137914.7,930650,61220,37742,338450,55500,100172.7,592200
116450,141418.1,930650,60800,37783.3,338450,55650,103634.8,592200
116470,139782.8,930650,60510,37302.5,338450,55960,102480.3,592200
116530,127245.6,930650,60240,30158.3,338450,56290,97087.3,592200
116510,119790.5,930650,59950,26957.6,338450,56560,92832.9,592200
116570,119646.4,930650,59700,28741.9,338450,56870,90904.5,592200
116980,129244.2,930650,59870,37286.2,338450,57110,91958,592200
117440,132201.4,930650,60060,41525.2,338450,57380,90676.2,592200
117870,126267.9,930650,60250,39208,338450,57620,87059.9,592200
118280,126149.7,930650,60410,37946.3,338450,57870,88203.4,592200
118630,115104.7,930650,60500,28399.6,338450,58130,86705.1,592200
118900,109948,930650,60590,24212.8,338450,58310,85735.2,592200
119210,109818,930650,60640,26085.4,338450,58570,83732.6,592200
119520,105188.6,930650,60720,24902.5,338450,58800,80286.1,592200
121130,101084.4,930650,62170,21340,338450,58960,79744.4,592200
122780,100136.3,930650,63610,23358.4,338450,59170,76777.9,592200
124400,96501.8,930650,65030,20500.2,338450,59370,76001.6,592200
126040,96348.4,930650,66470,21650.8,338450,59570,74697.6,592200
127960,102895.7,930650,68710,25537.5,338450,59250,77358.2,592200
129850,99635.3,930650,70930,24549.6,338450,58920,75085.7,592200
131710,99743.8,930650,73170,25783.5,338450,58540,73960.3,592200
133680,90863.9,930650,75390,19997.6,338450,58290,70866.3,592200
134640,87229.8,930650,76730,17976.6,338450,57910,69253.2,592200
135580,81246.7,930650,78070,16422.1,338450,57510,64824.6,592200
136650,78167.3,930650,79390,14040.3,338450,57260,64127,592200
137610,76984.6,930650,80740,15435.5,338450,56870,61549.1,592200
139150,80084.3,930650,82470,17804.3,338450,56680,62280,592200
140600,80237.9,930650,84200,18185.4,338450,56400,62052.5,592200
142070,83659,930650,85900,21466.5,338450,56170,62192.5,592200
143540,85701,930650,87630,21126.2,338450,55910,64574.8,592200
144590,89551.1,930650,88070,24888.1,338450,56520,64663,592200
145490,95667.9,930650,88480,30258,338450,57010,65409.9,592200
146360,96472.8,930650,88890,30145,338450,57470,66327.8,592200
147370,113403.4,930650,89320,43737,338450,58050,69666.4,592200
148010,136232.5,930650,89420,59407.7,338450,58590,76824.8,592200
148670,152583.6,930650,89530,68927.7,338450,59140,83655.9,592200
149330,164576.6,930650,89630,76486.2,338450,59700,88090.4,592200
149980,136618.2,930650,89740,53677.4,338450,60240,82940.8,592200
149780,141058.1,930650,88950,54968.5,338450,60830,86089.6,592200
149550,157145.7,930650,88170,60673.8,338450,61380,96471.9,592200
149310,164777.7,930650,87390,64085,338450,61920,100692.7,592200
149100,161243.7,930650,86610,59625.5,338450,62490,101618.2,592200
149670,178560.6,930650,86850,70240.8,338450,62820,108319.8,592200
150210,170913.2,930650,87080,61725.4,338450,63130,109187.8,592200
150830,172766.1,930650,87340,58313.7,338450,63490,114452.4,592200
151360,207004.9,930650,87580,83033.1,338450,63780,123971.8,592200
151480,186986.3,930650,87040,69632.8,338450,64440,117353.5,592200
151620,188548.5,930650,86490,71998.3,338450,65130,116550.2,592200
151780,173176.6,930650,85950,60149.5,338450,65830,113027.1,592200
114480,169237.9,930650,65150,58937.5,338450,49330,110300.4,592200
116290,171070.8,930650,66700,66611.9,338450,49590,104458.9,592200
118060,181424.9,930650,68260,69967.9,338450,49800,111457,592200
119820,184311.4,930650,69820,70633.5,338450,50000,113677.9,592200
121660,184608.9,930650,71390,73354,338450,50270,111254.9,592200
124440,221192.2,930650,72330,96913,338450,52110,124279.2,592200
127300,223222.8,930650,73290,99544,338450,54010,123678.8,592200
130090,203933.4,930650,74240,88281.9,338450,55850,115651.5,592200
132870,216948.6,930650,75200,94744.9,338450,57670,122203.7,592200
135050,217807.5,930650,75610,97004.4,338450,59440,120803.1,592200
137170,214825.3,930650,76030,89271.5,338450,61140,125553.8,592200
139420,204025.1,930650,76470,81138,338450,62950,122887.1,592200
141620,203641.9,930650,76900,82564.6,338450,64720,121077.3,592200
141950,200542.3,930650,75320,75804.5,338450,66630,124737.8,592200
142300,179349.9,930650,73730,71147.7,338450,68570,108202.2,592200
142620,185086.9,930650,72140,67085.6,338450,70480,118001.3,592200
143040,153085.5,930650,70570,58903.3,338450,72470,94182.2,592200
143260,153157.7,930650,70180,58277.4,338450,73080,94880.3,592200
143500,161672.8,930650,69730,59840.7,338450,73770,101832.1,592200
143830,173101.5,930650,69320,60562.6,338450,74510,112538.9,592200
144050,202480.5,930650,68890,76794,338450,75160,125686.5,592200
143830,229570.1,930650,68510,93791,338450,75320,135779.1,592200
143670,206319.6,930650,68140,80272.2,338450,75530,126047.4,592200
143490,206577.5,930650,67790,79961.4,338450,75700,126616.1,592200
143280,215351.6,930650,67400,88468.5,338450,75880,126883.1,592200
142670,236993.2,930650,66330,110854.4,338450,76340,126138.8,592200
142120,256636.5,930650,65260,118161.2,338450,76860,138475.3,592200
141480,266168.8,930650,64190,119316.3,338450,77290,146852.5,592200
140910,257479.1,930650,63130,102409.5,338450,77780,155069.6,592200
135360,204774,930650,59130,62746.2,338450,76230,142027.8,592200
129790,167530.1,930650,55130,51967.1,338450,74660,115563,592200
124180,159764.3,930650,51110,41372.2,338450,73070,118392.1,592200
118620,160585,930650,47110,38328,338450,71510,122257,592200
112550,171244.5,930650,43020,35024,338450,69530,136220.5,592200
106570,151303.3,930650,38930,35718.4,338450,67640,115584.9,592200
100570,150678.8,930650,34860,33501,338450,65710,117177.8,592200
94640,167288.2,930650,30780,35418.3,338450,63860,131869.9,592200
89550,170108.1,930650,27600,34755.7,338450,61950,135352.4,592200
84500,179244.9,930650,24410,33511.2,338450,60090,145733.7,592200
79500,165618.2,930650,21240,27340.6,338450,58260,138277.6,592200
74490,143673.2,930650,18040,20430.1,338450,56450,123243.1,592200
72480,133183.6,930650,17800,18315.9,338450,54680,114867.7,592200
70590,122926.4,930650,17570,16550.6,338450,53020,106375.8,592200
68660,110000.4,930650,17340,13574.9,338450,51320,96425.5,592200
66710,104933.6,930650,17120,12284.5,338450,49590,92649.1,592200
63870,108161.8,930650,15750,13363,338450,48120,94798.8,592200
61030,107678.4,930650,14380,12921.8,338450,46650,94756.6,592200
58190,110558.7,930650,13000,12363.7,338450,45190,98195,592200
55360,108561.6,930650,11630,9629,338450,43730,98932.6,592200
53920,113151.1,930650,11630,10303.8,338450,42290,102847.3,592200
52450,117651.7,930650,11590,10482.1,338450,40860,107169.6,592200
51040,108983.2,930650,11580,9025.5,338450,39460,99957.7,592200
49590,110459.5,930650,11560,12173.2,338450,38030,98286.3,592200
48670,109271.5,930650,10480,13193.7,338450,38190,96077.8,592200
47850,113005.1,930650,9400,15772.3,338450,38450,97232.8,592200
47020,110211,930650,8350,15663.3,338450,38670,94547.7,592200
46190,105775,930650,7280,15270.9,338450,38910,90504.1,592200
46140,104252.3,930650,7150,14490.2,338450,38990,89762.1,592200
46000,102390.1,930650,6970,13094.8,338450,39030,89295.3,592200
45940,108218.4,930650,6820,15309.4,338450,39120,92909,592200
45860,116394.7,930650,6690,16236.1,338450,39170,100158.6,592200
45460,116607.6,930650,6320,15807.2,338450,39140,100800.4,592200
44980,113230.9,930650,5930,14818.7,338450,39050,98412.2,592200
44610,113592.8,930650,5560,14897.4,338450,39050,98695.4,592200
44150,110592.3,930650,5190,11160.2,338450,38960,99432.1,592200
42630,111081.8,930650,5070,10564.8,338450,37560,100517,592200
41030,108683.2,930650,4940,10432.8,338450,36090,98250.4,592200
39530,101682,930650,4820,9851.6,338450,34710,91830.4,592200
37860,102166.6,930650,4690,12931.5,338450,33170,89235.1,592200
36820,97336.9,930650,5150,10926.9,338450,31670,86410,592200
35650,93916.1,930650,5580,9153.7,338450,30070,84762.4,592200
34590,90985.3,930650,6040,9802.5,338450,28550,81182.8,592200
33490,88080.4,930650,6510,10351.1,338450,26980,77729.3,592200
31750,83440.4,930650,6280,7863.3,338450,25470,75577.1,592200
29980,84880.8,930650,6070,9693,338450,23910,75187.8,592200
28240,81621,930650,5850,8808.5,338450,22390,72812.5,592200
26560,82194,930650,5640,10099.5,338450,20920,72094.5,592200
25080,85143.8,930650,5060,12383.3,338450,20020,72760.5,592200
23660,85860.5,930650,4490,14970.8,338450,19170,70889.7,592200
22140,84232.6,930650,3880,12509.3,338450,18260,71723.3,592200
20720,85303.8,930650,3300,14798.8,338450,17420,70505,592200
19740,78076.2,930650,3060,11073.9,338450,16680,67002.3,592200
18600,73227.1,930650,2780,8199.8,338450,15820,65027.3,592200
17580,76838.9,930650,2520,11183.1,338450,15060,65655.8,592200
16580,82880.7,930650,2270,14749.5,338450,14310,68131.2,592200
15660,83037.9,930650,2080,14604.8,338450,13580,68433.1,592200
14740,83612.6,930650,1880,14772.4,338450,12860,68840.2,592200
13880,85545.9,930650,1720,16111.4,338450,12160,69434.5,592200
12990,90931.5,930650,1530,19814.9,338450,11460,71116.6,592200
12720,94483.5,930650,1600,23547,338450,11120,70936.5,592200
12570,96579,930650,1690,25266,338450,10880,71313,592200
12350,97984.6,930650,1780,25499.1,338450,10570,72485.5,592200
12140,103906.5,930650,1870,31709,338450,10270,72197.5,592200
12030,123154.9,930650,1960,44880.4,338450,10070,78274.5,592200
11920,137605.9,930650,2050,55611.8,338450,9870,81994.1,592200
11870,119344.3,930650,2160,41820.7,338450,9710,77523.6,592200
24130,102932.1,930650,15140,31702.5,338450,8990,71229.6,592200
24820,89184.9,930650,15610,22464.1,338450,9210,66720.8,592200
25480,87587.9,930650,16130,22198.3,338450,9350,65389.6,592200
26290,98021.2,930650,16650,29369.6,338450,9640,68651.6,592200
26990,95595.8,930650,17130,27324.9,338450,9860,68270.9,592200
27580,100072.1,930650,17940,29862.6,338450,9640,70209.5,592200
28240,105446.1,930650,18760,34057.3,338450,9480,71388.8,592200
28880,118033.8,930650,19580,43603.7,338450,9300,74430.1,592200
29530,111110,930650,20400,38490.3,338450,9130,72619.7,592200
29730,111078.1,930650,20820,37691.2,338450,8910,73386.9,592200
29970,114073.2,930650,21200,39437.5,338450,8770,74635.7,592200
30180,111518.1,930650,21620,37267.8,338450,8560,74250.3,592200
30390,99616.6,930650,22010,28486.3,338450,8380,71130.3,592200
31300,87770.4,930650,23070,19958.1,338450,8230,67812.3,592200
32220,83271.2,930650,24120,17895.4,338450,8100,65375.8,592200
33210,88873.5,930650,25190,22491.7,338450,8020,66381.8,592200
34150,114262.4,930650,26250,41282.1,338450,7900,72980.3,592200
34790,136636.3,930650,26980,57182,338450,7810,79454.3,592200
35440,148572.1,930650,27740,66257.6,338450,7700,82314.5,592200
36140,136720.4,930650,28480,58368.9,338450,7660,78351.5,592200
36810,126379.6,930650,29230,51580.4,338450,7580,74799.2,592200
37470,122933.2,930650,29840,49947.8,338450,7630,72985.4,592200
38220,125804.3,930650,30470,51626.4,338450,7750,74177.9,592200
38880,133156,930650,31090,55911.1,338450,7790,77244.9,592200
39550,126654.8,930650,31710,51476.3,338450,7840,75178.5,592200
40730,134683.3,930650,32610,58927.7,338450,8120,75755.6,592200
41840,123103.1,930650,33490,50969.7,338450,8350,72133.4,592200
42900,122943.9,930650,34350,50947.6,338450,8550,71996.3,592200
44040,111642.4,930650,35270,42426.3,338450,8770,69216.1,592200
46330,103698.3,930650,36850,38259.6,338450,9480,65438.7,592200
48620,107041,930650,38430,41578.5,338450,10190,65462.5,592200
50890,107639.6,930650,40040,40850.7,338450,10850,66788.9,592200
53200,109584.3,930650,41630,41085.7,338450,11570,68498.6,592200
55370,112229,930650,43190,42671.9,338450,12180,69557.1,592200
57510,115055.9,930650,44790,44853.1,338450,12720,70202.8,592200
59660,118364.5,930650,46390,46208.2,338450,13270,72156.3,592200
61820,125797.6,930650,47970,50273.8,338450,13850,75523.8,592200
62950,133190.3,930650,48800,55853.5,338450,14150,77336.8,592200
64090,144433,930650,49620,63090.7,338450,14470,81342.3,592200
65250,152827.9,930650,50470,66336.2,338450,14780,86491.7,592200
66390,152756.9,930650,51300,64033.6,338450,15090,88723.3,592200
66880,161892,930650,51330,68591.4,338450,15550,93300.6,592200
67270,165557.6,930650,51390,69604.8,338450,15880,95952.8,592200
67770,175154.4,930650,51450,75812.7,338450,16320,99341.7,592200
68190,179740.2,930650,51490,78566.8,338450,16700,101173.4,592200
69570,202806,930650,52180,93850.3,338450,17390,108955.7,592200
70850,205529.2,930650,52860,92823.2,338450,17990,112706,592200
72170,220486.5,930650,53540,105755.7,338450,18630,114730.8,592200
73530,212905,930650,54220,100455.8,338450,19310,112449.2,592200
75800,229696.5,930650,55590,114243.8,338450,20210,115452.7,592200
78070,212400.7,930650,57010,111833.9,338450,21060,100566.8,592200
80380,200971.4,930650,58410,103783.4,338450,21970,97188,592200
82610,203677.8,930650,59810,97011.2,338450,22800,106666.6,592200
82040,199461.4,930650,59820,97942.2,338450,22220,101519.2,592200
81440,173420.9,930650,59840,87677.6,338450,21600,85743.3,592200
80790,174969.6,930650,59850,90230.6,338450,20940,84739,592200
80200,207593.8,930650,59860,95626.5,338450,20340,111967.3,592200
79130,211119.9,930650,59480,99319.2,338450,19650,111800.7,592200
78010,199422.5,930650,59070,93402.9,338450,18940,106019.6,592200
76870,192269.6,930650,58690,93129.6,338450,18180,99140,592200
75770,184907.6,930650,58290,86028,338450,17480,98879.6,592200
73940,189146.9,930650,57360,88558.7,338450,16580,100588.2,592200
72170,185471.5,930650,56410,88878.6,338450,15760,96592.9,592200
70310,188183.6,930650,55440,91192.6,338450,14870,96991,592200
68510,184182,930650,54510,87043.4,338450,14000,97138.6,592200
68770,178327.7,930650,54870,82920.2,338450,13900,95407.5,592200
68980,183270.5,930650,55230,86171.2,338450,13750,97099.3,592200
69260,167182.5,930650,55620,73966.7,338450,13640,93215.8,592200
69550,154737.2,930650,55990,63724.1,338450,13560,91013.1,592200
69960,154420.4,930650,56130,63348.6,338450,13830,91071.8,592200
70340,147018.3,930650,56270,58309.1,338450,14070,88709.2,592200
70710,150018.5,930650,56420,62025.4,338450,14290,87993.1,592200
71110,160921.9,930650,56550,69263.7,338450,14560,91658.2,592200
71520,173204.5,930650,56070,79602.1,338450,15450,93602.4,592200
71890,170533.8,930650,55590,78390.6,338450,16300,92143.2,592200
72300,164102.6,930650,55130,72380.8,338450,17170,91721.8,592200
72710,164392,930650,54670,72514.1,338450,18040,91877.9,592200
73090,160741.6,930650,55180,68573.4,338450,17910,92168.2,592200
73400,163594.2,930650,55660,70364.4,338450,17740,93229.8,592200
73710,161506.1,930650,56130,73051.6,338450,17580,88454.5,592200
74070,175543.4,930650,56610,84636.5,338450,17460,90906.9,592200
75470,179828.7,930650,57420,86062.6,338450,18050,93766.1,592200
76850,198114,930650,58220,111607.6,338450,18630,86506.4,592200
78260,229538.9,930650,59050,122659.9,338450,19210,106879,592200
79600,232032.6,930650,59840,115718.2,338450,19760,116314.4,592200
81010,204544.9,930650,60250,95664.6,338450,20760,108880.3,592200
82430,195834.1,930650,60630,90249.6,338450,21800,105584.5,592200
83850,195616.7,930650,61020,89724.3,338450,22830,105892.4,592200
85220,198193.8,930650,61420,92605.1,338450,23800,105588.7,592200
86440,204389.1,930650,61720,97731.7,338450,24720,106657.4,592200
87600,197263.7,930650,61980,93139,338450,25620,104124.7,592200
88790,194742.8,930650,62290,92707.9,338450,26500,102034.9,592200
89940,202978.7,930650,62580,96511.9,338450,27360,106466.8,592200
91070,215442.7,930650,62790,104614.5,338450,28280,110828.2,592200
92160,207113.4,930650,63000,102167.2,338450,29160,104946.2,592200
93270,193788.7,930650,63210,99556.3,338450,30060,94232.4,592200
85050,219615.9,930650,50560,106247.3,338450,34490,113368.6,592200
85340,216123.1,930650,50250,101078.2,338450,35090,115044.9,592200
85690,199951.5,930650,49930,99344,338450,35760,100607.5,592200
85970,205597.2,930650,49620,98263.1,338450,36350,107334.1,592200
86300,210612.7,930650,49300,95517.6,338450,37000,115095.1,592200
87130,199445.4,930650,49950,86123.7,338450,37180,113321.7,592200
87940,215035.4,930650,50630,99549.4,338450,37310,115486,592200
88750,233627.7,930650,51280,112878.6,338450,37470,120749.1,592200
89620,233231.4,930650,51940,111970.1,338450,37680,121261.3,592200
90230,241526.6,930650,52530,117951.5,338450,37700,123575.1,592200
90870,243743.1,930650,53140,118729.2,338450,37730,125013.9,592200
91530,282008.8,930650,53750,147540.4,338450,37780,134468.4,592200
92200,285654.1,930650,54370,149722.5,338450,37830,135931.6,592200
93280,285626.1,930650,55480,150716.3,338450,37800,134909.8,592200
94320,279200.2,930650,56570,145572.1,338450,37750,133628.1,592200
95380,301233.5,930650,57700,152763.2,338450,37680,148470.3,592200
96400,277844.3,930650,58830,137770.6,338450,37570,140073.7,592200
95540,250865.7,930650,58660,132299.6,338450,36880,118566.1,592200
94610,252079.4,930650,58490,136272.7,338450,36120,115806.7,592200
93680,252138.8,930650,58300,133275.6,338450,35380,118863.2,592200
92820,237251.4,930650,58160,127941.1,338450,34660,109310.3,592200
92390,243291.7,930650,58270,132211.9,338450,34120,111079.8,592200
92040,230584.2,930650,58390,125157.6,338450,33650,105426.6,592200
91700,216132.7,930650,58510,115627.5,338450,33190,100505.2,592200
91300,212511.8,930650,58640,113994.7,338450,32660,98517.1,592200
91330,233720.9,930650,59030,130663.1,338450,32300,103057.8,592200
91470,238554.7,930650,59410,132592.3,338450,32060,105962.4,592200
91560,243281.1,930650,59800,133427.8,338450,31760,109853.3,592200
91620,251778.1,930650,60200,132031.3,338450,31420,119746.8,592200
92650,251807,930650,60930,128241.4,338450,31720,123565.6,592200
93660,234764.6,930650,61680,118250.4,338450,31980,116514.2,592200
94700,243720.2,930650,62410,115454.7,338450,32290,128265.5,592200
95690,224403.3,930650,63140,112541.1,338450,32550,111862.2,592200
95770,234956.1,930650,63010,114039.2,338450,32760,120916.9,592200
95910,247850.5,930650,62860,120630.6,338450,33050,127219.9,592200
96020,230007.8,930650,62740,114781.4,338450,33280,115226.4,592200
96080,225294.8,930650,62610,123033.2,338450,33470,102261.6,592200
96680,227165.3,930650,63140,124880.7,338450,33540,102284.6,592200
97180,206354.9,930650,63650,109690.1,338450,33530,96664.8,592200
97720,178357.2,930650,64210,90062.3,338450,33510,88294.9,592200
98320,180450.5,930650,64740,92548.8,338450,33580,87901.7,592200
98840,177855.8,930650,65860,92104.5,338450,32980,85751.3,592200
99400,173889.7,930650,67010,88561.2,338450,32390,85328.5,592200
99950,206198.4,930650,68140,112309.7,338450,31810,93888.7,592200
100530,237090.2,930650,69300,130905.2,338450,31230,106185,592200
99990,251425.2,930650,69330,142080.6,338450,30660,109344.6,592200
99430,246038.1,930650,69370,139567.7,338450,30060,106470.4,592200
98910,253966.9,930650,69370,145574,338450,29540,108392.9,592200
98370,281189.7,930650,69390,161871.3,338450,28980,119318.4,592200
99900,292591.9,930650,71450,170138,338450,28450,122453.9,592200
101470,299625.6,930650,73540,176756.9,338450,27930,122868.7,592200
102890,298831,930650,75590,178040.7,338450,27300,120790.3,592200
104400,285922.3,930650,77670,168600.4,338450,26730,117321.9,592200
104290,267905.9,930650,77740,155307.1,338450,26550,112598.8,592200
104060,280114.7,930650,77780,162073,338450,26280,118041.7,592200
103890,243922.2,930650,77840,137438.8,338450,26050,106483.4,592200
103710,232813,930650,77910,131820.9,338450,25800,100992.1,592200
103150,255134.1,930650,77470,144093,338450,25680,111041.1,592200
102730,257452.5,930650,77050,148348.9,338450,25680,109103.6,592200
102180,265415.3,930650,76600,151539.2,338450,25580,113876.1,592200
101640,272671.1,930650,76140,156185.6,338450,25500,116485.5,592200
101850,276661.1,930650,76080,157997.7,338450,25770,118663.4,592200
101990,284904.3,930650,76010,152862,338450,25980,132042.3,592200
102180,279082.8,930650,75950,161961.8,338450,26230,117121,592200
102290,276587.7,930650,75880,156364.4,338450,26410,120223.3,592200
104690,287281.4,930650,77270,152479.5,338450,27420,134801.9,592200
107070,255759.4,930650,78680,139556.2,338450,28390,116203.2,592200
109520,257451.4,930650,80100,141556.4,338450,29420,115895,592200
111850,247279.5,930650,81490,134567,338450,30360,112712.5,592200
114380,258819.8,930650,83240,143515.2,338450,31140,115304.6,592200
116880,253412.2,930650,84980,139639.6,338450,31900,113772.6,592200
119440,276955,930650,86710,154653,338450,32730,122302,592200
121970,286463.3,930650,88470,162109.5,338450,33500,124353.8,592200
124950,285001.6,930650,90970,167351.6,338450,33980,117650,592200
127980,280465.4,930650,93450,163815.4,338450,34530,116650,592200
131100,283552.4,930650,95970,164711.6,338450,35130,118840.8,592200
134100,274481.3,930650,98470,157110.3,338450,35630,117371,592200
134830,255825.9,930650,98230,147371.1,338450,36600,108454.8,592200
135470,286984.3,930650,97910,167573.6,338450,37560,119410.7,592200
136080,270752.6,930650,97660,155722.6,338450,38420,115030,592200
136790,242669.7,930650,97380,137765.2,338450,39410,104904.5,592200
138040,256272.2,930650,97590,133577.4,338450,40450,122694.8,592200
139340,222043.6,930650,97790,105339.2,338450,41550,116704.4,592200
140660,194261.3,930650,98000,92081.1,338450,42660,102180.2,592200
141900,188493.2,930650,98170,96094.4,338450,43730,92398.8,592200
143030,212804.3,930650,98240,103784.2,338450,44790,109020.1,592200
144160,214604,930650,98280,104885.5,338450,45880,109718.5,592200
145330,261288.3,930650,98340,131229,338450,46990,130059.3,592200
146490,287628.3,930650,98380,146437.4,338450,48110,141190.9,592200
148230,266116.9,930650,99490,142858.7,338450,48740,123258.2,592200
149910,261351.2,930650,100580,129239.7,338450,49330,132111.5,592200
151590,252843.2,930650,101670,136370.8,338450,49920,116472.4,592200
153350,251718,930650,102790,129363.1,338450,50560,122354.9,592200
154040,264493,930650,103030,142507.7,338450,51010,121985.3,592200
154800,265121.6,930650,103270,135542,338450,51530,129579.6,592200
155510,243578,930650,103510,132367.4,338450,52000,111210.6,592200
187980,232129.1,930650,118730,129878.2,338450,69250,102250.9,592200
189140,251214.2,930650,119030,140383.1,338450,70110,110831.1,592200
190240,260778.6,930650,119330,153113.8,338450,70910,107664.8,592200
191360,252497.3,930650,119630,148234.2,338450,71730,104263.1,592200
192460,238235.8,930650,119930,138074.3,338450,72530,100161.5,592200
193660,243637,930650,120100,142081.1,338450,73560,101555.9,592200
195000,262294.5,930650,120290,153250.2,338450,74710,109044.3,592200
196220,251506.5,930650,120480,143285.2,338450,75740,108221.3,592200
197510,245220.8,930650,120660,139593.7,338450,76850,105627.1,592200
198490,241362,930650,121140,138712.6,338450,77350,102649.4,592200
199490,255798.5,930650,121630,142740.6,338450,77860,113057.9,592200
200500,253671.2,930650,122120,145269,338450,78380,108402.2,592200
201470,256792.6,930650,122600,145422.6,338450,78870,111370,592200
201470,282397.7,930650,122390,155210.2,338450,79080,127187.5,592200
201510,277017.9,930650,122190,156965.6,338450,79320,120052.3,592200
201400,271939.4,930650,121970,150024,338450,79430,121915.4,592200
201410,293006.1,930650,121740,159707.8,338450,79670,133298.3,592200
200040,283807.3,930650,119840,157872.9,338450,80200,125934.4,592200
198690,290805,930650,117920,165283.6,338450,80770,125521.4,592200
197460,306282.2,930650,116030,174797.8,338450,81430,131484.4,592200
196090,320059.1,930650,114120,178612.8,338450,81970,141446.3,592200
194910,333772.4,930650,112460,180469.7,338450,82450,153302.7,592200
193820,329595.7,930650,110810,173569.4,338450,83010,156026.3,592200
192620,321493.8,930650,109170,172592.4,338450,83450,148901.4,592200
191490,308591.2,930650,107520,169776.6,338450,83970,138814.6,592200
190670,281596.3,930650,106330,153099,338450,84340,128497.3,592200
189890,291483.9,930650,105160,147352.6,338450,84730,144131.3,592200
189130,300495.4,930650,103990,154849.6,338450,85140,145645.8,592200
188220,314063.2,930650,102780,160700.3,338450,85440,153362.9,592200
189320,319264.2,930650,102790,158856,338450,86530,160408.2,592200
190420,309494.5,930650,102790,155886.5,338450,87630,153608,592200
191510,271314.3,930650,102820,137156.5,338450,88690,134157.8,592200
192570,262608.9,930650,102810,134363,338450,89760,128245.9,592200
193640,262154,930650,102650,124027.9,338450,90990,138126.1,592200
194680,250317.1,930650,102490,118576.7,338450,92190,131740.4,592200
195700,221525.4,930650,102290,108469.5,338450,93410,113055.9,592200
196720,232326.9,930650,102110,115726.5,338450,94610,116600.4,592200
197330,222665.3,930650,101730,109714.8,338450,95600,112950.5,592200
197960,210838.8,930650,101370,100608.9,338450,96590,110229.9,592200
198530,188839,930650,101000,84584.1,338450,97530,104254.9,592200
199090,173885.9,930650,100610,75713,338450,98480,98172.9,592200
191960,178968.4,930650,95660,77172.6,338450,96300,101795.8,592200
184730,162708.8,930650,90690,66067.6,338450,94040,96641.2,592200
177540,149313.8,930650,85750,54262.2,338450,91790,95051.6,592200
170360,165406.5,930650,80760,68059.3,338450,89600,97347.2,592200
162570,171044.8,930650,75370,73257.9,338450,87200,97786.9,592200
154830,169192.2,930650,69990,72024.9,338450,84840,97167.3,592200
147160,191812.4,930650,64620,87509.6,338450,82540,104302.8,592200
139350,168531.4,930650,59240,71558.3,338450,80110,96973.1,592200
131880,152814.5,930650,53910,58787,338450,77970,94027.5,592200
124320,148003.2,930650,48560,54229.7,338450,75760,93773.5,592200
116780,162866.8,930650,43210,64664.9,338450,73570,98201.9,592200
109290,164933.2,930650,37860,66157.6,338450,71430,98775.6,592200
107300,155956.8,930650,37690,58487.4,338450,69610,97469.4,592200
105300,153309.8,930650,37490,54321.6,338450,67810,98988.2,592200
103280,148222.3,930650,37290,51424.2,338450,65990,96798.1,592200
101320,166623.4,930650,37110,55406.2,338450,64210,111217.2,592200
99770,184260.1,930650,37330,59274.6,338450,62440,124985.5,592200
98250,161832.4,930650,37550,47017.7,338450,60700,114814.7,592200
96750,171635.2,930650,37760,49454.6,338450,58990,122180.6,592200
95200,178684,930650,37970,50916.1,338450,57230,127767.9,592200
92860,183289.4,930650,37360,54087.8,338450,55500,129201.6,592200
90410,173052.5,930650,36740,48140.8,338450,53670,124911.7,592200
88060,167795.2,930650,36140,46308.3,338450,51920,121486.9,592200
85570,163572.7,930650,35510,47311,338450,50060,116261.7,592200
82410,159145.7,930650,33810,48556.4,338450,48600,110589.3,592200
79220,163614.9,930650,32090,49256.8,338450,47130,114358.1,592200
76080,165068.4,930650,30370,46675.1,338450,45710,118393.3,592200
72880,159748.6,930650,28680,41862.1,338450,44200,117886.5,592200
70560,159860.5,930650,27790,41050.9,338450,42770,118809.6,592200
68260,153551.7,930650,26880,37646.7,338450,41380,115905,592200
65960,144694.8,930650,26020,32938.4,338450,39940,111756.4,592200
63630,139587.6,930650,25110,30972.2,338450,38520,108615.4,592200
60930,135199.3,930650,23850,26752.2,338450,37080,108447.1,592200
58210,124546.7,930650,22590,24336.8,338450,35620,100209.9,592200
55520,115161.5,930650,21370,19326.4,338450,34150,95835.1,592200
52810,113678.1,930650,20110,18401.4,338450,32700,95276.7,592200
50710,114837.4,930650,19090,18838.4,338450,31620,95999,592200
48630,108611.5,930650,18070,14851.2,338450,30560,93760.3,592200
46560,110510.6,930650,17060,17151,338450,29500,93359.6,592200
44430,106911.3,930650,16030,15855.1,338450,28400,91056.2,592200
42200,104878.2,930650,14840,14521.6,338450,27360,90356.6,592200
39900,105337.5,930650,13660,16047.8,338450,26240,89289.7,592200
37610,97138.9,930650,12490,11498.6,338450,25120,85640.3,592200
35330,94242.9,930650,11300,10336.4,338450,24030,83906.5,592200
33080,96823.5,930650,9950,13793,338450,23130,83030.5,592200
30790,92754.2,930650,8560,10421.5,338450,22230,82332.7,592200
28580,92445.6,930650,7210,9118.3,338450,21370,83327.3,592200
26290,88567.9,930650,5820,7564.6,338450,20470,81003.3,592200
24920,88924.8,930650,5450,8787.6,338450,19470,80137.2,592200
23470,94340.8,930650,5040,13063.9,338450,18430,81276.9,592200
22100,90916,930650,4650,12489.3,338450,17450,78426.7,592200
20690,91230.5,930650,4260,11786.8,338450,16430,79443.7,592200
19740,84331.8,930650,4240,8349.2,338450,15500,75982.6,592200
18800,83106.7,930650,4220,9428.8,338450,14580,73677.9,592200
17910,80013.2,930650,4220,7669.2,338450,13690,72344,592200
14390,79260.9,930650,3840,8695.6,338450,10550,70565.3,592200
13660,78575.1,930650,3950,9663.5,338450,9710,68911.6,592200
12930,77741.1,930650,4070,9511.6,338450,8860,68229.5,592200
12180,81085.4,930650,4170,10764.3,338450,8010,70321.1,592200
11430,79815.2,930650,4270,10025.8,338450,7160,69789.4,592200
10690,80440.5,930650,3940,9808.3,338450,6750,70632.2,592200
9930,84774.5,930650,3590,13945,338450,6340,70829.5,592200
9210,90158.1,930650,3240,18779.8,338450,5970,71378.3,592200
8460,88738.4,930650,2900,16126.2,338450,5560,72612.2,592200
7960,94688,930650,2630,19897.7,338450,5330,74790.3,592200
7410,90069.1,930650,2360,16424,338450,5050,73645.1,592200
6800,102998.2,930650,2080,25210.6,338450,4720,77787.6,592200
6300,103307,930650,1810,24285.1,338450,4490,79021.9,592200
5790,95341.4,930650,1580,19178.5,338450,4210,76162.9,592200
5280,95032.9,930650,1330,18845.4,338450,3950,76187.5,592200
4720,94392.5,930650,1070,20170.6,338450,3650,74221.9,592200
4230,91596,930650,820,17978.9,338450,3410,73617.1,592200
4250,93953.1,930650,890,19045.6,338450,3360,74907.5,592200
4340,97715.5,930650,960,21535.6,338450,3380,76179.9,592200
4330,102660.9,930650,1030,23802.9,338450,3300,78858,592200
4400,104730,930650,1100,24345.1,338450,3300,80384.9,592200
4470,107197.6,930650,1190,23708.6,338450,3280,83489,592200
4550,108397.9,930650,1260,24932.8,338450,3290,83465.1,592200
4590,117327.9,930650,1350,31216.9,338450,3240,86111,592200
4720,124376,930650,1450,35967.2,338450,3270,88408.8,592200
4800,128018.5,930650,1520,37705.8,338450,3280,90312.7,592200
4900,131235.2,930650,1580,38968.1,338450,3320,92267.1,592200
4910,127609.8,930650,1660,33388.1,338450,3250,94221.7,592200
5030,115125.9,930650,1730,31254.6,338450,3300,83871.3,592200
5410,112627,930650,1830,29156.3,338450,3580,83470.7,592200
5860,125660.9,930650,1900,30573,338450,3960,95087.9,592200
6230,108068.3,930650,1960,29201.7,338450,4270,78866.6,592200
6650,46788.4,930650,2040,20093.1,338450,4610,26695.3,592200
6990,44319.9,930650,2100,19425.7,338450,4890,24894.2,592200
7440,43905,930650,2210,18933,338450,5230,24972,592200
7800,50040,930650,2270,22544.4,338450,5530,27495.6,592200
8210,53812.7,930650,2360,24613.7,338450,5850,29199,592200
8510,66352.7,930650,2410,23945.8,338450,6100,42406.9,592200
8870,80455.9,930650,2510,21868.9,338450,6360,58587,592200
9190,77003.9,930650,2590,19440.9,338450,6600,57563,592200
9500,73262.8,930650,2670,17670.7,338450,6830,55592.1,592200
8990,67275.9,930650,2550,15636.2,338450,6440,51639.7,592200
8520,66044.8,930650,2430,13539.6,338450,6090,52505.2,592200
7970,58531.7,930650,2320,10635.8,338450,5650,47895.9,592200
7460,57738.4,930650,2200,9645.7,338450,5260,48092.7,592200
6960,58357.9,930650,2040,8649.8,338450,4920,49708.1,592200
6430,57319.7,930650,1900,8055.5,338450,4530,49264.2,592200
5880,53005.6,930650,1730,7095.8,338450,4150,45909.8,592200
5360,51692.6,930650,1570,5621.6,338450,3790,46071,592200
4910,53141.3,930650,1460,6180.4,338450,3450,46960.9,592200
4510,58630.4,930650,1360,9009.4,338450,3150,49621,592200
4050,57855.1,930650,1230,9407.9,338450,2820,48447.2,592200
3590,54755.9,930650,1120,8197.7,338450,2470,46558.2,592200
3540,54008.9,930650,1150,8078,338450,2390,45930.9,592200
3620,54018.1,930650,1180,7773.8,338450,2440,46244.3,592200
3650,55162.7,930650,1190,7327.1,338450,2460,47835.6,592200
3660,54552.2,930650,1210,7142.3,338450,2450,47409.9,592200
3730,55267.3,930650,1240,6735.2,338450,2490,48532.1,592200
3800,54057.4,930650,1290,6135.2,338450,2510,47922.2,592200
3780,53159.3,930650,1300,7028,338450,2480,46131.3,592200
3840,54243.2,930650,1350,6767.8,338450,2490,47475.4,592200
3900,51935.7,930650,1370,5358.5,338450,2530,46577.2,592200
4030,53911.8,930650,1440,6282.1,338450,2590,47629.7,592200
4050,58866.3,930650,1460,8733.8,338450,2590,50132.5,592200
4070,54857,930650,1480,9196.9,338450,2590,45660.1,592200
4830,51325.1,930650,1900,8823.8,338450,2930,42501.3,592200
5490,47786,930650,2260,5679.2,338450,3230,42106.8,592200
6180,46953.1,930650,2630,4997.4,338450,3550,41955.7,592200
6900,48133.8,930650,3030,4984.6,338450,3870,43149.2,592200
7650,47733.3,930650,3420,5064.5,338450,4230,42668.8,592200
8410,45883.1,930650,3810,4701.5,338450,4600,41181.6,592200
9130,47095.6,930650,4190,5707.9,338450,4940,41387.7,592200
9890,49197.8,930650,4570,6857.1,338450,5320,42340.7,592200
10670,54313.4,930650,5000,11094.1,338450,5670,43219.3,592200
11430,51089,930650,5380,9784,338450,6050,41305,592200
12220,48460.8,930650,5800,9036.6,338450,6420,39424.2,592200
13020,49816.6,930650,6210,9854,338450,6810,39962.6,592200
14250,50139.2,930650,7000,10585.5,338450,7250,39553.7,592200
15500,48660.4,930650,7780,9927,338450,7720,38733.4,592200
16660,49222.2,930650,8530,10001.2,338450,8130,39221,592200
17880,54405.1,930650,9300,12531.6,338450,8580,41873.5,592200
19180,61256.8,930650,10130,16431.1,338450,9050,44825.7,592200
20520,62980.4,930650,10950,18029.1,338450,9570,44951.3,592200
21780,58664.2,930650,11770,14321.6,338450,10010,44342.6,592200
23090,59239.8,930650,12570,14998.6,338450,10520,44241.2,592200
24260,63554.2,930650,13420,17236.1,338450,10840,46318.1,592200
25430,61633.2,930650,14230,15715.2,338450,11200,45918,592200
26580,61934,930650,15060,16614.3,338450,11520,45319.7,592200
27680,57868,930650,15890,14275.7,338450,11790,43592.3,592200
31370,58852.5,930650,18100,15441.6,338450,13270,43410.9,592200
34950,52379,930650,20270,11509,338450,14680,40870,592200
38610,49018.8,930650,22500,10939,338450,16110,38079.8,592200
42280,48885.8,930650,24730,10300.9,338450,17550,38584.9,592200
45570,75489.8,930650,26540,16611.1,338450,19030,58878.7,592200
48870,120012.5,930650,28400,37464.1,338450,20470,82548.4,592200
52160,122413.2,930650,30230,41001.7,338450,21930,81411.5,592200
36800,112273.5,930650,17640,32355.7,338450,19160,79917.8,592200
39430,108725.6,930650,19560,29551.7,338450,19870,79173.9,592200
42090,115359.7,930650,21500,32686.9,338450,20590,82672.8,592200
44740,126973.4,930650,23420,39226.7,338450,21320,87746.7,592200
47410,133666.1,930650,25360,39654.7,338450,22050,94011.4,592200
51100,136475.2,930650,27870,38362.1,338450,23230,98113.1,592200
54770,128531.2,930650,30380,31562.7,338450,24390,96968.5,592200
58470,127643.8,930650,32890,26487.3,338450,25580,101156.5,592200
62140,117587.5,930650,35390,21590.3,338450,26750,95997.2,592200
67830,100978.5,930650,39770,23810.5,338450,28060,77168,592200
73430,107596.9,930650,44130,32104.8,338450,29300,75492.1,592200
79100,109214,930650,48520,33696.1,338450,30580,75517.9,592200
84730,108498.5,930650,52900,38178.4,338450,31830,70320.1,592200
88110,107825.2,930650,54960,40632.7,338450,33150,67192.5,592200
91450,111123.5,930650,57010,43696.9,338450,34440,67426.6,592200
94870,149924.9,930650,59040,56932.1,338450,35830,92992.8,592200
98280,138611.1,930650,61120,51082.3,338450,37160,87528.8,592200
99330,148204.1,930650,62380,59600.5,338450,36950,88603.6,592200
100330,150079.6,930650,63650,60917.4,338450,36680,89162.2,592200
101430,162805.7,930650,64910,71297.9,338450,36520,91507.8,592200
102450,196418.6,930650,66180,94185,338450,36270,102233.6,592200
102950,199943,930650,66900,98311,338450,36050,101632,592200
103510,192921.5,930650,67640,99494.5,338450,35870,93427,592200
103960,212648,930650,68360,103531.8,338450,35600,109116.2,592200
104510,227313,930650,69110,113525.3,338450,35400,113787.7,592200
104710,220934.6,930650,69320,109012.2,338450,35390,111922.4,592200
104860,217734,930650,69550,105860.2,338450,35310,111873.8,592200
104950,241130.3,930650,69750,120069.1,338450,35200,121061.2,592200
105160,250076.3,930650,69990,126400.9,338450,35170,123675.4,592200
100330,256538.8,930650,66680,132855.6,338450,33650,123683.2,592200
95590,266839,930650,63360,141676.4,338450,32230,125162.6,592200
90750,258272,930650,60050,136799.2,338450,30700,121472.8,592200
85970,247140.1,930650,56740,131267.1,338450,29230,115873,592200
81380,225904.4,930650,53750,117375,338450,27630,108529.4,592200
76780,216474.4,930650,50760,112117.6,338450,26020,104356.8,592200
72120,219396,930650,47760,116231.9,338450,24360,103164.1,592200
67520,203805.9,930650,44760,108240.4,338450,22760,95565.5,592200
63040,195830.2,930650,41790,97251.7,338450,21250,98578.5,592200
58530,192938.5,930650,38800,94953.7,338450,19730,97984.8,592200
54090,203344.5,930650,35840,103437.3,338450,18250,99907.2,592200
49620,204817.2,930650,32870,105771.6,338450,16750,99045.6,592200
46930,189387.9,930650,31200,94930.5,338450,15730,94457.4,592200
44220,172195.5,930650,29540,81399.7,338450,14680,90795.8,592200
41590,145975.1,930650,27850,61772.2,338450,13740,84202.9,592200
38930,123450.6,930650,26190,46992.9,338450,12740,76457.7,592200
36360,108275.4,930650,24620,35520.7,338450,11740,72754.7,592200
33810,104441.1,930650,23040,31081.9,338450,10770,73359.2,592200
31260,100155.5,930650,21440,24971.6,338450,9820,75183.9,592200
28690,97454.6,930650,19880,23301.7,338450,8810,74152.9,592200
26670,88878,930650,18600,20027,338450,8070,68851,592200
24580,95439.1,930650,17320,25871.5,338450,7260,69567.6,592200
22500,98196.7,930650,16030,26605,338450,6470,71591.7,592200
20440,99078,930650,14730,27074.1,338450,5710,72003.9,592200
20310,103647.4,930650,14370,29089.8,338450,5940,74557.6,592200
20270,107525.1,930650,14010,31515.6,338450,6260,76009.5,592200
20150,104841.5,930650,13650,29333.7,338450,6500,75507.8,592200
20070,104288.8,930650,13290,28057.7,338450,6780,76231.1,592200
20140,115354.2,930650,13170,36399.8,338450,6970,78954.4,592200
20190,123297.5,930650,13020,43121.1,338450,7170,80176.4,592200
20300,121527.1,930650,12890,43444.7,338450,7410,78082.4,592200
20340,120701.1,930650,12750,42602,338450,7590,78099.1,592200
20130,115406.1,930650,12410,39114.3,338450,7720,76291.8,592200
19940,110325.1,930650,12060,34774.8,338450,7880,75550.3,592200
19710,108926.6,930650,11750,32918.8,338450,7960,76007.8,592200
19480,108197.4,930650,11380,32825.4,338450,8100,75372,592200
20770,103609.1,930650,11860,30289.7,338450,8910,73319.4,592200
21990,101851.3,930650,12340,30033,338450,9650,71818.3,592200
23290,101407.5,930650,12830,29735.1,338450,10460,71672.4,592200
24580,106925.8,930650,13310,32774.7,338450,11270,74151.1,592200
26190,115449.6,930650,14110,39651.8,338450,12080,75797.8,592200
27730,123540.7,930650,14890,45562.3,338450,12840,77978.4,592200
29360,122551.2,930650,15680,45500,338450,13680,77051.2,592200
30960,121673.7,930650,16460,45736,338450,14500,75937.7,592200
32750,119366.8,930650,17310,44770.3,338450,15440,74596.5,592200
34600,117045.5,930650,18150,42724.5,338450,16450,74321,592200
36420,116471,930650,18950,41943,338450,17470,74528,592200
38290,120358.8,930650,19780,44691.7,338450,18510,75667.1,592200
39430,119377,930650,20630,43059.7,338450,18800,76317.3,592200
40560,112225.5,930650,21470,38043.6,338450,19090,74181.9,592200
41690,102681.9,930650,22300,30910.9,338450,19390,71771,592200
42860,99290.6,930650,23140,28070.6,338450,19720,71220,592200
43930,90867.3,930650,23940,22837.7,338450,19990,68029.6,592200
45000,86324.6,930650,24760,19023.9,338450,20240,67300.7,592200
46070,81300.1,930650,25570,15306.5,338450,20500,65993.6,592200
47120,81697.4,930650,26370,15441.9,338450,20750,66255.5,592200
48020,63803.7,930650,27160,16684.7,338450,20860,47119,592200
48970,58359.4,930650,27950,16882.6,338450,21020,41476.8,592200
49860,64045.5,930650,28730,20317.4,338450,21130,43728.1,592200
50760,69601.1,930650,29510,24395.5,338450,21250,45205.6,592200
51840,102295.3,930650,30250,31325.8,338450,21590,70969.5,592200
52910,108750.4,930650,31010,37511.7,338450,21900,71238.7,592200
54030,110014.1,930650,31750,38340.6,338450,22280,71673.5,592200
55090,108839.1,930650,32480,36043.8,338450,22610,72795.3,592200
56530,114046.5,930650,33540,37950.2,338450,22990,76096.3,592200
58020,117676.4,930650,34600,41399.6,338450,23420,76276.8,592200
59420,109793.6,930650,35680,35618,338450,23740,74175.6,592200
26330,93882.2,930650,10470,20251.3,338450,15860,73630.9,592200
27440,91770.9,930650,11080,16632.1,338450,16360,75138.8,592200
28580,104138,930650,11680,24104.5,338450,16900,80033.5,592200
29680,127232.6,930650,12280,39000.9,338450,17400,88231.7,592200
30710,135377.7,930650,12880,40276.8,338450,17830,95100.9,592200
34010,120550,930650,14530,26110.8,338450,19480,94439.2,592200
37330,113284.3,930650,16190,20176,338450,21140,93108.3,592200
40560,111464.5,930650,17830,20283,338450,22730,91181.5,592200
43930,113544.1,930650,19510,20098.2,338450,24420,93445.9,592200
47050,113787.6,930650,20970,18983.9,338450,26080,94803.7,592200
50280,119671.2,930650,22420,22809.6,338450,27860,96861.6,592200
53480,117634.3,930650,23860,25369.9,338450,29620,92264.4,592200
56620,124024.8,930650,25290,32306.9,338450,31330,91717.9,592200
60050,140606.8,930650,27010,41136.8,338450,33040,99470,592200
63430,144457.9,930650,28710,42256.5,338450,34720,102201.4,592200
66870,120825.4,930650,30420,36100.2,338450,36450,84725.2,592200
70260,143786.7,930650,32120,36681.8,338450,38140,107104.9,592200
75740,128534.7,930650,34960,41410.3,338450,40780,87124.4,592200
81200,132125.5,930650,37790,46743.9,338450,43410,85381.6,592200
86710,135646.1,930650,40630,52277.1,338450,46080,83369,592200
92210,142990.2,930650,43460,56506.2,338450,48750,86484,592200
97860,153934.3,930650,46390,62287.6,338450,51470,91646.7,592200
103530,158844.3,930650,49330,64162.6,338450,54200,94681.7,592200
109080,164043.5,930650,52230,68204.5,338450,56850,95839,592200
114780,153365.1,930650,55160,62549.6,338450,59620,90815.5,592200
120730,146134.4,930650,58220,57170.4,338450,62510,88964,592200
126640,155916.1,930650,61240,59997,338450,65400,95919.1,592200
132610,168936.4,930650,64310,63823.3,338450,68300,105113.1,592200
138510,176730.6,930650,67350,65492.5,338450,71160,111238.1,592200
144040,173708.5,930650,71050,61357.7,338450,72990,112350.8,592200
149540,162805.6,930650,74740,53348.8,338450,74800,109456.8,592200
155030,166968.8,930650,78420,59920.3,338450,76610,107048.5,592200
160590,177777.7,930650,82140,70559.4,338450,78450,107218.3,592200
166050,192815.8,930650,85790,80621.9,338450,80260,112193.9,592200
171510,192490.4,930650,89460,82001.7,338450,82050,110488.7,592200
176940,192392.6,930650,93120,83720.9,338450,83820,108671.7,592200
182450,194213.8,930650,96780,87720.2,338450,85670,106493.6,592200
187770,193305.3,930650,100270,91358.5,338450,87500,101946.8,592200
193050,198170,930650,103730,96934.1,338450,89320,101235.9,592200
198400,204237.9,930650,107240,104286.6,338450,91160,99951.3,592200
203690,195483.7,930650,110710,101519.8,338450,92980,93963.9,592200
205080,188372.5,930650,112600,97580.8,338450,92480,90791.7,592200
206510,185269.1,930650,114460,94869,338450,92050,90400.1,592200
207920,197283.2,930650,116330,93966.3,338450,91590,103316.9,592200
209300,199689,930650,118190,92382,338450,91110,107307,592200
210460,212794,930650,120050,101791.1,338450,90410,111002.9,592200
211560,227159.2,930650,121900,115884.5,338450,89660,111274.7,592200
212690,232278.2,930650,123770,123753.7,338450,88920,108524.5,592200
213800,247207,930650,125610,123599.6,338450,88190,123607.4,592200
214260,229798.9,930650,127270,119947.4,338450,86990,109851.5,592200
214810,220865.1,930650,128910,115603.1,338450,85900,105262,592200
215330,223584,930650,130550,117631.8,338450,84780,105952.2,592200
215850,218574.2,930650,132190,114240.3,338450,83660,104333.9,592200
221090,209949.5,930650,134870,108410.9,338450,86220,101538.6,592200
226350,218722.8,930650,137550,106511.6,338450,88800,112211.2,592200
231570,210042.9,930650,140250,106945.9,338450,91320,103097,592200
236790,217734.3,930650,142910,113561.3,338450,93880,104173,592200
242470,240070.9,930650,145500,127647.3,338450,96970,112423.6,592200
248140,258432,930650,148070,140455.6,338450,100070,117976.4,592200
253850,289956.4,930650,150630,158037.5,338450,103220,131918.9,592200
259520,312085.9,930650,153230,169677.4,338450,106290,142408.5,592200
265600,330268.8,930650,155810,181563.1,338450,109790,148705.7,592200
271760,333257.3,930650,158440,185371.8,338450,113320,147885.5,592200
277900,344965.5,930650,161080,190823.1,338450,116820,154142.4,592200
283960,346414.2,930650,163680,192655,338450,120280,153759.2,592200
289110,362719.3,930650,165720,201578.1,338450,123390,161141.2,592200
294170,359414.8,930650,167730,201702.5,338450,126440,157712.3,592200
299300,369301.1,930650,169780,208443.2,338450,129520,160857.9,592200
304480,370118.2,930650,171820,211256.5,338450,132660,158861.7,592200
309240,382572.7,930650,173780,215109.8,338450,135460,167462.9,592200
313980,390389.2,930650,175730,219587.9,338450,138250,170801.3,592200
318800,394761.6,930650,177660,220568.1,338450,141140,174193.5,592200
323640,395190.3,930650,179630,222250.9,338450,144010,172939.4,592200
328210,395794.5,930650,181600,223556.8,338450,146610,172237.7,592200
332830,397982.2,930650,183560,222871.5,338450,149270,175110.7,592200
337450,399149.6,930650,185560,224238.1,338450,151890,174911.5,592200
342050,408372.6,930650,187520,226895.5,338450,154530,181477.1,592200
337850,414183.1,930650,185940,229098.2,338450,151910,185084.9,592200
333810,413943.4,930650,184330,231278.2,338450,149480,182665.2,592200
329680,412807.7,930650,182730,230956.4,338450,146950,181851.3,592200
325520,397657,930650,181150,225167.1,338450,144370,172489.9,592200
321160,391993.1,930650,179380,221755.1,338450,141780,170238,592200
316770,390555.3,930650,177610,221850,338450,139160,168705.3,592200
312470,388988.8,930650,175860,222264.1,338450,136610,166724.7,592200
308060,387123,930650,174100,221821.8,338450,133960,165301.2,592200
303720,382132.9,930650,172260,217762.5,338450,131460,164370.4,592200
299400,370491.7,930650,170410,213735.5,338450,128990,156756.2,592200
295000,358736.5,930650,168580,208348.5,338450,126420,150388,592200
290650,351780.4,930650,166750,206180,338450,123900,145600.4,592200
287210,336754.5,930650,165480,199483.6,338450,121730,137270.9,592200
283790,328503.5,930650,164230,197768.3,338450,119560,130735.2,592200
280420,320060.1,930650,162980,191283.7,338450,117440,128776.4,592200
277010,316974.9,930650,161730,188051.4,338450,115280,128923.5,592200
274020,311237.3,930650,160790,184579.7,338450,113230,126657.6,592200
271110,306819.1,930650,159870,180453,338450,111240,126366.1,592200
268120,303142.5,930650,158940,176010.1,338450,109180,127132.4,592200
266280,307207.1,930650,156620,173671.9,338450,109660,133535.2,592200
260910,295709.2,930650,154470,164017.2,338450,106440,131692,592200
255550,275778.2,930650,152340,157959.6,338450,103210,117818.6,592200
250160,284197.5,930650,150200,161277.5,338450,99960,122920,592200
244790,289883.3,930650,148080,157066.8,338450,96710,132816.5,592200
244440,276803.3,930650,148420,162153.2,338450,96020,114650.1,592200
244100,276689,930650,148760,163445.6,338450,95340,113243.4,592200
243770,285950,930650,149100,157474.8,338450,94670,128475.2,592200
243260,273913.6,930650,149420,150614.8,338450,93840,123298.8,592200
242660,269354.5,930650,149400,145967.3,338450,93260,123387.2,592200
241880,267853.5,930650,149340,143419.9,338450,92540,124433.6,592200
241190,264393.1,930650,149310,142798.6,338450,91880,121594.5,592200
240470,240772.7,930650,149280,137252.1,338450,91190,103520.6,592200
239740,255071.5,930650,149160,139248,338450,90580,115823.5,592200
238980,264764,930650,149050,141955.5,338450,89930,122808.5,592200
238350,268019.4,930650,148950,146423.2,338450,89400,121596.2,592200
237580,274020.3,930650,148850,152682.4,338450,88730,121337.9,592200
236340,284205.4,930650,147430,162260.3,338450,88910,121945.1,592200
235150,297144.3,930650,146030,172036.4,338450,89120,125107.9,592200
233840,291887.3,930650,144610,172284.6,338450,89230,119602.7,592200
232600,277426.8,930650,143200,172839.5,338450,89400,104587.3,592200
231460,298081.9,930650,141920,180053.6,338450,89540,118028.3,592200
230410,310942.7,930650,140640,185729.5,338450,89770,125213.2,592200
229220,309773.3,930650,139360,185551,338450,89860,124222.3,592200
228080,310311.6,930650,138070,182902.3,338450,90010,127409.3,592200
226710,291116,930650,136630,170420.5,338450,90080,120695.5,592200
225240,295840.2,930650,135170,169164,338450,90070,126676.2,592200
223850,298579,930650,133720,166636.6,338450,90130,131942.4,592200
222440,287264.2,930650,132290,161656,338450,90150,125608.2,592200
219370,291848,930650,129840,162660.3,338450,89530,129187.7,592200
216360,292793.3,930650,127420,162340.1,338450,88940,130453.2,592200
213390,295180.4,930650,124970,163598.6,338450,88420,131581.8,592200
210340,286627.9,930650,122540,158934.8,338450,87800,127693.1,592200
207240,271542,930650,120040,150257.8,338450,87200,121284.2,592200
204090,264626.3,930650,117530,143883.4,338450,86560,120742.9,592200
200990,258259.4,930650,115030,138517,338450,85960,119742.4,592200
197880,262269,930650,112520,140925,338450,85360,121344,592200
194930,254239.6,930650,110380,132854.3,338450,84550,121385.3,592200
191870,251460.7,930650,108210,131495.4,338450,83660,119965.3,592200
188860,254759.1,930650,106070,133917.4,338450,82790,120841.7,592200
185890,254360.1,930650,103920,132866.8,338450,81970,121493.3,592200
180600,253803.5,930650,100880,131578.1,338450,79720,122225.4,592200
175360,230369.9,930650,97850,117145.1,338450,77510,113224.8,592200
170040,231525.8,930650,94780,118729,338450,75260,112796.8,592200
164720,227440.7,930650,91750,118900.9,338450,72970,108539.8,592200
159790,226082.8,930650,88780,116745.8,338450,71010,109337,592200
154880,224597.9,930650,85770,115874.1,338450,69110,108723.8,592200
149890,216594.3,930650,82770,109824.8,338450,67120,106769.5,592200
144990,199917.5,930650,79810,98709.2,338450,65180,101208.3,592200
139560,186102.2,930650,76530,88557.2,338450,63030,97545,592200
134050,183227.3,930650,73260,85855.7,338450,60790,97371.6,592200
128620,180105.8,930650,70030,85103.6,338450,58590,95002.2,592200
123090,187976.7,930650,66760,92344,338450,56330,95632.7,592200
124260,184166.5,930650,66420,88828.4,338450,57840,95338.1,592200
125300,195295.9,930650,66070,96067.6,338450,59230,99228.3,592200
126400,195916.9,930650,65720,93506.2,338450,60680,102410.7,592200
127590,193531.2,930650,65390,91250.2,338450,62200,102281,592200
129000,201272.1,930650,65040,95599.6,338450,63960,105672.5,592200
130490,207417.8,930650,64660,96013.6,338450,65830,111404.2,592200
131970,187983.3,930650,64310,90186.9,338450,67660,97796.4,592200
133360,193306.7,930650,63940,87392.8,338450,69420,105913.9,592200
135980,199421.4,930650,64420,91291.1,338450,71560,108130.3,592200
138610,182746.1,930650,64880,92317.9,338450,73730,90428.2,592200
141180,188340.7,930650,65340,90064.3,338450,75840,98276.4,592200
143770,180124.9,930650,65810,86956.4,338450,77960,93168.5,592200
145290,181076.4,930650,65950,87414.6,338450,79340,93661.8,592200
146850,206347.9,930650,66140,95190.9,338450,80710,111157,592200
148430,223609.3,930650,66270,98153.5,338450,82160,125455.8,592200
149980,226509.7,930650,66440,104585,338450,83540,121924.7,592200
151070,211747.5,930650,66510,104643.4,338450,84560,107104.1,592200
152140,222044.5,930650,66570,110610.8,338450,85570,111433.7,592200
153200,234296.4,930650,66620,116241.3,338450,86580,118055.1,592200
154320,278225.9,930650,66710,131283,338450,87610,146942.9,592200
154620,275007.9,930650,66390,130984.1,338450,88230,144023.8,592200
154930,271997.7,930650,66070,121623.4,338450,88860,150374.3,592200
155210,245927,930650,65730,108278,338450,89480,137649,592200
155480,215567.3,930650,65440,94008.2,338450,90040,121559.1,592200
149910,207766.7,930650,62630,92696.4,338450,87280,115070.3,592200
144360,234323.9,930650,59820,108320.2,338450,84540,126003.7,592200
138870,237503.2,930650,57020,113414.8,338450,81850,124088.4,592200
133290,226609.8,930650,54200,106985.5,338450,79090,119624.3,592200
128020,242020.9,930650,52100,109254.6,338450,75920,132766.3,592200
122750,252820,930650,49990,112171,338450,72760,140649,592200
117440,242779.7,930650,47880,98738.2,338450,69560,144041.5,592200
112240,224854.2,930650,45800,96842.7,338450,66440,128011.5,592200
106200,196829,930650,42860,83644.8,338450,63340,113184.2,592200
100150,180143.3,930650,39910,74600.4,338450,60240,105542.9,592200
94100,197311.6,930650,36960,84859.3,338450,57140,112452.3,592200
88020,199243.9,930650,34010,76106.5,338450,54010,123137.4,592200
82950,184844.3,930650,31700,63780,338450,51250,121064.3,592200
77770,162336.5,930650,29370,49129.5,338450,48400,113207,592200
72590,161918.4,930650,27060,49675.2,338450,45530,112243.2,592200
67520,162782.9,930650,24750,50506.2,338450,42770,112276.7,592200
62860,177464.5,930650,22750,61030.7,338450,40110,116433.8,592200
58330,179921.3,930650,20770,60962.4,338450,37560,118958.9,592200
53660,178253.7,930650,18760,58649.1,338450,34900,119604.6,592200
51780,167818.7,930650,19970,51033.4,338450,31810,116785.3,592200
46540,148840.3,930650,17100,41083.2,338450,29440,107757.1,592200
41290,133082.7,930650,14260,33937.8,338450,27030,99144.9,592200
36000,117966.8,930650,11410,23823.7,338450,24590,94143.1,592200
30760,109396,930650,8570,19876.7,338450,22190,89519.3,592200
28860,105108.1,930650,7880,17444.7,338450,20980,87663.4,592200
26990,103255,930650,7240,18372,338450,19750,84883,592200
25030,91358.2,930650,6560,13059.8,338450,18470,78298.4,592200
23170,86346.9,930650,5890,10150,338450,17280,76196.9,592200
21620,82750.1,930650,5440,9974,338450,16180,72776.1,592200
20090,79341,930650,4990,8437.9,338450,15100,70903.1,592200
18530,77426.5,930650,4520,6703.1,338450,14010,70723.4,592200
17010,74538.9,930650,4080,6546.7,338450,12930,67992.2,592200
15710,72867.1,930650,3680,6323.9,338450,12030,66543.2,592200
14350,71830.6,930650,3300,5637.3,338450,11050,66193.3,592200
13050,72797.2,930650,2910,5470.4,338450,10140,67326.8,592200
11690,72851.5,930650,2500,5592,338450,9190,67259.5,592200
10960,71120.8,930650,2310,5268.2,338450,8650,65852.6,592200
10190,70821.8,930650,2120,5510.5,338450,8070,65311.3,592200
9420,69150.7,930650,1930,5154.5,338450,7490,63996.2,592200
8680,69198.5,930650,1750,5368,338450,6930,63830.5,592200
7850,68689.7,930650,1520,5447.5,338450,6330,63242.2,592200
7000,68484.9,930650,1290,5569.3,338450,5710,62915.6,592200
6230,68175.4,930650,1080,5419.8,338450,5150,62755.6,592200
5350,67832.3,930650,830,5062.5,338450,4520,62769.8,592200
4710,66604.4,930650,710,4801,338450,4000,61803.4,592200
3990,66172.1,930650,550,4801,338450,3440,61371.1,592200
3290,66570.9,930650,410,5090.4,338450,2880,61480.5,592200
2560,68098.5,930650,250,5082.8,338450,2310,63015.7,592200
3580,66731.2,930650,1110,5170.8,338450,2470,61560.4,592200
4670,63772.4,930650,2010,5381,338450,2660,58391.4,592200
5640,65442.4,930650,2870,6859.1,338450,2770,58583.3,592200
6660,116117.7,930650,3750,44853.6,338450,2910,71264.1,592200
7980,95972.5,930650,4750,30370.9,338450,3230,65601.6,592200
9250,81417.8,930650,5740,18996.7,338450,3510,62421.1,592200
10510,77378.4,930650,6710,16254.8,338450,3800,61123.6,592200
11780,80099.3,930650,7730,16872,338450,4050,63227.3,592200
13640,79895.3,930650,9200,15807.1,338450,4440,64088.2,592200
15560,84601.4,930650,10690,17654.7,338450,4870,66946.7,592200
17380,81528.1,930650,12150,13694,338450,5230,67834.1,592200
19250,80866.6,930650,13620,13659.4,338450,5630,67207.2,592200
25100,77372.3,930650,18580,12107.3,338450,6520,65265,592200
30920,73093.3,930650,23520,9918.4,338450,7400,63174.9,592200
36780,71053.6,930650,28510,10497.4,338450,8270,60556.2,592200
42610,65969.3,930650,33450,10274.4,338450,9160,55694.9,592200
48050,63182.1,930650,38380,10522.6,338450,9670,52659.5,592200
53520,66011.9,930650,43320,11250,338450,10200,54761.9,592200
59020,64754.4,930650,48260,11965.7,338450,10760,52788.7,592200
64460,64729.8,930650,53180,12285.9,338450,11280,52443.9,592200
71080,61663,930650,59340,12116.3,338450,11740,49546.7,592200
77730,64059.7,930650,65510,12514.6,338450,12220,51545.1,592200
84330,65416.2,930650,71680,13265.6,338450,12650,52150.6,592200
90950,66541.3,930650,77840,13960.9,338450,13110,52580.4,592200
99560,82142.9,930650,83870,27003.8,338450,15690,55139.1,592200
108190,126490.1,930650,89920,62758.3,338450,18270,63731.8,592200
116810,206169.2,930650,95950,123724.7,338450,20860,82444.5,592200
125490,216637.8,930650,102000,131952.7,338450,23490,84685.1,592200
134740,228313.3,930650,108450,142589.2,338450,26290,85724.1,592200
143970,254332,930650,114890,159634.3,338450,29080,94697.7,592200
153250,269326.4,930650,121360,170681.7,338450,31890,98644.7,592200
162460,261781.7,930650,127800,168312.5,338450,34660,93469.2,592200
171150,259625,930650,133480,165236,338450,37670,94389,592200
179860,252485.5,930650,139190,158555,338450,40670,93930.5,592200
188610,254071.9,930650,144900,158858.7,338450,43710,95213.2,592200
197320,273959.8,930650,150570,168438,338450,46750,105521.8,592200
216010,279515.4,930650,157300,173706,338450,58710,105809.4,592200
234690,294598,930650,163980,182526.9,338450,70710,112071.1,592200
253380,307353.4,930650,170670,187304.4,338450,82710,120049,592200
272090,310705.2,930650,177390,193476.5,338450,94700,117228.7,592200
291540,335396.3,930650,183910,204456,338450,107630,130940.3,592200
310970,360210.7,930650,190430,209020.9,338450,120540,151189.8,592200
330390,365117.6,930650,196980,215528,338450,133410,149589.6,592200
349830,400707.8,930650,203490,231570.2,338450,146340,169137.6,592200
369350,420836.2,930650,210180,237666,338450,159170,183170.2,592200
388840,447329.1,930650,216870,241619.2,338450,171970,205709.9,592200
408440,454076.9,930650,223570,237879,338450,184870,216197.9,592200
427960,471339.1,930650,230240,242005.4,338450,197720,229333.7,592200
443010,482787.5,930650,232110,245500.8,338450,210900,237286.7,592200
458020,511774.7,930650,233960,250607.6,338450,224060,261167.1,592200
473000,542530.7,930650,235840,260788.1,338450,237160,281742.6,592200
488070,559706.7,930650,237690,267077,338450,250380,292629.7,592200
502010,581694.8,930650,238710,275953.8,338450,263300,305741,592200
516030,593656.4,930650,239750,277658.7,338450,276280,315997.7,592200
529980,609900,930650,240780,281565,338450,289200,328335,592200
543990,612513.8,930650,241800,281292.2,338450,302190,331221.6,592200
554610,630061.1,930650,240030,281729.8,338450,314580,348331.3,592200
565260,669328.7,930650,238230,300637.1,338450,327030,368691.6,592200
575910,694796.2,930650,236450,314633.8,338450,339460,380162.4,592200
586460,689721.3,930650,234660,315319.4,338450,351800,374401.9,592200
580760,698825.1,930650,230260,311253.6,338450,350500,387571.5,592200
575040,696182.9,930650,225840,304836.1,338450,349200,391346.8,592200
569290,709072.6,930650,221420,302385.9,338450,347870,406686.7,592200
563560,682612.9,930650,217010,284810.8,338450,346550,397802.1,592200
558500,658904.6,930650,214950,269877.1,338450,343550,389027.5,592200
553380,636094.7,930650,212880,251095.3,338450,340500,384999.4,592200
548280,579417.7,930650,210820,208313.7,338450,337460,371104,592200
537360,556654.1,930650,195710,188565.3,338450,341650,368088.8,592200
535430,542632.3,930650,190800,178493.5,338450,344630,364138.8,592200
533430,511461.3,930650,185900,160954.7,338450,347530,350506.6,592200
531530,482526.2,930650,181020,139699.4,338450,350510,342826.8,592200
529550,463285.5,930650,176130,126085.6,338450,353420,337199.9,592200
513010,458222.5,930650,168570,125568.3,338450,344440,332654.2,592200
496500,476544.5,930650,161020,138799,338450,335480,337745.5,592200
479940,493171.5,930650,153470,151850.3,338450,326470,341321.2,592200
463370,472455,930650,145930,143256.4,338450,317440,329198.6,592200
446290,438572,930650,138170,126390.3,338450,308120,312181.7,592200
429190,413013.7,930650,130410,113945,338450,298780,299068.7,592200
412130,370176.4,930650,122650,94656.8,338450,289480,275519.6,592200
394950,332191,930650,114880,82322.7,338450,280070,249868.3,592200
375450,299684,930650,106780,62816.9,338450,268670,236867.1,592200
355740,275818.2,930650,98660,56527.8,338450,257080,219290.4,592200
336230,248477.8,930650,90600,48686.4,338450,245630,199791.4,592200
316640,228995.1,930650,82480,37494.5,338450,234160,191500.6,592200
304090,230908,930650,82460,38020.4,338450,221630,192887.6,592200
291500,215404.8,930650,82430,35927.7,338450,209070,179477.1,592200
278940,205340,930650,82400,38324.7,338450,196540,167015.3,592200
266390,222935,930650,82380,55520.3,338450,184010,167414.7,592200
254400,203769,930650,82290,53726.5,338450,172110,150042.5,592200
242420,175906.6,930650,82240,30837.6,338450,160180,145069,592200
230410,138914.3,930650,82160,15447.7,338450,148250,123466.6,592200
218500,127661.9,930650,82090,12674.6,338450,136410,114987.3,592200
203070,141846.7,930650,78630,30297.3,338450,124440,111549.4,592200
187660,228438.5,930650,75170,93946,338450,112490,134492.5,592200
172290,297990.4,930650,71730,148824.2,338450,100560,149166.2,592200
156910,223711.3,930650,68290,98352.9,338450,88620,125358.4,592200
156190,303414.7,930650,71080,159100.9,338450,85110,144313.8,592200
155470,330044.5,930650,73860,181591.9,338450,81610,148452.6,592200
154670,304454.4,930650,76660,166152.5,338450,78010,138301.9,592200
154020,272177.2,930650,79460,146544.4,338450,74560,125632.8,592200
156870,276577.8,930650,86100,152728.2,338450,70770,123849.6,592200
159720,266572.2,930650,92760,148972.3,338450,66960,117599.9,592200
162580,269997.7,930650,99420,154312.5,338450,63160,115685.2,592200
165420,268798,930650,106090,155275.3,338450,59330,113522.7,592200
165270,263528.9,930650,109840,157441.7,338450,55430,106087.2,592200
165110,260626.3,930650,113620,151829.6,338450,51490,108796.7,592200
164910,248918.2,930650,117390,147712.1,338450,47520,101206.1,592200
164770,224231,930650,121150,139986,338450,43620,84245,592200
162470,211140.8,930650,120920,131927.1,338450,41550,79213.7,592200
160150,201454.7,930650,120660,124931.8,338450,39490,76522.9,592200
157910,188379.2,930650,120410,116250.3,338450,37500,72128.9,592200
155570,166009.6,930650,120140,100715.1,338450,35430,65294.5,592200
151140,137448,930650,116750,80635.1,338450,34390,56812.9,592200
146690,133414.4,930650,113370,78356.1,338450,33320,55058.3,592200
142200,142968.5,930650,109980,78478.5,338450,32220,64490,592200
137770,132413.6,930650,106590,74382,338450,31180,58031.6,592200
133440,140322.5,930650,103100,77484.8,338450,30340,62837.7,592200
129000,134810.3,930650,99590,72086.5,338450,29410,62723.8,592200
124630,132161.8,930650,96090,68839.1,338450,28540,63322.7,592200
120290,140471.6,930650,92580,74218.3,338450,27710,66253.3,592200
123440,143771.7,930650,93390,76817.4,338450,30050,66954.3,592200
126620,131910.4,930650,94210,77843,338450,32410,54067.4,592200
129810,144791.3,930650,95020,94048.3,338450,34790,50743,592200
132930,139799.2,930650,95830,89281.9,338450,37100,50517.3,592200
136640,141929,930650,96930,88809.7,338450,39710,53119.3,592200
140250,155282.3,930650,97990,87627.8,338450,42260,67654.5,592200
143890,165567.3,930650,99070,93938,338450,44820,71629.3,592200
147580,162359.9,930650,100160,89594.3,338450,47420,72765.6,592200
149710,190949.9,930650,100420,100874.9,338450,49290,90075,592200
151870,216732.7,930650,100690,110914.5,338450,51180,105818.2,592200
153980,214612.8,930650,100920,104916,338450,53060,109696.8,592200
156160,235806,930650,101180,106248.6,338450,54980,129557.4,592200
158850,231477,930650,101170,102660,338450,57680,128817,592200
161520,240386.3,930650,101150,96079.6,338450,60370,144306.7,592200
164200,228636.7,930650,101120,98868,338450,63080,129768.7,592200
166920,238914.1,930650,101110,109566.8,338450,65810,129347.3,592200
168640,236102.3,930650,100870,112664.1,338450,67770,123438.2,592200
170400,264812.4,930650,100630,115241.8,338450,69770,149570.6,592200
172170,274598.7,930650,100410,121814.1,338450,71760,152784.6,592200
173850,277884.1,930650,100170,126034.3,338450,73680,151849.8,592200
176330,249318.7,930650,99800,109365.4,338450,76530,139953.3,592200
178740,227220.1,930650,99380,101482.8,338450,79360,125737.3,592200
181150,231294.1,930650,98990,97696.8,338450,82160,133597.3,592200
183460,226007.4,930650,98600,92326.1,338450,84860,133681.3,592200
180940,209691.1,930650,96720,80365,338450,84220,129326.1,592200
178270,193581.5,930650,94830,77997.1,338450,83440,115584.4,592200
175680,173058.4,930650,92970,69567.1,338450,82710,103491.3,592200
173070,154577.9,930650,91070,59021.9,338450,82000,95556,592200
169930,136660.9,930650,89140,55625.8,338450,80790,81035.1,592200
166730,119216.6,930650,87160,49454.1,338450,79570,69762.5,592200
163590,107697.9,930650,85210,42513.3,338450,78380,65184.6,592200
160460,107484.2,930650,83230,38983.8,338450,77230,68500.4,592200
157370,99140.2,930650,81360,35215.6,338450,76010,63924.6,592200
154310,92589.1,930650,79480,29161.8,338450,74830,63427.3,592200
151180,86844.7,930650,77570,28189,338450,73610,58655.7,592200
148110,89168.1,930650,75700,31118.9,338450,72410,58049.2,592200
145540,84431.6,930650,74090,24404.1,338450,71450,60027.5,592200
142870,104656.8,930650,72460,39703,338450,70410,64953.8,592200
140280,108469.9,930650,70830,45607.9,338450,69450,62862,592200
137620,110212.9,930650,69220,49013.8,338450,68400,61199.1,592200
135460,97251.9,930650,67960,55905,338450,67500,41346.9,592200
133330,98574.8,930650,66720,58434.8,338450,66610,40140,592200
131070,98897.2,930650,65450,54839.8,338450,65620,44057.4,592200
142110,130024,930650,60380,58354.3,338450,81730,71669.7,592200
138010,140663.9,930650,58000,64898.4,338450,80010,75765.5,592200
133820,120603.3,930650,55600,61197.1,338450,78220,59406.2,592200
129700,115353.6,930650,53220,61419.5,338450,76480,53934.1,592200
125560,102889.7,930650,50840,49939.5,338450,74720,52950.2,592200
121690,103178.4,930650,48840,38655.1,338450,72850,64523.3,592200
117790,117392.2,930650,46870,38265,338450,70920,79127.2,592200
113940,97866.2,930650,44900,32247.3,338450,69040,65618.9,592200
110020,88749.6,930650,42900,25130.6,338450,67120,63619,592200
106440,102238.3,930650,41230,25538.9,338450,65210,76699.4,592200
102830,109599.8,930650,39510,28603.4,338450,63320,80996.4,592200
99370,101983.2,930650,37830,26452.2,338450,61540,75531,592200
95720,94230.4,930650,36110,24266.6,338450,59610,69963.8,592200
92700,85764.8,930650,34810,20252.9,338450,57890,65511.9,592200
89580,99722.9,930650,33510,31127.5,338450,56070,68595.4,592200
86450,116517.1,930650,32160,41439.3,338450,54290,75077.8,592200
83430,101420.5,930650,30880,29801.2,338450,52550,71619.3,592200
82920,79661.4,930650,31370,12776.6,338450,51550,66884.8,592200
82440,77841.8,930650,31880,10077.8,338450,50560,67764,592200
82000,75354.4,930650,32360,8874.8,338450,49640,66479.6,592200
81560,69910,930650,32890,8516,338450,48670,61394,592200
81100,65263,930650,33290,8036.6,338450,47810,57226.4,592200
80670,63286,930650,33720,8777.8,338450,46950,54508.2,592200
80210,63365.9,930650,34120,8790.2,338450,46090,54575.7,592200
79800,65114.3,930650,34560,9318.2,338450,45240,55796.1,592200
79000,66583,930650,34480,10642.9,338450,44520,55940.1,592200
78130,64046.8,930650,34430,11119,338450,43700,52927.8,592200
77330,76600.1,930650,34360,20252.2,338450,42970,56347.9,592200
76460,122506.4,930650,34300,54196.3,338450,42160,68310.1,592200
75780,146334.5,930650,33970,70746.4,338450,41810,75588.1,592200
75140,103216.5,930650,33610,35314.3,338450,41530,67902.2,592200
74460,71385.8,930650,33270,12265.7,338450,41190,59120.1,592200
73800,64126.5,930650,32930,7341.1,338450,40870,56785.4,592200
73340,61480.5,930650,32700,6872.7,338450,40640,54607.8,592200
72870,63388.7,930650,32460,9111.8,338450,40410,54276.9,592200
72330,61734.1,930650,32230,11434.1,338450,40100,50300,592200
71870,56542.9,930650,31990,6246.6,338450,39880,50296.3,592200
71430,64752.8,930650,31700,12918.1,338450,39730,51834.7,592200
70990,116139,930650,31420,48360.6,338450,39570,67778.4,592200
70550,161236.3,930650,31110,78316.7,338450,39440,82919.6,592200
70150,134946.8,930650,30820,60413,338450,39330,74533.8,592200
69270,99946.1,930650,30330,37874.8,338450,38940,62071.3,592200
68420,79817.3,930650,29790,26350.3,338450,38630,53467,592200
67600,68907,930650,29280,19265.6,338450,38320,49641.4,592200
66710,69331.7,930650,28770,18813.3,338450,37940,50518.4,592200
65610,58696.3,930650,28200,11581.7,338450,37410,47114.6,592200
64510,50724.6,930650,27630,5670.3,338450,36880,45054.3,592200
63390,45470.9,930650,27050,3989.9,338450,36340,41481,592200
62310,44057.1,930650,26510,3012.9,338450,35800,41044.2,592200
61170,41900.1,930650,25660,2333.4,338450,35510,39566.7,592200
59970,39413.8,930650,24830,2197,338450,35140,37216.8,592200
58810,38841.9,930650,23960,2598.4,338450,34850,36243.5,592200
57580,37334.1,930650,23110,2492.7,338450,34470,34841.4,592200
59360,38430,930650,23430,2653.4,338450,35930,35776.6,592200
61080,38432.5,930650,23730,3135.5,338450,37350,35297,592200
62800,38776.3,930650,24040,3359.8,338450,38760,35416.5,592200
64510,43587.1,930650,24360,6737.9,338450,40150,36849.2,592200
65880,40089.3,930650,24400,4466.3,338450,41480,35623,592200
67150,45525.8,930650,24410,11105.4,338450,42740,34420.4,592200
68420,72475.1,930650,24440,28406.3,338450,43980,44068.8,592200
69670,51137.5,930650,24440,10615.9,338450,45230,40521.6,592200
71560,42188.1,930650,24930,4307.2,338450,46630,37880.9,592200
73490,41169.7,930650,25420,3344.1,338450,48070,37825.6,592200
75300,38621.3,930650,25900,2077.5,338450,49400,36543.8,592200
77190,40786.2,930650,26410,3276.6,338450,50780,37509.6,592200
80880,42902.5,930650,27920,5839.5,338450,52960,37063,592200
84560,48415.3,930650,29400,10158.2,338450,55160,38257.1,592200
88240,57613.3,930650,30910,17201.4,338450,57330,40411.9,592200
91850,66799.1,930650,32410,23480.5,338450,59440,43318.6,592200
95160,69890.5,930650,33390,24727.9,338450,61770,45162.6,592200
98440,74323.6,930650,34330,26030.8,338450,64110,48292.8,592200
101710,73817.8,930650,35300,24486.5,338450,66410,49331.3,592200
105020,76230.8,930650,36270,26267.9,338450,68750,49962.9,592200
107410,78622.3,930650,36910,26459.6,338450,70500,52162.7,592200
109830,82699.6,930650,37530,27597,338450,72300,55102.6,592200
112290,90615.9,930650,38170,32044.5,338450,74120,58571.4,592200
114660,94627.9,930650,38790,35779.6,338450,75870,58848.3,592200
113640,104086.3,930650,38030,42822,338450,75610,61264.3,592200
112540,103658,930650,37260,42026.7,338450,75280,61631.3,592200
111510,97277.7,930650,36500,37698.9,338450,75010,59578.8,592200
110460,104392.3,930650,35760,41337.7,338450,74700,63054.6,592200
109510,104371.1,930650,35180,41188.2,338450,74330,63182.9,592200
108610,106117,930650,34590,44895.4,338450,74020,61221.6,592200
107690,107228.8,930650,34020,46043.3,338450,73670,61185.5,592200
106860,96962.2,930650,33470,37067.4,338450,73390,59894.8,592200
105830,88660.8,930650,32910,31772.7,338450,72920,56888.1,592200
104790,83075.8,930650,32350,27624.4,338450,72440,55451.4,592200
103770,71761,930650,31770,20189.1,338450,72000,51571.9,592200
102750,64021.9,930650,31200,17256.6,338450,71550,46765.3,592200
100190,70461.5,930650,30350,21313.2,338450,69840,49148.3,592200
97630,67194.1,930650,29490,18998.9,338450,68140,48195.2,592200
95100,66529.2,930650,28620,20374.5,338450,66480,46154.7,592200
92580,68771.6,930650,27760,20641.9,338450,64820,48129.7,592200
89930,66041.8,930650,26820,18798.2,338450,63110,47243.6,592200
87300,59424.9,930650,25890,14472.8,338450,61410,44952.1,592200
84600,56547,930650,24960,12459.1,338450,59640,44087.9,592200
50200,63122.3,930650,11440,14458,338450,38760,48664.3,592200
47710,60794.9,930650,10590,12200.1,338450,37120,48594.8,592200
45200,60075.7,930650,9770,11059.4,338450,35430,49016.3,592200
42680,58756.5,930650,8930,11132.6,338450,33750,47623.9,592200
40150,56045,930650,8090,8972.3,338450,32060,47072.7,592200
39360,62557.2,930650,7880,12299.5,338450,31480,50257.7,592200
38550,64434.4,930650,7670,13191.8,338450,30880,51242.6,592200
37730,59257.7,930650,7440,8591.9,338450,30290,50665.8,592200
36860,50829.4,930650,7240,6975.4,338450,29620,43854,592200
36300,50068.2,930650,7140,8314.6,338450,29160,41753.6,592200
35680,46560.3,930650,7030,5619,338450,28650,40941.3,592200
35020,47994.8,930650,6920,6834.8,338450,28100,41160,592200
34410,47644.1,930650,6800,6698.6,338450,27610,40945.5,592200
33790,41194.9,930650,6720,3008.7,338450,27070,38186.2,592200
33190,41016.3,930650,6640,2744,338450,26550,38272.3,592200
32620,42190.3,930650,6570,2822.3,338450,26050,39368,592200
31980,42352.8,930650,6480,2124.2,338450,25500,40228.6,592200
32330,42824.5,930650,6430,2080.8,338450,25900,40743.7,592200
32700,42517.7,930650,6380,1978.2,338450,26320,40539.5,592200
33000,42705.3,930650,6330,2677.6,338450,26670,40027.7,592200
33370,44713,930650,6300,3044.5,338450,27070,41668.5,592200
33640,48480.6,930650,6230,4170.5,338450,27410,44310.1,592200
33960,49068.7,930650,6180,5112.8,338450,27780,43955.9,592200
34250,49566.5,930650,6120,5471.5,338450,28130,44095,592200
34600,53824.1,930650,6080,9235.6,338450,28520,44588.5,592200
34930,49963.9,930650,5990,6765.5,338450,28940,43198.4,592200
35270,43605.8,930650,5950,3314,338450,29320,40291.8,592200
35580,41391.6,930650,5870,1201,338450,29710,40190.6,592200
35980,39926.3,930650,5830,1038.5,338450,30150,38887.8,592200
35440,41626.6,930650,5810,1151,338450,29630,40475.6,592200
34900,43081.9,930650,5810,1276,338450,29090,41805.9,592200
34370,43181.2,930650,5830,1338.5,338450,28540,41842.7,592200
33850,41931.5,930650,5840,1251,338450,28010,40680.5,592200
33560,40505.5,930650,5870,1176,338450,27690,39329.5,592200
33250,38966,930650,5890,1026,338450,27360,37940,592200
32910,39420.5,930650,5920,1101,338450,26990,38319.5,592200
32700,41311.8,930650,5960,1461.2,338450,26740,39850.6,592200
32470,43343.1,930650,6020,2084.4,338450,26450,41258.7,592200
32210,40130.4,930650,6060,1629.4,338450,26150,38501,592200
31940,36748.7,930650,6110,1082.1,338450,25830,35666.6,592200
31670,36280.1,930650,6150,886.7,338450,25520,35393.4,592200
30230,48374.2,930650,6100,1976,338450,24130,46398.2,592200
28830,47198.7,930650,6050,7605.9,338450,22780,39592.8,592200
27410,55472.2,930650,5990,10414.4,338450,21420,45057.8,592200
25970,43783.6,930650,5940,8041.9,338450,20030,35741.7,592200
24880,54897.5,930650,6040,11649,338450,18840,43248.5,592200
23800,57673.6,930650,6110,14312,338450,17690,43361.6,592200
22700,51801.5,930650,6210,10709.5,338450,16490,41092,592200
21620,45812.8,930650,6300,7228.5,338450,15320,38584.3,592200
20470,43289.6,930650,6460,5374.1,338450,14010,37915.5,592200
19440,44991.2,930650,6640,7205.9,338450,12800,37785.3,592200
18390,45822.9,930650,6800,8301.8,338450,11590,37521.1,592200
17380,54528,930650,7000,9576.9,338450,10380,44951.1,592200
17490,62832.1,930650,7240,13007.8,338450,10250,49824.3,592200
17670,49709,930650,7490,10053.7,338450,10180,39655.3,592200
17780,46495.2,930650,7740,8058.5,338450,10040,38436.7,592200
17890,39965,930650,8000,4653.4,338450,9890,35311.6,592200
18010,39912.2,930650,8220,4517.7,338450,9790,35394.5,592200
18180,38387.3,930650,8430,3995.1,338450,9750,34392.2,592200
18260,40531.3,930650,8640,6478.2,338450,9620,34053.1,592200
18360,41470,930650,8860,7294.6,338450,9500,34175.4,592200
18020,40678.4,930650,8590,6159.1,338450,9430,34519.3,592200
17620,41567.6,930650,8320,6379.1,338450,9300,35188.5,592200
17280,43432,930650,8090,7609.6,338450,9190,35822.4,592200
16880,44386.6,930650,7830,7208.9,338450,9050,37177.7,592200
18420,49699.4,930650,8670,10594.3,338450,9750,39105.1,592200
19930,56824.3,930650,9500,14208.2,338450,10430,42616.1,592200
21470,53178.6,930650,10330,11494.1,338450,11140,41684.5,592200
22990,50314.7,930650,11150,9798.5,338450,11840,40516.2,592200
24520,51416.6,930650,11840,11065,338450,12680,40351.6,592200
25970,53140.8,930650,12550,11783.9,338450,13420,41356.9,592200
27460,49158.9,930650,13240,9321,338450,14220,39837.9,592200
28940,46538,930650,13950,7865.5,338450,14990,38672.5,592200
30580,46089.3,930650,14910,8382.6,338450,15670,37706.7,592200
32250,45030,930650,15870,8594.7,338450,16380,36435.3,592200
33910,48145.4,930650,16840,10739.2,338450,17070,37406.2,592200
35520,48438.2,930650,17770,10867.9,338450,17750,37570.3,592200
38330,48917.6,930650,19500,12184,338450,18830,36733.6,592200
41180,44743.7,930650,21200,10020.8,338450,19980,34722.9,592200
43950,41014.6,930650,22890,8774.9,338450,21060,32239.7,592200
46750,51301.6,930650,24600,15972.6,338450,22150,35329,592200
49880,57880.1,930650,26670,20945.4,338450,23210,36934.7,592200
53020,55771.1,930650,28740,19479.7,338450,24280,36291.4,592200
56150,55307.7,930650,30810,19675.9,338450,25340,35631.8,592200
59290,59252.7,930650,32900,22482.5,338450,26390,36770.2,592200
63210,69364.8,930650,35500,30428.8,338450,27710,38936,592200
67150,61965.3,930650,38110,26055.7,338450,29040,35909.6,592200
71170,57121.9,930650,40740,22646,338450,30430,34475.9,592200
75140,64035,930650,43330,27865.2,338450,31810,36169.8,592200
78600,63532.9,930650,45750,26874.4,338450,32850,36658.5,592200
82090,65871.6,930650,48160,30494.4,338450,33930,35377.2,592200
85610,72365.6,930650,50570,36200.9,338450,35040,36164.7,592200
89080,75914.2,930650,52970,39226.4,338450,36110,36687.8,592200
92780,87336,930650,55140,47304.9,338450,37640,40031.1,592200
96510,65770.2,930650,57310,30749.4,338450,39200,35020.8,592200
100150,69137.3,930650,59460,33794.6,338450,40690,35342.7,592200
92210,82069.6,930650,55240,41765.5,338450,36970,40304.1,592200
94920,87554,930650,57210,45267.3,338450,37710,42286.7,592200
97690,86278,930650,59200,44113.5,338450,38490,42164.5,592200
100490,86065,930650,61210,43843.6,338450,39280,42221.4,592200
103180,87408.9,930650,63160,44915.9,338450,40020,42493,592200
105390,87033.7,930650,64940,44746.7,338450,40450,42287,592200
107610,91632.8,930650,66700,48286.9,338450,40910,43345.9,592200
109840,95959.8,930650,68460,51042.8,338450,41380,44917,592200
112040,92394.3,930650,70220,47159.6,338450,41820,45234.7,592200
113160,97394.1,930650,70510,51145.4,338450,42650,46248.7,592200
114280,96359.7,930650,70820,51929.1,338450,43460,44430.6,592200
115380,102133.9,930650,71110,56986.9,338450,44270,45147,592200
116480,112099.9,930650,71410,65074.9,338450,45070,47025,592200
118780,121310.4,930650,72830,72481.8,338450,45950,48828.6,592200
121120,121531.5,930650,74240,72924,338450,46880,48607.5,592200
123510,115356.9,930650,75640,68909.6,338450,47870,46447.3,592200
125790,102978.9,930650,77020,59485.2,338450,48770,43493.7,592200
128230,91328.7,930650,77790,50291.5,338450,50440,41037.2,592200
130750,90564.4,930650,78520,50290,338450,52230,40274.4,592200
133170,93062,930650,79250,52353.3,338450,53920,40708.7,592200
135690,86485.4,930650,79990,46419.2,338450,55700,40066.2,592200
136520,83482.8,930650,79990,43998.4,338450,56530,39484.4,592200
137460,84601.1,930650,79990,45548.7,338450,57470,39052.4,592200
138300,82661.7,930650,80000,44280.6,338450,58300,38381.1,592200
139110,83477.6,930650,79980,45056.3,338450,59130,38421.3,592200
141120,80776.5,930650,80620,43211,338450,60500,37565.5,592200
142980,81411.8,930650,81230,43898.4,338450,61750,37513.4,592200
144920,81611.3,930650,81850,43639.9,338450,63070,37971.4,592200
146840,86766.5,930650,82470,47173.1,338450,64370,39593.4,592200
155110,100877.1,930650,86740,57297.2,338450,68370,43579.9,592200
163420,110633.3,930650,91020,65054.2,338450,72400,45579.1,592200
171750,130795.4,930650,95280,81524.3,338450,76470,49271.1,592200
180030,138325.4,930650,99550,88329,338450,80480,49996.4,592200
186800,145121.7,930650,103010,93184.2,338450,83790,51937.5,592200
193580,149930.2,930650,106500,95585.9,338450,87080,54344.3,592200
200340,132509.9,930650,109970,81977.7,338450,90370,50532.2,592200
207160,146342.3,930650,113450,90650.2,338450,93710,55692.1,592200
213890,146594.1,930650,116740,90875.5,338450,97150,55718.6,592200
220650,143978.3,930650,120040,88094.8,338450,100610,55883.5,592200
227470,136917.5,930650,123310,82332,338450,104160,54585.5,592200
234210,142473.5,930650,126620,84976.2,338450,107590,57497.3,592200
231270,138032.5,930650,125880,79517.4,338450,105390,58515.1,592200
228380,149205.6,930650,125140,86998.1,338450,103240,62207.5,592200
225380,142490,930650,124380,80957.3,338450,101000,61532.7,592200
222480,139268.9,930650,123630,76892.2,338450,98850,62376.7,592200
221450,143166.8,930650,123290,80045.2,338450,98160,63121.6,592200
220330,149817.5,930650,122880,84782.9,338450,97450,65034.6,592200
219270,150620.7,930650,122520,85949.4,338450,96750,64671.3,592200
218160,151204.8,930650,122140,83019.1,338450,96020,68185.7,592200
217220,139054.7,930650,121910,79286.4,338450,95310,59768.3,592200
216280,141733.8,930650,121660,79985.6,338450,94620,61748.2,592200
215380,152132.5,930650,121430,83198.8,338450,93950,68933.7,592200
214520,190707.1,930650,121210,100616.2,338450,93310,90090.9,592200
219410,204882.7,930650,123590,109308.1,338450,95820,95574.6,592200
224330,211270.6,930650,125990,115560.4,338450,98340,95710.2,592200
229330,229168.4,930650,128420,124022.5,338450,100910,105145.9,592200
234270,222256.9,930650,130800,123712.3,338450,103470,98544.6,592200
240200,217584.8,930650,133790,123077.6,338450,106410,94507.2,592200
246170,204431.3,930650,136780,114641.2,338450,109390,89790.1,592200
252040,211092.2,930650,139740,115098.3,338450,112300,95993.9,592200
258010,205386.4,930650,142730,113672.6,338450,115280,91713.8,592200
261920,200547.3,930650,144070,107943.5,338450,117850,92603.8,592200
265760,203935.3,930650,145410,108990.6,338450,120350,94944.7,592200
269580,215317.3,930650,146750,114954.5,338450,122830,100362.8,592200
273500,219635.9,930650,148100,119424.9,338450,125400,100211,592200
282560,244245.4,930650,151050,131367.1,338450,131510,112878.3,592200
291740,266522.5,930650,154070,148094.7,338450,137670,118427.8,592200
300870,268751,930650,157050,159768.9,338450,143820,108982.1,592200
309990,285189.9,930650,160040,168792.5,338450,149950,116397.4,592200
319100,296676.5,930650,163080,176589.2,338450,156020,120087.3,592200
328270,319115.5,930650,166110,180785.4,338450,162160,138330.1,592200
337400,325703.2,930650,169150,184236.3,338450,168250,141466.9,592200
346500,337733.5,930650,172200,188196.6,338450,174300,149536.9,592200
353950,344770,930650,174180,186084.6,338450,179770,158685.4,592200
361410,344709.1,930650,176190,182063.4,338450,185220,162645.7,592200
368860,347372.8,930650,178170,185517.1,338450,190690,161855.7,592200
376260,372623.3,930650,180150,200281.4,338450,196110,172341.9,592200
378110,391198.3,930650,180660,203512.8,338450,197450,187685.5,592200
379910,403204.3,930650,181170,208702.1,338450,198740,194502.2,592200
381720,394411,930650,181680,208810.8,338450,200040,185600.2,592200
383570,396380.3,930650,182160,211788.5,338450,201410,184591.8,592200
384360,404264.9,930650,182120,222461.6,338450,202240,181803.3,592200
385180,396516.8,930650,182100,220939.2,338450,203080,175577.6,592200
386020,388112.4,930650,182060,212327.6,338450,203960,175784.8,592200
386820,382911.5,930650,182020,210500.3,338450,204800,172411.2,592200
387170,373080.1,930650,181970,208775.3,338450,205200,164304.8,592200
387520,368928.9,930650,181910,211240.1,338450,205610,157688.8,592200
387930,378789,930650,181870,212830.7,338450,206060,165958.3,592200
388300,367300.8,930650,181820,206547.2,338450,206480,160753.6,592200
381200,369730.9,930650,178310,203895.5,338450,202890,165835.4,592200
374070,373605.4,930650,174760,204153.4,338450,199310,169452,592200
366990,367713.8,930650,171210,196541.3,338450,195780,171172.5,592200
359840,350277.1,930650,167700,191283.9,338450,192140,158993.2,592200
352970,352511.3,930650,164220,191385.5,338450,188750,161125.8,592200
346040,342994.8,930650,160720,191483.7,338450,185320,151511.1,592200
339150,337588.3,930650,157240,189707.3,338450,181910,147881,592200
401840,337822.7,930650,190760,192347.4,338450,211080,145475.3,592200
396110,318615.6,930650,188510,179575.3,338450,207600,139040.3,592200
390350,305645.9,930650,186210,171858.1,338450,204140,133787.8,592200
384630,294062,930650,183970,167013.2,338450,200660,127048.8,592200
378860,292455.7,930650,181690,163730.4,338450,197170,128725.3,592200
376520,291186.2,930650,180810,164385.8,338450,195710,126800.4,592200
374270,302546.3,930650,179940,171867,338450,194330,130679.3,592200
371900,300456.8,930650,179080,175511.5,338450,192820,124945.3,592200
369650,316412.9,930650,178240,175415.3,338450,191410,140997.6,592200
367920,327436,930650,177630,178006.3,338450,190290,149429.7,592200
366230,306276.7,930650,177040,176046.9,338450,189190,130229.8,592200
364520,297832.7,930650,176430,177012.3,338450,188090,120820.4,592200
362850,304923.2,930650,175840,177701.4,338450,187010,127221.8,592200
362060,322473.9,930650,175720,183931.3,338450,186340,138542.6,592200
361280,333903.1,930650,175610,185710,338450,185670,148193.1,592200
360470,330729.8,930650,175480,186789.2,338450,184990,143940.6,592200
359680,335820.4,930650,175350,190126.7,338450,184330,145693.7,592200
359140,339276.1,930650,175910,189548.1,338450,183230,149728,592200
358590,339350.6,930650,176470,187867.8,338450,182120,151482.8,592200
358010,338638.3,930650,176990,188228.3,338450,181020,150410,592200
357490,344858.7,930650,177530,193336.2,338450,179960,151522.5,592200
356170,355513.9,930650,177840,198109.6,338450,178330,157404.3,592200
354790,353060.4,930650,178140,198923.7,338450,176650,154136.7,592200
353450,342590.8,930650,178450,192608.9,338450,175000,149981.9,592200
352150,355470,930650,178750,196609.4,338450,173400,158860.6,592200
351770,354274.7,930650,178820,197443.4,338450,172950,156831.3,592200
351370,359726.3,930650,178880,202702.8,338450,172490,157023.5,592200
351010,366154.2,930650,178960,203850.2,338450,172050,162304,592200
350720,366332,930650,179040,203192.7,338450,171680,163139.3,592200
352430,362773.1,930650,180350,202321.9,338450,172080,160451.2,592200
354120,359826,930650,181620,204056.6,338450,172500,155769.4,592200
355900,352985.5,930650,182950,199096.7,338450,172950,153888.8,592200
357570,354983.7,930650,184210,198932.6,338450,173360,156051.1,592200
358450,356218.7,930650,185500,199283.7,338450,172950,156935,592200
359220,362709.2,930650,186760,208019.9,338450,172460,154689.3,592200
360030,366149.4,930650,188060,208646,338450,171970,157503.4,592200
360840,359018.2,930650,189320,200497.9,338450,171520,158520.3,592200
360890,328625.8,930650,189850,184015,338450,171040,144610.8,592200
360950,318539.4,930650,190390,174349.3,338450,170560,144190.1,592200
361000,291572.6,930650,190940,156804.8,338450,170060,134767.8,592200
361020,284287.1,930650,191480,155792.9,338450,169540,128494.2,592200
356030,262348.2,930650,189550,146444.6,338450,166480,115903.6,592200
351030,261848.3,930650,187620,150185.7,338450,163410,111662.6,592200
346010,270615.2,930650,185690,158937.3,338450,160320,111677.9,592200
340980,268784.3,930650,183760,159961.7,338450,157220,108822.6,592200
337190,288839.3,930650,182130,170950.3,338450,155060,117889,592200
333450,302862.8,930650,180480,181706.7,338450,152970,121156.1,592200
329660,294815.8,930650,178870,171422.7,338450,150790,123393.1,592200
325880,296341.4,930650,177250,169278.4,338450,148630,127063,592200
322110,278851.7,930650,175900,161481,338450,146210,117370.7,592200
318380,282301.8,930650,174530,161103.1,338450,143850,121198.7,592200
314590,298200.6,930650,173190,169023.9,338450,141400,129176.7,592200
310850,303810.8,930650,171830,172385.3,338450,139020,131425.5,592200
315690,317856.9,930650,173340,182428.7,338450,142350,135428.2,592200
320590,339011.1,930650,174830,194913.8,338450,145760,144097.3,592200
325460,354084.8,930650,176320,200071.8,338450,149140,154013,592200
330340,362082.3,930650,177820,203169.1,338450,152520,158913.2,592200
334890,358676,930650,178630,203119.8,338450,156260,155556.2,592200
339500,348845.9,930650,179450,196238.3,338450,160050,152607.6,592200
344080,358184.4,930650,180280,201581.4,338450,163800,156603,592200
348640,371849,930650,181080,210212.8,338450,167560,161636.2,592200
353800,385504.9,930650,182890,214920,338450,170910,170584.9,592200
359000,397135.1,930650,184700,219398.7,338450,174300,177736.4,592200
364130,392981,930650,186510,209436.2,338450,177620,183544.8,592200
369330,395859.4,930650,188330,210973.6,338450,181000,184885.8,592200
372850,397278.5,930650,189280,213206.7,338450,183570,184071.8,592200
376280,405723.1,930650,190260,217169.6,338450,186020,188553.5,592200
379750,406285.3,930650,191210,224600.6,338450,188540,181684.7,592200
383320,405911.1,930650,192240,227076.7,338450,191080,178834.4,592200
387080,422000.6,930650,193270,233404,338450,193810,188596.6,592200
390920,417422.7,930650,194340,230725,338450,196580,186697.7,592200
394690,430807,930650,195400,238094.9,338450,199290,192712.1,592200
398470,431788.3,930650,196460,234226.1,338450,202010,197562.2,592200
403480,443205.8,930650,198310,233749.3,338450,205170,209456.5,592200
408490,444125.3,930650,200180,227846.1,338450,208310,216279.2,592200
413500,451359.4,930650,202050,230461.9,338450,211450,220897.5,592200
418530,455870.9,930650,203930,237094.6,338450,214600,218776.3,592200
413850,451782.3,930650,202010,241857.4,338450,211840,209924.9,592200
409200,456670.9,930650,200130,246796.1,338450,209070,209874.8,592200
404470,457002.5,930650,198190,245854.9,338450,206280,211147.6,592200
399810,457041.5,930650,196290,244330.3,338450,203520,212711.2,592200
395210,445532.7,930650,194520,239015.5,338450,200690,206517.2,592200
390690,432010.9,930650,192730,230454.2,338450,197960,201556.7,592200
386130,440479.1,930650,190970,236076,338450,195160,204403.1,592200
381590,445878.1,930650,189180,242255.6,338450,192410,203622.5,592200
379450,449314.6,930650,187920,240660.4,338450,191530,208654.2,592200
377380,455329.7,930650,186690,243334.9,338450,190690,211994.8,592200
375300,459282.2,930650,185400,244798.6,338450,189900,214483.6,592200
373260,461964.5,930650,184160,246306.4,338450,189100,215658.1,592200
372510,454774.5,930650,183600,243825.9,338450,188910,210948.6,592200
371850,439466.8,930650,183050,232340.8,338450,188800,207126,592200
371100,430776,930650,182470,228384,338450,188630,202392,592200
370380,407584.2,930650,181920,212623.8,338450,188460,194960.4,592200
370500,398650.8,930650,181550,210268.6,338450,188950,188382.2,592200
370700,412425.2,930650,181200,215493.6,338450,189500,196931.6,592200
370910,430025.3,930650,180840,225147,338450,190070,204878.3,592200
454390,429437.9,930650,209110,223528.4,338450,245280,205909.5,592200
454000,428080.1,930650,209340,217002.4,338450,244660,211077.7,592200
453720,419491.5,930650,209570,210303.3,338450,244150,209188.2,592200
453300,394598.9,930650,209780,201267,338450,243520,193331.9,592200
452970,394233.6,930650,210000,201382.5,338450,242970,192851.1,592200
457260,400819.9,930650,211680,204155.8,338450,245580,196664.1,592200
461530,373606.9,930650,213340,182089.9,338450,248190,191517,592200
465800,381235.9,930650,215030,187233.2,338450,250770,194002.7,592200
470030,386815.6,930650,216690,189648.8,338450,253340,197166.8,592200
473460,405833.7,930650,218280,196996.2,338450,255180,208837.5,592200
476890,427815.4,930650,219910,212432.4,338450,256980,215383,592200
480300,417781.4,930650,221500,207098.8,338450,258800,210682.6,592200
483720,381121.5,930650,223100,178416.4,338450,260620,202705.1,592200
485580,411241,930650,223590,201855.1,338450,261990,209385.9,592200
487370,406224.2,930650,224070,199854.8,338450,263300,206369.4,592200
489230,411347.6,930650,224580,201062.1,338450,264650,210285.5,592200
491030,428200.7,930650,225080,214913.8,338450,265950,213286.9,592200
492340,445754,930650,226360,222867.8,338450,265980,222886.2,592200
493750,465190.5,930650,227650,227165.3,338450,266100,238025.2,592200
495040,457530.1,930650,228910,221500.2,338450,266130,236029.9,592200
496400,431428.1,930650,230190,206166.3,338450,266210,225261.8,592200
494350,411901.5,930650,228570,195912.9,338450,265780,215988.6,592200
492430,406723.4,930650,226950,197421.9,338450,265480,209301.5,592200
490490,409296.9,930650,225380,201732.4,338450,265110,207564.5,592200
488510,396675.3,930650,223720,194814.5,338450,264790,201860.8,592200
488580,407022.9,930650,223850,202367.9,338450,264730,204655,592200
488680,417540.9,930650,224010,208218.4,338450,264670,209322.5,592200
488760,415514.5,930650,224150,206548.2,338450,264610,208966.3,592200
488830,403056.4,930650,224270,196779.5,338450,264560,206276.9,592200
487510,402492.2,930650,224270,192450.6,338450,263240,210041.6,592200
486190,402655.6,930650,224270,193040,338450,261920,209615.6,592200
484820,395415.7,930650,224260,194378.7,338450,260560,201037,592200
483560,405423.9,930650,224250,200694.2,338450,259310,204729.7,592200
480640,406867.2,930650,223120,203129.1,338450,257520,203738.1,592200
477700,405305,930650,222010,201973.1,338450,255690,203331.9,592200
474820,399869.4,930650,220890,202093.9,338450,253930,197775.5,592200
471830,390115.8,930650,219760,200740.8,338450,252070,189375,592200
469120,386193.7,930650,218820,203922.9,338450,250300,182270.8,592200
466390,366326.6,930650,217890,205309,338450,248500,161017.6,592200
463720,368363.4,930650,216930,211468.7,338450,246790,156894.7,592200
461100,360408.6,930650,216000,209633.9,338450,245100,150774.7,592200
456690,346957.9,930650,214850,206167.8,338450,241840,140790.1,592200
452340,352683.7,930650,213680,211744.4,338450,238660,140939.3,592200
448000,354459.2,930650,212570,214809.4,338450,235430,139649.8,592200
443570,342434.4,930650,211370,208708.9,338450,232200,133725.5,592200
439480,353090.1,930650,210380,214584,338450,229100,138506.1,592200
435430,351828.8,930650,209360,217301.9,338450,226070,134526.9,592200
431350,349010.5,930650,208350,219040.5,338450,223000,129970,592200
427340,338508.4,930650,207340,214765.2,338450,220000,123743.2,592200
423320,334625.5,930650,206370,212349.8,338450,216950,122275.7,592200
419310,314581.1,930650,205380,203234,338450,213930,111347.1,592200
415310,303347.2,930650,204380,195956.3,338450,210930,107390.9,592200
411300,290870.6,930650,203410,188729.5,338450,207890,102141.1,592200
407170,273521.1,930650,201820,181822.3,338450,205350,91698.8,592200
402950,253394.2,930650,200230,170402.5,338450,202720,82991.7,592200
398810,251613.7,930650,198650,170817.2,338450,200160,80796.5,592200
394600,237606.2,930650,197050,162122.8,338450,197550,75483.4,592200
389760,220808.1,930650,194360,152173.6,338450,195400,68634.5,592200
384970,218147.6,930650,191690,151607,338450,193280,66540.6,592200
380120,215526.6,930650,189010,150947.4,338450,191110,64579.2,592200
375320,227267.7,930650,186310,152508.5,338450,189010,74759.2,592200
370340,211463.3,930650,183120,143101.4,338450,187220,68361.9,592200
365410,224927.8,930650,179950,151571,338450,185460,73356.8,592200
360480,222700.5,930650,176780,153552.5,338450,183700,69148,592200
355540,228610.7,930650,173590,156598.6,338450,181950,72012.1,592200
351480,234015,930650,170520,154470.3,338450,180960,79544.7,592200
347540,223442.3,930650,167470,153935,338450,180070,69507.3,592200
343500,227306.2,930650,164430,146673.8,338450,179070,80632.4,592200
339510,220060.5,930650,161340,142278.2,338450,178170,77782.3,592200
335920,203382.7,930650,158330,128662.6,338450,177590,74720.1,592200
332320,188561.9,930650,155330,118755.2,338450,176990,69806.7,592200
328780,171833,930650,152320,105755.2,338450,176460,66077.8,592200
325200,163139.6,930650,149300,99360.6,338450,175900,63779,592200
322310,154176.3,930650,147270,92759.9,338450,175040,61416.4,592200
319470,147499.3,930650,145210,87709.4,338450,174260,59789.9,592200
316600,146747.2,930650,143160,86555.8,338450,173440,60191.4,592200
313800,133252.4,930650,141110,78837.5,338450,172690,54414.9,592200
315070,116620.8,930650,139520,64618.8,338450,175550,52002,592200
316420,105427.4,930650,137960,54514.6,338450,178460,50912.8,592200
317780,108966.2,930650,136380,57230.5,338450,181400,51735.7,592200
319120,110226.1,930650,134830,57261.4,338450,184290,52964.7,592200
321820,116873.5,930650,134060,61390.8,338450,187760,55482.7,592200
324500,125922.8,930650,133300,67691.3,338450,191200,58231.5,592200
327180,124796.1,930650,132520,64990.6,338450,194660,59805.5,592200
329850,126333.8,930650,131780,62606.1,338450,198070,63727.7,592200
332460,120658.7,930650,131630,56976.4,338450,200830,63682.3,592200
335110,118563.8,930650,131520,52914.7,338450,203590,65649.1,592200
337750,113771.5,930650,131390,46405.4,338450,206360,67366.1,592200
340390,112273.4,930650,131300,46727,338450,209090,65546.4,592200
335740,102369.2,930650,128390,43437.6,338450,207350,58931.6,592200
331150,92115.8,930650,125510,43956.7,338450,205640,48159.1,592200
326500,85912.5,930650,122620,40776.9,338450,203880,45135.6,592200
321900,87922.6,930650,119720,41222.9,338450,202180,46699.7,592200
315320,122535.5,930650,115250,49248.5,338450,200070,73287,592200
308880,132874.1,930650,110790,55382.2,338450,198090,77491.9,592200
302280,141160.2,930650,106330,59403.5,338450,195950,81756.7,592200
229310,151281.1,930650,78690,66771.3,338450,150620,84509.8,592200
228520,162750.4,930650,78160,73393.2,338450,150360,89357.2,592200
227800,165674.4,930650,77640,79547.8,338450,150160,86126.6,592200
227010,175979.4,930650,77100,83598.6,338450,149910,92380.8,592200
226160,156131.4,930650,76570,76854.8,338450,149590,79276.6,592200
224380,168036.1,930650,76890,80876.2,338450,147490,87159.9,592200
222580,177800,930650,77200,93072.5,338450,145380,84727.5,592200
220720,179500.1,930650,77510,100011.8,338450,143210,79488.3,592200
218950,168352.7,930650,77830,97053.3,338450,141120,71299.4,592200
218450,147235.2,930650,79160,88720,338450,139290,58515.2,592200
217930,158481,930650,80500,80366,338450,137430,78115,592200
217390,163901.6,930650,81850,82128.5,338450,135540,81773.1,592200
216880,149746.7,930650,83200,83095,338450,133680,66651.7,592200
215210,166306.7,930650,83710,91391.7,338450,131500,74915,592200
213510,174953.5,930650,84220,95195,338450,129290,79758.5,592200
211800,184110.6,930650,84750,104144.5,338450,127050,79966.1,592200
210110,189564.2,930650,85260,108658.8,338450,124850,80905.4,592200
207090,181195.9,930650,83130,100450.6,338450,123960,80745.3,592200
204080,178246.4,930650,81010,97666.2,338450,123070,80580.2,592200
201030,185233.4,930650,78890,102470.4,338450,122140,82763,592200
198020,175689.5,930650,76740,94231.4,338450,121280,81458.1,592200
196430,165002.1,930650,75860,87913.7,338450,120570,77088.4,592200
194730,161716.3,930650,74950,85431.2,338450,119780,76285.1,592200
193140,153281.1,930650,74020,78022.4,338450,119120,75258.7,592200
191470,143461.8,930650,73120,69464.4,338450,118350,73997.4,592200
190380,145722.6,930650,72560,71610.4,338450,117820,74112.2,592200
189350,139211.2,930650,72010,67616.1,338450,117340,71595.1,592200
188220,143512.9,930650,71420,71605.2,338450,116800,71907.7,592200
187150,136986.1,930650,70850,67066.3,338450,116300,69919.8,592200
187550,133792.3,930650,71370,64755.7,338450,116180,69036.6,592200
187910,122402.2,930650,71890,57258.2,338450,116020,65144,592200
188290,110797.7,930650,72400,49071.5,338450,115890,61726.2,592200
188670,103165.4,930650,72920,42902,338450,115750,60263.4,592200
189430,98882.3,930650,73730,40763.4,338450,115700,58118.9,592200
190190,109015.2,930650,74530,48336.2,338450,115660,60679,592200
190970,127730,930650,75340,63698.4,338450,115630,64031.6,592200
191690,136753,930650,76140,70467.7,338450,115550,66285.3,592200
192830,161454.7,930650,76920,87633,338450,115910,73821.7,592200
193910,162221.4,930650,77720,87685.3,338450,116190,74536.1,592200
195090,162998.7,930650,78490,85221.8,338450,116600,77776.9,592200
196200,165390.8,930650,79260,85681.7,338450,116940,79709.1,592200
194000,163266.7,930650,77910,85113,338450,116090,78153.7,592200
191800,164854.5,930650,76560,86108.8,338450,115240,78745.7,592200
189540,178514.4,930650,75170,94401.1,338450,114370,84113.3,592200
187430,186025.1,930650,73820,99043.9,338450,113610,86981.2,592200
184160,188538.4,930650,72090,98486.6,338450,112070,90051.8,592200
180930,177550.3,930650,70350,91145.5,338450,110580,86404.8,592200
177680,167054.3,930650,68610,85342.4,338450,109070,81711.9,592200
174460,149844.1,930650,66850,74228.7,338450,107610,75615.4,592200
170940,143536.3,930650,64970,70771.3,338450,105970,72765,592200
167360,131284.1,930650,63080,62804.9,338450,104280,68479.2,592200
163890,133730.8,930650,61210,64515.3,338450,102680,69215.5,592200
160280,133711.1,930650,59290,63447.5,338450,100990,70263.6,592200
159150,131205.1,930650,58970,61814.7,338450,100180,69390.4,592200
157940,124123,930650,58630,57523.7,338450,99310,66599.3,592200
156770,117313.1,930650,58260,52948.5,338450,98510,64364.6,592200
155600,107363.4,930650,57920,44377,338450,97680,62986.4,592200
155180,105775.8,930650,57910,43143.6,338450,97270,62632.2,592200
154830,102443.7,930650,57940,40516.4,338450,96890,61927.3,592200
154440,100763.7,930650,57930,38588.6,338450,96510,62175.1,592200
154000,100635.2,930650,57890,36709.3,338450,96110,63925.9,592200
153810,101610.6,930650,57940,37191.6,338450,95870,64419,592200
153490,99594.2,930650,57960,36019.6,338450,95530,63574.6,592200
153260,87968.3,930650,57970,27901.8,338450,95290,60066.5,592200
152930,77525.2,930650,58010,20012.5,338450,94920,57512.7,592200
155100,77433.7,930650,59880,19333.9,338450,95220,58099.8,592200
157210,81956.2,930650,61760,23261.2,338450,95450,58695,592200
159480,80013.2,930650,63660,22480.4,338450,95820,57532.8,592200
161650,83184.6,930650,65530,24072.2,338450,96120,59112.4,592200
163900,83302.9,930650,67480,24008.8,338450,96420,59294.1,592200
166200,79969.9,930650,69450,21891.8,338450,96750,58078.1,592200
168470,84731.5,930650,71430,26011.1,338450,97040,58720.4,592200
170750,87147,930650,73400,27494.5,338450,97350,59652.5,592200
172960,85689.7,930650,75360,26297.3,338450,97600,59392.4,592200
175250,86056.3,930650,77370,25321.2,338450,97880,60735.1,592200
177450,83208.7,930650,79380,23589.9,338450,98070,59618.8,592200
179640,82293.6,930650,81360,22489.5,338450,98280,59804.1,592200
175120,86723,930650,80480,24364.6,338450,94640,62358.4,592200
170480,86790.1,930650,79570,22240.1,338450,90910,64550,592200
166040,80385.3,930650,78720,20773.7,338450,87320,59611.6,592200
161350,72140.2,930650,77780,18242.9,338450,83570,53897.3,592200
156740,73619.4,930650,76820,20749.4,338450,79920,52870,592200
151960,72858.1,930650,75830,19760.9,338450,76130,53097.2,592200
147290,68160.1,930650,74870,17330.9,338450,72420,50829.2,592200
142610,64246.1,930650,73890,16043.5,338450,68720,48202.6,592200
137710,60545.5,930650,72820,15016.7,338450,64890,45528.8,592200
132890,63657.3,930650,71760,16501.8,338450,61130,47155.5,592200
128040,66120.8,930650,70670,18720.2,338450,57370,47400.6,592200
123090,65683.6,930650,69580,18618.9,338450,53510,47064.7,592200
122460,71433.8,930650,70060,22174.3,338450,52400,49259.5,592200
121860,71677.9,930650,70540,23167,338450,51320,48510.9,592200
121230,67289.9,930650,71010,20358.9,338450,50220,46931,592200
120590,63907.5,930650,71490,19037.3,338450,49100,44870.2,592200
119840,62950.7,930650,71840,19700.4,338450,48000,43250.3,592200
119050,59461.6,930650,72180,18906.1,338450,46870,40555.5,592200
118390,57650.6,930650,72550,19152.1,338450,45840,38498.5,592200
46020,64056.9,930650,19130,15529.8,338450,26890,48527.1,592200
42980,65717.5,930650,18190,15771.6,338450,24790,49945.9,592200
40040,64616.6,930650,17250,14736,338450,22790,49880.6,592200
37040,63483.7,930650,16310,13821.8,338450,20730,49661.9,592200
34000,65816.9,930650,15390,14936.4,338450,18610,50880.5,592200
33950,67286.3,930650,15560,16651.9,338450,18390,50634.4,592200
33890,68574.2,930650,15760,17366.6,338450,18130,51207.6,592200
33880,67784.1,930650,15930,16584.6,338450,17950,51199.5,592200
33850,65884.3,930650,16120,16703.2,338450,17730,49181.1,592200
33910,67340.6,930650,16350,18872.3,338450,17560,48468.3,592200
33890,66450.1,930650,16550,17795.4,338450,17340,48654.7,592200
33960,63361.2,930650,16740,15376.6,338450,17220,47984.6,592200
34030,62085.1,930650,16970,15114.5,338450,17060,46970.6,592200
33800,67516.2,930650,16900,18615.6,338450,16900,48900.6,592200
33560,68953.4,930650,16830,19503.3,338450,16730,49450.1,592200
33360,64775,930650,16760,17162.6,338450,16600,47612.4,592200
33100,62794.9,930650,16690,15285.2,338450,16410,47509.7,592200
32380,60648.2,930650,16480,14034.5,338450,15900,46613.7,592200
31570,58644.8,930650,16290,12758.1,338450,15280,45886.7,592200
30830,60344.7,930650,16070,13115.2,338450,14760,47229.5,592200
30100,63922.5,930650,15870,14902.2,338450,14230,49020.3,592200
29730,68424.3,930650,15950,17922,338450,13780,50502.3,592200
29270,68303.8,930650,16020,19418.6,338450,13250,48885.2,592200
28940,66609.1,930650,16100,18654.7,338450,12840,47954.4,592200
28490,64893.5,930650,16160,18199.7,338450,12330,46693.8,592200
28820,67370.1,930650,16920,20223.1,338450,11900,47147,592200
29110,67525.9,930650,17640,20001.1,338450,11470,47524.8,592200
29430,67372.9,930650,18380,19283.1,338450,11050,48089.8,592200
29690,69063.7,930650,19090,19838.8,338450,10600,49224.9,592200
30480,74310.1,930650,19700,23168.6,338450,10780,51141.5,592200
31270,70268.8,930650,20340,21193.8,338450,10930,49075,592200
32040,69031,930650,20950,21196.3,338450,11090,47834.7,592200
32840,74179.3,930650,21560,25245.9,338450,11280,48933.4,592200
33350,79592.4,930650,21760,29231.6,338450,11590,50360.8,592200
33780,78252.7,930650,21940,28697.5,338450,11840,49555.2,592200
34360,72479.9,930650,22160,25612.7,338450,12200,46867.2,592200
34870,71183.1,930650,22370,23549.8,338450,12500,47633.3,592200
34960,68456.9,930650,22230,22464.9,338450,12730,45992,592200
35030,68813.3,930650,22080,22680.3,338450,12950,46133,592200
35180,83196.3,930650,21970,24164.1,338450,13210,59032.2,592200
35240,91570.2,930650,21850,27837.8,338450,13390,63732.4,592200
35050,107867.4,930650,22650,33096.9,338450,12400,74770.5,592200
34800,109927.7,930650,23490,33565,338450,11310,76362.7,592200
34630,105140.2,930650,24300,30944.5,338450,10330,74195.7,592200
34450,103960,930650,25130,30004,338450,9320,73956,592200
34410,99875.5,930650,25460,27134.2,338450,8950,72741.3,592200
34320,91621.6,930650,25770,22136.4,338450,8550,69485.2,592200
34300,85364.2,930650,26110,17956.6,338450,8190,67407.6,592200
34230,83868.3,930650,26400,17137.5,338450,7830,66730.8,592200
34700,81973.1,930650,26910,16433.1,338450,7790,65540,592200
35120,82750.2,930650,27380,17979.1,338450,7740,64771.1,592200
35550,87566.3,930650,27830,21479.1,338450,7720,66087.2,592200
36030,89535.9,930650,28320,22549.7,338450,7710,66986.2,592200
36710,94390.3,930650,28290,26199.4,338450,8420,68190.9,592200
37450,100431.8,930650,28260,30329.5,338450,9190,70102.3,592200
38140,105465.2,930650,28210,34019.6,338450,9930,71445.6,592200
38880,102167.4,930650,28180,31823,338450,10700,70344.4,592200
39580,98026.6,930650,27910,27966.3,338450,11670,70060.3,592200
40260,96074,930650,27620,25376.2,338450,12640,70697.8,592200
41020,95941.6,930650,27370,24565.9,338450,13650,71375.7,592200
41730,95711.9,930650,27090,24319.3,338450,14640,71392.6,592200
43310,96597.9,930650,27930,24905.4,338450,15380,71692.5,592200
44910,99731.4,930650,28760,27193.7,338450,16150,72537.7,592200
46450,107080.3,930650,29570,31281.1,338450,16880,75799.2,592200
48000,112152.5,930650,30400,33391.3,338450,17600,78761.2,592200
52590,113269.8,930650,32550,34481.9,338450,20040,78787.9,592200
57140,118255.5,930650,34680,35848.8,338450,22460,82406.7,592200
61750,124758.5,930650,36850,37513.3,338450,24900,87245.2,592200
66320,132716.8,930650,38980,39607.3,338450,27340,93109.5,592200
70990,144622.1,930650,41470,46353.5,338450,29520,98268.6,592200
75660,156111,930650,43960,51868.7,338450,31700,104242.3,592200
80250,175766.5,930650,46440,62263.1,338450,33810,113503.4,592200
84950,194712,930650,48920,75929.1,338450,36030,118782.9,592200
90630,224345.2,930650,52010,94289.8,338450,38620,130055.4,592200
96270,243522.3,930650,55050,105173.7,338450,41220,138348.6,592200
101880,263457.4,930650,58120,117312.6,338450,43760,146144.8,592200
107480,272278.7,930650,61190,120363.6,338450,46290,151915.1,592200
108450,276666.7,930650,61020,123978.7,338450,47430,152688,592200
109340,269160.2,930650,60860,119385.3,338450,48480,149774.9,592200
110330,269973.9,930650,60700,120291.5,338450,49630,149682.4,592200
111180,259256.2,930650,60530,115054.5,338450,50650,144201.7,592200
111380,262967.5,930650,60110,114698.2,338450,51270,148269.3,592200
111580,260469.7,930650,59710,112328.7,338450,51870,148141,592200
111750,257485.4,930650,59290,107910.9,338450,52460,149574.5,592200
111850,249718.7,930650,58860,102963.4,338450,52990,146755.3,592200
112220,248019.1,930650,58700,103854.5,338450,53520,144164.6,592200
112640,237979.9,930650,58520,98795.6,338450,54120,139184.3,592200
112950,222297.1,930650,58330,90486.6,338450,54620,131810.5,592200
113340,223789.6,930650,58140,93057,338450,55200,130732.6,592200
111920,216946.7,930650,57050,88414.1,338450,54870,128532.6,592200
110440,218654.5,930650,55970,88337.6,338450,54470,130316.9,592200
108990,220628.4,930650,54870,90516.9,338450,54120,130111.5,592200
107590,223975.7,930650,53770,91314.8,338450,53820,132660.9,592200
105630,208478.2,930650,52280,93215.3,338450,53350,115262.9,592200
103650,217702.8,930650,50810,100102.7,338450,52840,117600.1,592200
101630,231327,930650,49310,94581.9,338450,52320,136745.1,592200
136900,216288.2,930650,72020,88785.6,338450,64880,127502.6,592200
134840,201176.7,930650,71240,80041.8,338450,63600,121134.9,592200
132660,198070.3,930650,70420,78422,338450,62240,119648.3,592200
130580,192827.2,930650,69620,76060.4,338450,60960,116766.8,592200
128480,193243.5,930650,68810,77360.8,338450,59670,115882.7,592200
129910,187511,930650,70160,75318.9,338450,59750,112192.1,592200
131300,192412.8,930650,71530,80245.3,338450,59770,112167.5,592200
132660,192276.7,930650,72850,82666.7,338450,59810,109610,592200
134120,182773.5,930650,74200,77308.2,338450,59920,105465.3,592200
135460,172220.1,930650,75370,70282.6,338450,60090,101937.5,592200
136780,162218.8,930650,76530,65057.9,338450,60250,97160.9,592200
138150,156315.2,930650,77700,60938.5,338450,60450,95376.7,592200
139490,153545,930650,78850,60530,338450,60640,93015,592200
139380,144073.9,930650,78810,55188.4,338450,60570,88885.5,592200
139220,137583.3,930650,78730,52074.4,338450,60490,85508.9,592200
139090,137978,930650,78660,52015,338450,60430,85963,592200
138940,142849.1,930650,78590,54194.4,338450,60350,88654.7,592200
137530,146426.8,930650,77770,55413.5,338450,59760,91013.3,592200
136150,141991.4,930650,76970,52320,338450,59180,89671.4,592200
134760,132478.7,930650,76160,47752.6,338450,58600,84726.1,592200
133430,121266.1,930650,75340,41830.2,338450,58090,79435.9,592200
131740,118479.2,930650,74490,40505.9,338450,57250,77973.3,592200
130170,117068.3,930650,73650,40057.4,338450,56520,77010.9,592200
128510,120887.9,930650,72800,42656,338450,55710,78231.9,592200
126880,130427.9,930650,71960,49443.5,338450,54920,80984.4,592200
125370,131456.2,930650,71080,49147.2,338450,54290,82309,592200
124000,136164.6,930650,70220,51532.9,338450,53780,84631.7,592200
122560,143614.5,930650,69330,56945.4,338450,53230,86669.1,592200
121080,146739.8,930650,68490,58614,338450,52590,88125.8,592200
118110,157313.4,930650,66970,63905.1,338450,51140,93408.3,592200
115220,153061.6,930650,65490,60640.1,338450,49730,92421.5,592200
112270,152262.8,930650,63980,58969.3,338450,48290,93293.5,592200
109310,143061.3,930650,62490,53420.9,338450,46820,89640.4,592200
106540,137845.6,930650,61180,50402.6,338450,45360,87443,592200
103800,132138.1,930650,59870,46396.4,338450,43930,85741.7,592200
101080,141008.4,930650,58560,52752.6,338450,42520,88255.8,592200
98390,131161.3,930650,57250,45400,338450,41140,85761.3,592200
95760,130509.8,930650,56000,45513.8,338450,39760,84996,592200
93230,132603.9,930650,54790,47998,338450,38440,84605.9,592200
90640,123471.5,930650,53560,43219.8,338450,37080,80251.7,592200
88080,116023.6,930650,52320,39734.5,338450,35760,76289.1,592200
84910,104623.7,930650,51190,33877.5,338450,33720,70746.2,592200
81810,95495.1,930650,50040,28699.1,338450,31770,66796,592200
78660,96754.4,930650,48950,29220.9,338450,29710,67533.5,592200
75590,99706,930650,47820,33198.1,338450,27770,66507.9,592200
72000,109229.1,930650,46500,39183,338450,25500,70046.1,592200
68500,108088.9,930650,45240,37572.9,338450,23260,70516,592200
64850,105771.7,930650,43930,36712.6,338450,20920,69059.1,592200
61370,109163.7,930650,42650,38702.3,338450,18720,70461.4,592200
57020,109624.5,930650,40640,40148.6,338450,16380,69475.9,592200
52830,112782.9,930650,38680,40303.1,338450,14150,72479.8,592200
48510,111365.3,930650,36690,38916.4,338450,11820,72448.9,592200
44280,109662.9,930650,34730,37654.2,338450,9550,72008.7,592200
44840,110773.2,930650,34880,37745.8,338450,9960,73027.4,592200
45410,111304.9,930650,35030,38752.8,338450,10380,72552.1,592200
46030,106074,930650,35200,35162.6,338450,10830,70911.4,592200
46560,104933.5,930650,35370,33935.2,338450,11190,70998.3,592200
47600,102290.1,930650,35780,30904.3,338450,11820,71385.8,592200
48610,102958.6,930650,36150,30425.5,338450,12460,72533.1,592200
49630,103567.8,930650,36520,30105.1,338450,13110,73462.7,592200
50700,106780.5,930650,36910,31002.2,338450,13790,75778.3,592200
52090,118023.9,930650,37640,38407.6,338450,14450,79616.3,592200
53600,121178.8,930650,38360,40170.6,338450,15240,81008.2,592200
55080,115420,930650,39100,35990.1,338450,15980,79429.9,592200
56520,109626.2,930650,39840,30906.3,338450,16680,78719.9,592200
61190,110033.5,930650,42240,30294.5,338450,18950,79739,592200
65810,113472.5,930650,44610,33500,338450,21200,79972.5,592200
70480,118693.6,930650,47030,35200.8,338450,23450,83492.8,592200
75080,134171.5,930650,49420,46111.1,338450,25660,88060.4,592200
79960,136228.9,930650,52080,52122.6,338450,27880,84106.3,592200
84820,142699.3,930650,54730,54214,338450,30090,88485.3,592200
89660,151344.1,930650,57410,59054.2,338450,32250,92289.9,592200
94550,155456,930650,60070,59911.3,338450,34480,95544.7,592200
99310,163707.5,930650,62780,62544,338450,36530,101163.5,592200
104100,177862.3,930650,65500,71031.1,338450,38600,106831.2,592200
108910,165387,930650,68230,62041.3,338450,40680,103345.7,592200
113660,176272.1,930650,70940,68171.6,338450,42720,108100.5,592200
113650,188985.8,930650,70980,76434.7,338450,42670,112551.1,592200
113540,199699.2,930650,71020,83904.5,338450,42520,115794.7,592200
113490,186069.5,930650,71070,75339.7,338450,42420,110729.8,592200
113440,165279.4,930650,71110,67147,338450,42330,98132.4,592200
112550,136760.4,930650,70590,61797.6,338450,41960,74962.8,592200
111680,136625.4,930650,70050,62810.7,338450,41630,73814.7,592200
110850,132438.7,930650,69530,60586.8,338450,41320,71851.9,592200
109990,138803.9,930650,69010,63670.2,338450,40980,75133.7,592200
108690,182247.7,930650,68110,71783.8,338450,40580,110463.9,592200
107460,182168.5,930650,67250,72827.7,338450,40210,109340.8,592200
106210,162836.3,930650,66390,61400.9,338450,39820,101435.4,592200
104950,160618.1,930650,65510,60276.1,338450,39440,100342,592200
102790,153631,930650,64050,55408.6,338450,38740,98222.4,592200
100520,148074.6,930650,62540,51773.9,338450,37980,96300.7,592200
98270,143223,930650,61060,49620.2,338450,37210,93602.8,592200
96000,141548.8,930650,59580,48603.7,338450,36420,92945.1,592200
93770,142350.8,930650,58110,47565.8,338450,35660,94785,592200
91500,144015.1,930650,56630,48505.6,338450,34870,95509.5,592200
89180,143374.6,930650,55120,47788.1,338450,34060,95586.5,592200
112500,139267.4,930650,70550,47978.5,338450,41950,91288.9,592200
112330,132658.8,930650,70820,44331.3,338450,41510,88327.5,592200
112230,139005.2,930650,71100,48215.3,338450,41130,90789.9,592200
112120,139132.6,930650,71370,46842.7,338450,40750,92289.9,592200
112030,128583.3,930650,71640,40210.2,338450,40390,88373.1,592200
113600,133867.1,930650,72000,43467.9,338450,41600,90399.2,592200
115110,138598,930650,72350,47220.8,338450,42760,91377.2,592200
116650,147517.5,930650,72720,52376.9,338450,43930,95140.6,592200
118220,147751.6,930650,73070,52408.5,338450,45150,95343.1,592200
120180,158165.4,930650,73660,58904.3,338450,46520,99261.1,592200
122090,159003,930650,74250,59196.1,338450,47840,99806.9,592200
124030,152993.2,930650,74830,54095.9,338450,49200,98897.3,592200
126010,160360.5,930650,75430,59981,338450,50580,100379.5,592200
127960,157040.3,930650,76480,58020,338450,51480,99020.3,592200
129940,143183.3,930650,77570,51910.1,338450,52370,91273.2,592200
132010,112755.3,930650,78650,46579.6,338450,53360,66175.7,592200
134000,115476,930650,79730,50592.2,338450,54270,64883.8,592200
136130,113342,930650,82000,51403.8,338450,54130,61938.2,592200
138240,119506.5,930650,84270,57533,338450,53970,61973.5,592200
140370,124541,930650,86560,62127.8,338450,53810,62413.2,592200
142450,124837.4,930650,88800,62079.1,338450,53650,62758.3,592200
144290,125755.2,930650,90810,61229.2,338450,53480,64526,592200
146030,130035.2,930650,92780,63454.5,338450,53250,66580.7,592200
147870,145795.8,930650,94770,73671.1,338450,53100,72124.7,592200
149600,167425.9,930650,96740,88349.3,338450,52860,79076.6,592200
150930,167431.3,930650,98120,91535.7,338450,52810,75895.6,592200
152240,171776.1,930650,99530,95698.6,338450,52710,76077.5,592200
153600,175160.9,930650,100930,97538.8,338450,52670,77622.1,592200
154910,189989.9,930650,102310,105943.1,338450,52600,84046.8,592200
155350,205322.2,930650,101710,114590.5,338450,53640,90731.7,592200
155800,211657.6,930650,101110,117787,338450,54690,93870.6,592200
156240,205912.5,930650,100520,118866.1,338450,55720,87046.4,592200
156620,223498.9,930650,99900,131011,338450,56720,92487.9,592200
157420,234956.4,930650,99770,140434.6,338450,57650,94521.8,592200
158100,265855.1,930650,99590,154610.4,338450,58510,111244.7,592200
158870,268103.3,930650,99450,162898.2,338450,59420,105205.1,592200
159570,269174.6,930650,99290,154944.8,338450,60280,114229.8,592200
160240,233907.1,930650,99230,148740.1,338450,61010,85167,592200
160860,233308.1,930650,99140,147048.9,338450,61720,86259.2,592200
161550,241479.1,930650,99070,143427.7,338450,62480,98051.4,592200
162190,243232.9,930650,98980,142134.7,338450,63210,101098.2,592200
157320,220382.9,930650,95320,124430,338450,62000,95952.9,592200
152460,225572.1,930650,91690,110503,338450,60770,115069.1,592200
147580,197310.8,930650,88010,94054.5,338450,59570,103256.3,592200
142710,208650.1,930650,84400,99981.1,338450,58310,108669,592200
138680,213279.7,930650,80850,97695,338450,57830,115584.7,592200
134670,214117.1,930650,77340,96095.7,338450,57330,118021.4,592200
130630,223910.8,930650,73820,103581.8,338450,56810,120329,592200
126620,216529.8,930650,70310,99611,338450,56310,116918.8,592200
122580,196929.4,930650,66540,84674,338450,56040,112255.4,592200
118500,166306.5,930650,62750,65533.5,338450,55750,100773,592200
114420,148568,930650,58990,55436.8,338450,55430,93131.2,592200
110420,140223,930650,55230,46827.6,338450,55190,93395.4,592200
110190,122792.4,930650,54030,33973.1,338450,56160,88819.3,592200
110110,113904.6,930650,52830,28831.6,338450,57280,85073,592200
109880,113001.3,930650,51660,28482.4,338450,58220,84518.9,592200
109740,116404.3,930650,50470,32315.1,338450,59270,84089.2,592200
110070,117371.4,930650,49650,33598.2,338450,60420,83773.2,592200
110310,124632,930650,48810,37809.5,338450,61500,86822.5,592200
110610,121833.5,930650,47990,36027.6,338450,62620,85805.9,592200
110920,112925.8,930650,47170,27755.8,338450,63750,85170,592200
111610,112394.5,930650,46410,25642.6,338450,65200,86751.9,592200
112180,116139.3,930650,45640,28238.1,338450,66540,87901.2,592200
112850,113859.3,930650,44870,25860.8,338450,67980,87998.5,592200
113460,116325.2,930650,44110,27666.2,338450,69350,88659,592200
112900,113861.8,930650,43090,24904.3,338450,69810,88957.5,592200
112380,116610.9,930650,42080,25219.6,338450,70300,91391.3,592200
111820,123997.7,930650,41060,27851.3,338450,70760,96146.4,592200
111260,120932.2,930650,40040,24527.8,338450,71220,96404.4,592200
111040,122373.3,930650,39480,24117.6,338450,71560,98255.7,592200
110830,124576.7,930650,38910,27019.6,338450,71920,97557.1,592200
110660,123418.6,930650,38350,25122.9,338450,72310,98295.7,592200
110430,123309.8,930650,37780,22986.9,338450,72650,100322.9,592200
110110,118728.3,930650,37210,19538.2,338450,72900,99190.1,592200
109790,116456.6,930650,36660,18344.4,338450,73130,98112.2,592200
109510,108752.6,930650,36100,15272.7,338450,73410,93479.9,592200
109210,104037,930650,35560,15392.6,338450,73650,88644.4,592200
105150,103768.3,930650,34160,15130.9,338450,70990,88637.4,592200
101140,103907.1,930650,32760,15151.4,338450,68380,88755.7,592200
97140,100445.3,930650,31360,12661.4,338450,65780,87783.9,592200
93120,103304.5,930650,29950,14727.2,338450,63170,88577.3,592200
88880,99875.9,930650,28700,12962.6,338450,60180,86913.3,592200
84690,94841,930650,27430,12320.9,338450,57260,82520.1,592200
80520,99618.5,930650,26180,14126.5,338450,54340,85492,592200
76270,101247.2,930650,24910,15715.2,338450,51360,85532,592200
71950,99907.1,930650,23440,16635.5,338450,48510,83271.6,592200
67540,98698.4,930650,21960,16918.1,338450,45580,81780.3,592200
63240,97967,930650,20490,18538.7,338450,42750,79428.3,592200
58810,103580.6,930650,19000,23345.7,338450,39810,80234.9,592200
56530,102433.9,930650,18110,22091.8,338450,38420,80342.1,592200
54200,98994.4,930650,17210,19983.7,338450,36990,79010.7,592200
51880,68369.3,930650,16290,16648.3,338450,35590,51721,592200
49610,72754.5,930650,15400,19089.7,338450,34210,53664.8,592200
47660,77012.4,930650,14680,20679,338450,32980,56333.4,592200
45630,74156.2,930650,13960,18689.4,338450,31670,55466.8,592200
43700,69849.9,930650,13270,15966.8,338450,30430,53883.1,592200
35010,74221.4,930650,7730,18187.9,338450,27280,56033.5,592200
32630,69019.4,930650,7070,15488.1,338450,25560,53531.3,592200
30110,66096.4,930650,6400,14735.5,338450,23710,51360.9,592200
27720,65708.3,930650,5740,16523.9,338450,21980,49184.4,592200
25290,65374.9,930650,5070,17450.6,338450,20220,47924.3,592200
24390,63502.8,930650,5010,17145.9,338450,19380,46356.9,592200
23430,64582.4,930650,4900,17732.9,338450,18530,46849.5,592200
22500,65285.1,930650,4810,18637.8,338450,17690,46647.3,592200
21620,65096.6,930650,4710,19825.7,338450,16910,45270.9,592200
20800,54669.4,930650,4650,13650.5,338450,16150,41018.9,592200
19930,51073.9,930650,4590,11902,338450,15340,39171.9,592200
19120,52370.5,930650,4540,12992.9,338450,14580,39377.6,592200
18270,52326.7,930650,4480,13079.4,338450,13790,39247.3,592200
17460,46161,930650,4340,8344.5,338450,13120,37816.5,592200
16620,46219.3,930650,4200,8112.8,338450,12420,38106.5,592200
15790,47246.5,930650,4080,8095,338450,11710,39151.5,592200
15000,45281.6,930650,3940,6533.7,338450,11060,38747.9,592200
14750,44665.2,930650,3930,6218,338450,10820,38447.2,592200
14490,42590.2,930650,3920,4249.7,338450,10570,38340.5,592200
14210,44086.1,930650,3920,5342.5,338450,10290,38743.6,592200
14030,48493.7,930650,3920,8781.5,338450,10110,39712.2,592200
13880,50194.5,930650,4030,10571.6,338450,9850,39622.9,592200
13720,49796,930650,4110,9840.5,338450,9610,39955.5,592200
13530,47052.8,930650,4200,8232.9,338450,9330,38819.9,592200
13410,46191.4,930650,4300,8719.7,338450,9110,37471.7,592200
13110,51147.6,930650,4410,12599.8,338450,8700,38547.8,592200
12790,55312.8,930650,4530,15577.5,338450,8260,39735.3,592200
12500,59171.7,930650,4630,18146,338450,7870,41025.7,592200
12250,59879.6,930650,4750,18372.2,338450,7500,41507.4,592200
12510,62645.3,930650,5210,19961.7,338450,7300,42683.6,592200
12760,66326.1,930650,5670,22598.9,338450,7090,43727.2,592200
13010,69729.3,930650,6100,24724.2,338450,6910,45005.1,592200
13270,71755.1,930650,6550,26037.9,338450,6720,45717.2,592200
13890,76933.2,930650,7250,30137.8,338450,6640,46795.4,592200
14640,81457.2,930650,7960,34209.7,338450,6680,47247.5,592200
15290,82256.3,930650,8660,34553.9,338450,6630,47702.4,592200
15940,78921.7,930650,9350,31555.2,338450,6590,47366.5,592200
17520,102479.7,930650,10870,31184,338450,6650,71295.7,592200
18980,100883.2,930650,12380,29426.8,338450,6600,71456.4,592200
20490,97832.8,930650,13890,27659.8,338450,6600,70173,592200
21990,100104.4,930650,15430,29982.6,338450,6560,70121.8,592200
23950,110877.7,930650,16860,39589,338450,7090,71288.7,592200
25860,108115.2,930650,18280,38879.2,338450,7580,69236,592200
27780,107411.1,930650,19710,36187.1,338450,8070,71224,592200
29720,100639,930650,21130,32800.9,338450,8590,67838.1,592200
31610,99002.1,930650,22760,31859.9,338450,8850,67142.2,592200
33520,99002.1,930650,24360,31859.9,338450,9160,67142.2,592200
35440,107290,930650,25960,33262.6,338450,9480,74027.4,592200
37280,115072.4,930650,27570,34084.9,338450,9710,80987.5,592200
38680,110839.9,930650,28790,34773.1,338450,9890,76066.8,592200
40150,110217,930650,30050,37314.1,338450,10100,72902.9,592200
41570,116624.1,930650,31290,39872.9,338450,10280,76751.2,592200
42970,118446.5,930650,32530,39800.8,338450,10440,78645.7,592200
44510,112549.2,930650,32880,37373.8,338450,11630,75175.4,592200
46090,109635.6,930650,33210,35289.1,338450,12880,74346.5,592200
47650,110634.9,930650,33560,33883.5,338450,14090,76751.4,592200
49200,109231.4,930650,33910,31146.1,338450,15290,78085.3,592200
51780,108695.1,930650,35280,29613.4,338450,16500,79081.7,592200
54320,119044.6,930650,36660,34598.3,338450,17660,84446.3,592200
56900,125811.1,930650,38010,37858,338450,18890,87953.1,592200
59490,136056.5,930650,39390,42692.6,338450,20100,93363.9,592200
64010,146904.4,930650,42310,48961.1,338450,21700,97943.3,592200
68510,162578.1,930650,45210,59646.4,338450,23300,102931.7,592200
73020,171338.9,930650,48140,66000.1,338450,24880,105338.8,592200
77510,173280.6,930650,51070,66988.5,338450,26440,106292.1,592200
96080,200566.1,930650,60040,82583.2,338450,36040,117982.9,592200
114730,226087.1,930650,69030,97893,338450,45700,128194.1,592200
133320,247201.7,930650,78010,112105.7,338450,55310,135096,592200
151840,277453.8,930650,87000,129452.4,338450,64840,148001.4,592200
170580,319037.2,930650,96770,150078.8,338450,73810,168958.4,592200
189210,338600.1,930650,106560,165180.2,338450,82650,173419.9,592200
207880,349447.3,930650,116340,169244.6,338450,91540,180202.7,592200
226560,379072.4,930650,126110,188743.4,338450,100450,190329,592200
244580,392521.7,930650,135930,198365.1,338450,108650,194156.6,592200
262530,388735,930650,145730,192806.5,338450,116800,195928.5,592200
280650,433453.4,930650,155570,209924.7,338450,125080,223528.7,592200
298550,420889.9,930650,165370,214559.9,338450,133180,206330,592200
316530,459795.3,930650,170170,229827.3,338450,146360,229968,592200
334420,466399.3,930650,174960,219000.1,338450,159460,247399.2,592200
352330,487214.1,930650,179740,233869.3,338450,172590,253344.8,592200
370290,514068.5,930650,184540,249645.9,338450,185750,264422.6,592200
390260,527279,930650,190790,254154.7,338450,199470,273124.3,592200
410170,542379.2,930650,197050,257865.7,338450,213120,284513.5,592200
430180,545976.6,930650,203310,253022.8,338450,226870,292953.8,592200
450170,554036.6,930650,209570,255366.4,338450,240600,298670.2,592200
467990,540219.3,930650,214580,249917,338450,253410,290302.3,592200
485840,543799.2,930650,219610,255083.8,338450,266230,288715.4,592200
503720,549613.5,930650,224630,259542,338450,279090,290071.5,592200
521580,526327.5,930650,229660,251987.6,338450,291920,274339.9,592200
526110,522319.4,930650,230870,246596.1,338450,295240,275723.3,592200
530640,534521.4,930650,232080,248823.2,338450,298560,285698.2,592200
535100,522546.6,930650,233280,243814.8,338450,301820,278731.8,592200
539630,512604.1,930650,234460,241491.5,338450,305170,271112.6,592200
544310,504648.7,930650,235410,240234,338450,308900,264414.7,592200
548910,506746.2,930650,236330,240939.3,338450,312580,265806.9,592200
553540,496499.7,930650,237260,237252.7,338450,316280,259247,592200
557240,493440.3,930650,250320,238902.9,338450,306920,254537.4,592200
561180,495178.2,930650,251870,236630.7,338450,309310,258547.5,592200
564990,489562.6,930650,253410,236285.7,338450,311580,253276.9,592200
568890,472457.2,930650,254980,231949.5,338450,313910,240507.7,592200
572880,485286.9,930650,256540,237109.7,338450,316340,248177.2,592200
571580,488405.5,930650,255720,232386.4,338450,315860,256019.1,592200
570330,496829.8,930650,254900,234185.6,338450,315430,262644.2,592200
569100,499600.7,930650,254080,223764,338450,315020,275836.7,592200
567820,488312.3,930650,253230,226155.4,338450,314590,262156.9,592200
567620,462993.7,930650,253420,220275.7,338450,314200,242718,592200
567380,452894.2,930650,253610,217121.2,338450,313770,235773,592200
567210,465897.5,930650,253800,213150.2,338450,313410,252747.3,592200
566990,467249.8,930650,253970,215079.5,338450,313020,252170.3,592200
567570,476411.8,930650,254050,221942.5,338450,313520,254469.3,592200
568210,477086,930650,254130,222061.7,338450,314080,255024.3,592200
568720,485710.6,930650,254210,224627.8,338450,314510,261082.8,592200
569340,489645.4,930650,254300,224031.9,338450,315040,265613.5,592200
572870,497644.6,930650,254650,226831.8,338450,318220,270812.8,592200
576510,510944.1,930650,254990,235257.3,338450,321520,275686.8,592200
580030,497295.7,930650,255310,227406.1,338450,324720,269889.6,592200
583580,499274,930650,255650,231168.2,338450,327930,268105.8,592200
586260,500976.9,930650,255350,231726.8,338450,330910,269250.1,592200
588940,517240.6,930650,255060,234333.7,338450,333880,282906.9,592200
591650,533863.8,930650,254770,238755.7,338450,336880,295108.1,592200
594280,540199.8,930650,254460,237079.8,338450,339820,303120,592200
595790,530208.8,930650,253510,238930.5,338450,342280,291278.3,592200
597310,532162.1,930650,252550,248464.9,338450,344760,283697.2,592200
598730,544942.4,930650,251570,250143.5,338450,347160,294798.9,592200
600250,547970.9,930650,250610,246750.4,338450,349640,301220.5,592200
594820,539077.2,930650,247420,240468.5,338450,347400,298608.7,592200
589440,539693.5,930650,244260,239660.5,338450,345180,300033,592200
583960,504541.5,930650,241090,229254,338450,342870,275287.5,592200
578630,481861.6,930650,237910,229463.8,338450,340720,252397.8,592200
572610,474998.1,930650,234930,233665,338450,337680,241333.1,592200
566700,497252.7,930650,231930,235442.7,338450,334770,261810,592200
560760,486124.7,930650,228960,221664.5,338450,331800,264460.2,592200
554800,495931,930650,225960,225786.8,338450,328840,270144.2,592200
548530,509419.2,930650,222340,225210.9,338450,326190,284208.3,592200
542270,511363.2,930650,218710,224076.4,338450,323560,287286.8,592200
536030,499139.6,930650,215090,219929.4,338450,320940,279210.2,592200
529800,494159.5,930650,211460,214932.4,338450,318340,279227.1,592200
514900,480289.2,930650,205560,201042.2,338450,309340,279247,592200
500100,452031.4,930650,199690,179096.5,338450,300410,272934.9,592200
485200,444171.4,930650,193780,178924.4,338450,291420,265247,592200
470340,443040.3,930650,187870,186305.4,338450,282470,256734.9,592200
456320,425830,930650,183820,182232.3,338450,272500,243597.7,592200
442360,433835.1,930650,179750,181924.7,338450,262610,251910.4,592200
428410,441844.3,930650,175720,186457.6,338450,252690,255386.7,592200
414420,397678.7,930650,171650,166126.3,338450,242770,231552.4,592200
399300,386552.1,930650,165750,163947.5,338450,233550,222604.6,592200
384200,346999.4,930650,159870,137445.8,338450,224330,209553.6,592200
369120,285395.8,930650,154020,100018.4,338450,215100,185377.4,592200
354070,259602.6,930650,148130,87921.3,338450,205940,171681.3,592200
349200,269738.3,930650,146120,99678.7,338450,203080,170059.6,592200
344330,310694.6,930650,144110,129262.3,338450,200220,181432.3,592200
339440,336100.7,930650,142080,145419.8,338450,197360,190680.9,592200
334580,358736.7,930650,140100,157918.2,338450,194480,200818.5,592200
329600,373363.7,930650,137630,165755.5,338450,191970,207608.2,592200
324600,402259.9,930650,135190,186608.4,338450,189410,215651.5,592200
319620,388039.7,930650,132710,179750,338450,186910,208289.7,592200
314650,379933.2,930650,130280,172249.3,338450,184370,207683.9,592200
311930,358494.8,930650,129680,166159.5,338450,182250,192335.3,592200
309230,329752.3,930650,129100,152238.8,338450,180130,177513.5,592200
306580,298561.4,930650,128510,137340.8,338450,178070,161220.6,592200
303870,316987.9,930650,127960,154519.5,338450,175910,162468.4,592200
304150,341346.8,930650,125990,168854.3,338450,178160,172492.5,592200
304550,308271.2,930650,124020,149945.8,338450,180530,158325.4,592200
304860,315264.9,930650,122050,143098.4,338450,182810,172166.5,592200
305100,340450.5,930650,120090,168742.1,338450,185010,171708.4,592200
307340,346664.8,930650,119460,179647.4,338450,187880,167017.4,592200
309530,309533.1,930650,118780,152756.9,338450,190750,156776.2,592200
311680,282621.5,930650,118120,132047,338450,193560,150574.5,592200
313820,265367.8,930650,117470,118435.8,338450,196350,146932,592200
311320,265374.2,930650,114370,118418,338450,196950,146956.2,592200
308870,250098.9,930650,111270,110505.5,338450,197600,139593.4,592200
306420,248605,930650,108190,107204.2,338450,198230,141400.8,592200
303870,270075.6,930650,105080,118465.6,338450,198790,151610,592200
310330,237778.7,930650,107340,93463.9,338450,202990,144314.8,592200
316790,244408.8,930650,109560,98388.3,338450,207230,146020.5,592200
323160,265331.2,930650,111820,114957.2,338450,211340,150374,592200
329560,328539.7,930650,114020,157610,338450,215540,170929.7,592200
335770,343561.4,930650,117380,169517.8,338450,218390,174043.6,592200
341940,341546.1,930650,120720,167058.7,338450,221220,174487.4,592200
348150,330811.2,930650,124080,158710,338450,224070,172101.2,592200
354390,359332.8,930650,127430,173783.7,338450,226960,185549.1,592200
360750,378939.6,930650,131040,178919.1,338450,229710,200020.5,592200
367180,355760.8,930650,134670,157686.7,338450,232510,198074.1,592200
373570,396993.2,930650,138290,180995.5,338450,235280,215997.7,592200
379910,392415,930650,141930,175029.3,338450,237980,217385.7,592200
394260,431620.6,930650,149780,200378,338450,244480,231242.6,592200
408590,444476.7,930650,157640,207639.1,338450,250950,236837.6,592200
422940,513478.7,930650,165510,254525.9,338450,257430,258952.8,592200
437300,531958.4,930650,173390,266254.7,338450,263910,265703.7,592200
453850,576808.6,930650,182000,288824.4,338450,271850,287984.2,592200
470440,583292.5,930650,190620,282944.3,338450,279820,300348.2,592200
487060,597192.4,930650,199230,290658.4,338450,287830,306534,592200
540690,611671.8,930650,236180,298981.8,338450,304510,312690,592200
560230,592626.6,930650,243480,285364.8,338450,316750,307261.8,592200
579780,605752.7,930650,250770,276688.7,338450,329010,329064,592200
599350,598751.5,930650,258090,266660.1,338450,341260,332091.4,592200
618860,640439.2,930650,265380,287349.8,338450,353480,353089.4,592200
629440,665110.9,930650,268060,301134.1,338450,361380,363976.8,592200
639910,677419.4,930650,270730,303725.1,338450,369180,373694.3,592200
650370,696035.8,930650,273400,310041.6,338450,376970,385994.2,592200
660940,694002.1,930650,276090,311866.8,338450,384850,382135.3,592200
672160,702577.9,930650,279020,315188.2,338450,393140,387389.7,592200
683320,706329.5,930650,281940,317596.5,338450,401380,388733,592200
694490,709311.1,930650,284870,320099.6,338450,409620,389211.5,592200
705670,636502.8,930650,287820,268156,338450,417850,368346.8,592200
717340,719783.1,930650,291790,320965,338450,425550,398818.1,592200
728920,731353.4,930650,295740,322366.9,338450,433180,408986.5,592200
740560,741131.5,930650,299720,323498.5,338450,440840,417633,592200
752150,731816.7,930650,303670,321998.3,338450,448480,409818.4,592200
756610,753025.7,930650,304590,323507.9,338450,452020,429517.8,592200
761010,724081.4,930650,305490,320733.7,338450,455520,403347.7,592200
765440,751335.6,930650,306380,321595.9,338450,459060,429739.7,592200
769850,735918,930650,307310,321144.6,338450,462540,414773.4,592200
774590,723438.8,930650,308200,320061.7,338450,466390,403377.1,592200
779290,730161.3,930650,309130,320861.2,338450,470160,409300.1,592200
784080,732786.3,930650,310050,320952.2,338450,474030,411834.1,592200
788830,730603.3,930650,311000,321148.3,338450,477830,409455,592200
793790,730166.8,930650,311930,320407.5,338450,481860,409759.3,592200
798740,735101.2,930650,312850,320671.1,338450,485890,414430.1,592200
803730,740406.5,930650,313780,321758.4,338450,489950,418648.1,592200
808720,720430.4,930650,314700,320143.7,338450,494020,400286.7,592200
811470,710940.8,930650,315330,320010.7,338450,496140,390930.1,592200
814200,716350.7,930650,315970,322872.9,338450,498230,393477.8,592200
817060,720851.3,930650,316600,318987.9,338450,500460,401863.4,592200
819850,741717.8,930650,317220,319871.8,338450,502630,421846,592200
822420,720197.7,930650,317570,318301.3,338450,504850,401896.4,592200
825000,721514.3,930650,317940,320950.7,338450,507060,400563.6,592200
827620,723084.1,930650,318310,322097.1,338450,509310,400987,592200
830200,723268,930650,318650,320935.6,338450,511550,402332.4,592200
831900,746000.7,930650,318780,322936.2,338450,513120,423064.5,592200
833700,761756.6,930650,318910,325954.4,338450,514790,435802.2,592200
835440,768762,930650,319070,326759.4,338450,516370,442002.6,592200
837160,753665.7,930650,319180,324583.2,338450,517980,429082.5,592200
834450,754349.3,930650,318330,326031.2,338450,516120,428318.1,592200
831700,754226.8,930650,317470,325801.4,338450,514230,428425.4,592200
829010,747971.1,930650,316610,322259.6,338450,512400,425711.5,592200
826270,749611.5,930650,315770,322371.1,338450,510500,427240.4,592200
822240,745399.8,930650,313440,322019.4,338450,508800,423380.4,592200
818210,766589.1,930650,311130,324570.2,338450,507080,442018.9,592200
814130,754341.7,930650,308790,326165.9,338450,505340,428175.8,592200
810130,758383.8,930650,306480,326574.4,338450,503650,431809.4,592200
807100,755216.4,930650,306260,324768.2,338450,500840,430448.2,592200
804090,767140.4,930650,306030,326026.7,338450,498060,441113.7,592200
801080,760547.5,930650,305800,325271.8,338450,495280,435275.7,592200
798060,759543.5,930650,305570,324853.5,338450,492490,434690,592200
778970,749342.4,930650,299880,322657.7,338450,479090,426684.7,592200
759840,742148.5,930650,294200,321674.6,338450,465640,420473.9,592200
740700,703164.9,930650,288520,306992.4,338450,452180,396172.5,592200
721610,693800.9,930650,282820,308703.7,338450,438790,385097.2,592200
702500,665470.7,930650,277150,309765,338450,425350,355705.7,592200
683490,661389.9,930650,271490,310377.2,338450,412000,351012.7,592200
664460,666145.8,930650,265840,313280.4,338450,398620,352865.4,592200
645460,667327.8,930650,260190,315404.9,338450,385270,351922.9,592200
625930,650486.2,930650,254230,309216.1,338450,371700,341270.1,592200
606510,639506.1,930650,248260,305735.8,338450,358250,333770.3,592200
586940,608495.2,930650,242280,293207.8,338450,344660,315287.4,592200
567430,600709.9,930650,236340,291290.8,338450,331090,309419.1,592200
557500,555849.2,930650,234690,271583.6,338450,322810,284265.6,592200
547630,484962.6,930650,233040,230733.8,338450,314590,254228.8,592200
537610,433372.4,930650,231400,196546.6,338450,306210,236825.8,592200
527750,430972.4,930650,229770,193453.8,338450,297980,237518.6,592200
518250,446449,930650,227940,201586.3,338450,290310,244862.7,592200
508860,469313,930650,226140,223547.6,338450,282720,245765.4,592200
499440,449418,930650,224330,216381.3,338450,275110,233036.7,592200
490000,389960.4,930650,222490,185465.8,338450,267510,204494.6,592200
481130,441016.3,930650,221180,221065,338450,259950,219951.3,592200
472260,494285.6,930650,219890,248399.6,338450,252370,245886,592200
463390,525475.9,930650,218560,262153.9,338450,244830,263322,592200
454540,517765.2,930650,217280,254613.1,338450,237260,263152.1,592200
457090,524420.5,930650,219280,263128.6,338450,237810,261291.9,592200
459780,534713.2,930650,221330,276810.9,338450,238450,257902.3,592200
462310,523088.9,930650,223340,270527,338450,238970,252561.9,592200
464870,537277,930650,225340,279595.7,338450,239530,257681.3,592200
466840,524411.6,930650,226620,264995.6,338450,240220,259416,592200
468730,509049.7,930650,227890,244453.4,338450,240840,264596.3,592200
470660,519888.2,930650,229170,244173.6,338450,241490,275714.6,592200
472520,535306.3,930650,230440,258880.2,338450,242080,276426.1,592200
474520,511185.4,930650,231580,248080.9,338450,242940,263104.5,592200
476510,508606.2,930650,232750,249201.7,338450,243760,259404.5,592200
478530,516829.2,930650,233910,254095.6,338450,244620,262733.6,592200
480520,482679.2,930650,235050,241531.3,338450,245470,241147.9,592200
484020,476222.2,930650,235010,234354.6,338450,249010,241867.6,592200
487650,526578.6,930650,234990,263801.8,338450,252660,262776.8,592200
491160,536976.2,930650,234960,273261.3,338450,256200,263714.9,592200
494700,477719.9,930650,234930,239363.7,338450,259770,238356.2,592200
499040,493266.4,930650,235010,248957.1,338450,264030,244309.3,592200
503390,509346.5,930650,235090,266931.1,338450,268300,242415.4,592200
507720,496086.6,930650,235170,257508,338450,272550,238578.6,592200
524010,486813.5,930650,236880,247791.2,338450,287130,239022.3,592200
521550,474262.9,930650,235690,238510.7,338450,285860,235752.2,592200
519150,470736.3,930650,234480,231464.9,338450,284670,239271.4,592200
516720,450235.6,930650,233280,218187.9,338450,283440,232047.7,592200
514310,461131.1,930650,232080,235599.7,338450,282230,225531.4,592200
511000,468261.8,930650,230650,239554.6,338450,280350,228707.2,592200
507860,429235.2,930650,229270,205302.7,338450,278590,223932.5,592200
504640,449959.4,930650,227860,219579.9,338450,276780,230379.5,592200
501440,472429,930650,226470,237193.3,338450,274970,235235.7,592200
497440,470028,930650,225030,234026.8,338450,272410,236001.2,592200
493320,412806.6,930650,223560,195503.6,338450,269760,217303,592200
489240,409589.5,930650,222110,189193.5,338450,267130,220396,592200
485230,449286.5,930650,220660,219616.1,338450,264570,229670.4,592200
480600,456832.1,930650,218470,222588.8,338450,262130,234243.3,592200
475920,483298.3,930650,216290,236662,338450,259630,246636.3,592200
471300,495369,930650,214120,246072.5,338450,257180,249296.5,592200
466650,459047.2,930650,211940,219258.8,338450,254710,239788.4,592200
463670,479938.4,930650,210080,220324.4,338450,253590,259614,592200
460730,489422.8,930650,208270,223981.7,338450,252460,265441.1,592200
457730,467422.4,930650,206430,213238.4,338450,251300,254184,592200
454770,445551.1,930650,204600,206664.9,338450,250170,238886.2,592200
450950,447938.1,930650,201750,209482.1,338450,249200,238456,592200
447090,460593.6,930650,198890,219571.9,338450,248200,241021.7,592200
443290,473765.6,930650,196030,227765.6,338450,247260,246000,592200
439350,494271.2,930650,193150,238018.4,338450,246200,256252.8,592200
434060,514536.6,930650,189960,248558.3,338450,244100,265978.3,592200
428600,502694.4,930650,186770,240919.7,338450,241830,261774.7,592200
423260,499019.9,930650,183570,241264.6,338450,239690,257755.3,592200
417900,508877.5,930650,180380,256267.7,338450,237520,252609.8,592200
410220,490885.8,930650,176910,247664.5,338450,233310,243221.3,592200
402520,468603.8,930650,173440,250194,338450,229080,218409.8,592200
394810,441367.7,930650,169940,230205.2,338450,224870,211162.5,592200
387160,417709.9,930650,166480,213907.8,338450,220680,203802.1,592200
378250,361177.2,930650,161950,169895.9,338450,216300,191281.3,592200
369360,342503.2,930650,157450,156980.6,338450,211910,185522.6,592200
360440,329092.2,930650,152950,148112.3,338450,207490,180979.9,592200
351500,364494.9,930650,148440,172770.4,338450,203060,191724.5,592200
340930,378196.5,930650,142730,183210.7,338450,198200,194985.8,592200
330330,395889.6,930650,137030,191571.5,338450,193300,204318.1,592200
319780,397906.4,930650,131330,192711.9,338450,188450,205194.5,592200
309230,381274.1,930650,125620,177772.7,338450,183610,203501.4,592200
315870,349335.6,930650,129860,156552.5,338450,186010,192783.1,592200
322610,345888.3,930650,134130,149234.6,338450,188480,196653.7,592200
329300,308784.4,930650,138380,130187,338450,190920,178597.4,592200
335950,328713.5,930650,142610,149694.1,338450,193340,179019.4,592200
343370,322115.4,930650,146610,146531.6,338450,196760,175583.8,592200
350760,301981.9,930650,150600,132090.7,338450,200160,169891.2,592200
358150,325099.3,930650,154570,142147.7,338450,203580,182951.6,592200
365560,328218.7,930650,158580,147330.9,338450,206980,180887.8,592200
370510,343676.9,930650,160650,158573,338450,209860,185103.9,592200
375550,375263,930650,162690,179805.4,338450,212860,195457.6,592200
380460,381698.3,930650,164740,184694.1,338450,215720,197004.2,592200
385380,339805.5,930650,166800,156891.5,338450,218580,182914,592200
388400,360594.2,930650,170100,171447.3,338450,218300,189146.9,592200
391320,358959.7,930650,173420,177457.5,338450,217900,181502.2,592200
394260,375574.6,930650,176730,192490.2,338450,217530,183084.4,592200
397240,384195.7,930650,180050,192918.1,338450,217190,191277.6,592200
400320,396094.7,930650,183590,193092.4,338450,216730,203002.3,592200
403320,414958.3,930650,187100,207280.2,338450,216220,207678.1,592200
406380,443107.2,930650,190640,222483.3,338450,215740,220623.9,592200
409360,442586.8,930650,194160,225663.4,338450,215200,216923.4,592200
414450,455571.1,930650,198730,223960.6,338450,215720,231610.5,592200
419550,474223.4,930650,203290,233850,338450,216260,240373.4,592200
424630,517087.8,930650,207850,254390.2,338450,216780,262697.6,592200
429730,553540,930650,212420,267646.9,338450,217310,285893.1,592200
453670,571738.8,930650,219230,278835.3,338450,234440,292903.5,592200
477670,595997,930650,226080,283406.7,338450,251590,312590.3,592200
501620,600788.2,930650,232900,272347.8,338450,268720,328440.4,592200
525570,633470.8,930650,239700,282035.8,338450,285870,351435,592200
549510,661113,930650,246770,293488.8,338450,302740,367624.2,592200
573370,691121.2,930650,253820,296972.4,338450,319550,394148.8,592200
597280,721296,930650,260880,309146.8,338450,336400,412149.2,592200
621180,741293,930650,267950,317605.3,338450,353230,423687.7,592200
644480,780332.4,930650,274770,323580,338450,369710,456752.4,592200
667810,806971.9,930650,281570,325537.9,338450,386240,481434,592200
691110,823589.4,930650,288400,326621.9,338450,402710,496967.5,592200
714430,839316.8,930650,295210,328069,338450,419220,511247.8,592200
722620,835752.2,930650,295460,328408.3,338450,427160,507343.9,592200
730860,843474.8,930650,295730,328939.3,338450,435130,514535.5,592200
739150,847753,930650,296010,330428.5,338450,443140,517324.5,592200
747380,868917.9,930650,296260,332091,338450,451120,536826.9,592200
755660,859188.6,930650,296560,332443.6,338450,459100,526745,592200
763880,866459.5,930650,296870,329914.7,338450,467010,536544.8,592200
772150,835984.6,930650,297170,296764.1,338450,474980,539220.5,592200
780400,758601.1,930650,297440,250391.2,338450,482960,508209.9,592200
788390,734875.5,930650,297610,236865.2,338450,490780,498010.3,592200
796330,740080.2,930650,297750,239267.7,338450,498580,500812.5,592200
804340,813121.2,930650,297900,294108.4,338450,506440,519012.8,592200
812360,866086.5,930650,298070,332307.6,338450,514290,533778.9,592200
813750,869775.8,930650,298470,333334.7,338450,515280,536441.1,592200
815180,840539.3,930650,298900,313556.7,338450,516280,526982.6,592200
816550,768016.6,930650,299320,259513.8,338450,517230,508502.8,592200
818010,752226.2,930650,299760,250220.5,338450,518250,502005.7,592200
819160,724882.1,930650,299980,231126.2,338450,519180,493755.9,592200
820370,728043.1,930650,300220,230693.2,338450,520150,497349.9,592200
821540,752990,930650,300460,249826.9,338450,521080,503163.1,592200
808110,767428.7,930650,286060,254437.7,338450,522050,512991,592200
809210,832470.2,930650,286760,300372.9,338450,522450,532097.3,592200
810220,864184.3,930650,287440,327710.5,338450,522780,536473.8,592200
811340,846215.5,930650,288150,320365.2,338450,523190,525850.3,592200
812370,850830.3,930650,288840,326605,338450,523530,524225.3,592200
814440,850460.6,930650,291410,329454.5,338450,523030,521006.1,592200
816500,855064.6,930650,293980,329439.3,338450,522520,525625.3,592200
818510,848307.3,930650,296540,328135.7,338450,521970,520171.6,592200
820560,843825.7,930650,299110,327580.3,338450,521450,516245.4,592200
821940,853229.4,930650,301360,330156.7,338450,520580,523072.7,592200
823320,845552.9,930650,303660,321855.5,338450,519660,523697.4,592200
824630,840649.4,930650,305900,316336.3,338450,518730,524313.1,592200
825940,837254.3,930650,308150,312828.5,338450,517790,524425.8,592200
827720,835403.4,930650,310950,316804.8,338450,516770,518598.6,592200
829520,842438.6,930650,313750,322622.6,338450,515770,519816,592200
831210,823726.4,930650,316490,322450.4,338450,514720,501276,592200
833070,808984.1,930650,319290,322654.2,338450,513780,486329.9,592200
826050,819102,930650,317140,318755.8,338450,508910,500346.2,592200
819010,802360.6,930650,314940,316572.6,338450,504070,485788,592200
812000,799882.3,930650,312770,313417.8,338450,499230,486464.5,592200
805000,803248.5,930650,310580,315257.2,338450,494420,487991.3,592200
797710,789753,930650,308310,310558.5,338450,489400,479194.5,592200
790380,794719.9,930650,306020,311159.8,338450,484360,483560.1,592200
783110,789693.8,930650,303730,314658.9,338450,479380,475034.9,592200
775720,809364.5,930650,301440,319898.8,338450,474280,489465.7,592200
767720,796965.5,930650,298980,315574.7,338450,468740,481390.8,592200
759690,785696.4,930650,296540,310912.5,338450,463150,474783.9,592200
751670,768965.7,930650,294060,311561,338450,457610,457404.7,592200
743590,756037.1,930650,291580,299077.2,338450,452010,456959.9,592200
740390,760175.4,930650,289050,302252.2,338450,451340,457923.2,592200
737210,777348.1,930650,286500,310825.9,338450,450710,466522.2,592200
734010,786931.8,930650,283980,311714.9,338450,450030,475216.9,592200
730840,769643.8,930650,281440,295705.1,338450,449400,473938.7,592200
727110,789291.7,930650,277270,312377.8,338450,449840,476913.9,592200
723370,802861.1,930650,273070,319559.4,338450,450300,483301.7,592200
719600,798999.8,930650,268880,318119.5,338450,450720,480880.3,592200
715870,794591,930650,264720,317423,338450,451150,477168,592200
715180,782194,930650,263330,313031.3,338450,451850,469162.7,592200
714420,774564.4,930650,261920,312512.3,338450,452500,462052.1,592200
713660,773986.4,930650,260540,313837.9,338450,453120,460148.5,592200
712910,768551.7,930650,259130,310064.2,338450,453780,458487.5,592200
720850,779556,930650,263850,317473.8,338450,457000,462082.2,592200
728820,805948.3,930650,268540,320572,338450,460280,485376.3,592200
736770,798851.4,930650,273240,318548.5,338450,463530,480302.9,592200
744740,790450.9,930650,277940,316091.5,338450,466800,474359.4,592200
752400,778822.6,930650,282280,312724.5,338450,470120,466098.1,592200
759980,787468.8,930650,286610,315806.2,338450,473370,471662.6,592200
767670,781657.8,930650,290920,314614.3,338450,476750,467043.5,592200
775220,774389.4,930650,295270,314132.9,338450,479950,460256.5,592200
781280,800206.5,930650,298210,319351.1,338450,483070,480855.4,592200
787320,798466.1,930650,301140,317940.9,338450,486180,480525.2,592200
793350,800545.4,930650,304100,319365.8,338450,489250,481179.6,592200
799440,804007,930650,307060,320248,338450,492380,483759,592200
800950,797287.2,930650,307740,320064.6,338450,493210,477222.6,592200
802550,801441.5,930650,308460,318477.1,338450,494090,482964.4,592200
804120,796392.1,930650,309160,316656.7,338450,494960,479735.4,592200
805660,804229.6,930650,309860,314737.6,338450,495800,489492,592200
806860,814266.3,930650,310480,320658.1,338450,496380,493608.2,592200
808050,832952.1,930650,311090,323115.1,338450,496960,509837,592200
809210,809544.2,930650,311680,321140,338450,497530,488404.2,592200
810380,828526.3,930650,312310,321649.7,338450,498070,506876.6,592200
811410,840741.5,930650,312900,322909.5,338450,498510,517832,592200
812490,843577.3,930650,313510,324388.1,338450,498980,519189.2,592200
813540,848994,930650,314130,322495.9,338450,499410,526498.1,592200
814560,847009.9,930650,314720,321070.1,338450,499840,525939.8,592200
814830,847660.7,930650,314830,323492.9,338450,500000,524167.8,592200
815150,843951.8,930650,314950,324179.6,338450,500200,519772.2,592200
815440,827310.8,930650,315040,316299.2,338450,500400,511011.6,592200
815730,823164.6,930650,315180,316027.9,338450,500550,507136.7,592200
815840,822656.6,930650,315260,318693,338450,500580,503963.6,592200
815960,825886.3,930650,315350,317838.3,338450,500610,508048,592200
816090,834442.2,930650,315430,319431.4,338450,500660,515010.8,592200
816240,836508.7,930650,315510,321541.9,338450,500730,514966.8,592200
816380,834367.2,930650,315590,323100.6,338450,500790,511266.6,592200
816630,831937.5,930650,315690,322302.6,338450,500940,509634.9,592200
816930,820613.5,930650,315790,321954.7,338450,501140,498658.8,592200
817110,820611.5,930650,315890,325249.6,338450,501220,495361.9,592200
816650,842442.4,930650,315380,328645,338450,501270,513797.4,592200
816270,845873.7,930650,314890,323990.1,338450,501380,521883.6,592200
815860,849821.2,930650,314350,324731.6,338450,501510,525089.6,592200
815440,844352.7,930650,313860,322572.2,338450,501580,521780.5,592200
815630,844795.9,930650,313560,323451.4,338450,502070,521344.5,592200
815850,837831.3,930650,313280,321072.5,338450,502570,516758.8,592200
815940,828070.6,930650,312990,321017,338450,502950,507053.6,592200
816150,821654.4,930650,312690,317050.8,338450,503460,504603.6,592200
816400,830087.7,930650,312270,321992.7,338450,504130,508095,592200
816510,834068.4,930650,311840,320090.7,338450,504670,513977.7,592200
816700,836576.8,930650,311420,320490.6,338450,505280,516086.2,592200
816860,848998.3,930650,310980,325338,338450,505880,523660.3,592200
817360,857180.6,930650,311320,327825.9,338450,506040,529354.7,592200
817820,826300.3,930650,311620,312998.1,338450,506200,513302.2,592200
818310,846158.1,930650,311930,321502.7,338450,506380,524655.4,592200
818810,810668.1,930650,312260,296607.8,338450,506550,514060.3,592200
819350,797637.9,930650,312570,289482.1,338450,506780,508155.8,592200
819850,812252.2,930650,312850,297518.1,338450,507000,514734.1,592200
820440,813395.5,930650,313160,295839.7,338450,507280,517555.8,592200
816130,784624.3,930650,305630,286211.5,338450,510500,498412.8,592200
816610,789418.9,930650,304910,284511.5,338450,511700,504907.4,592200
817150,786590.5,930650,304230,284102.4,338450,512920,502488.1,592200
817720,798337.2,930650,303530,289125.9,338450,514190,509211.3,592200
818300,806050.2,930650,302830,294092.4,338450,515470,511957.8,592200
818150,809799.5,930650,302160,290235.9,338450,515990,519563.6,592200
818020,816108.3,930650,301460,295982.1,338450,516560,520126.2,592200
817870,810492.2,930650,300760,300309.7,338450,517110,510182.5,592200
817780,809672.4,930650,300080,302581.1,338450,517700,507091.3,592200
817550,840728.9,930650,299390,321602.8,338450,518160,519126.1,592200
817290,844550.7,930650,298690,319249,338450,518600,525301.7,592200
816990,859293.6,930650,298000,320041.8,338450,518990,539251.8,592200
816670,829925.8,930650,297310,313024.6,338450,519360,516901.2,592200
816260,807179.5,930650,296530,295430.9,338450,519730,511748.6,592200
815900,777878,930650,295760,272289.4,338450,520140,505588.6,592200
815530,733318.4,930650,295000,229486.5,338450,520530,503831.9,592200
815160,634712,930650,294250,161321.3,338450,520910,473390.7,592200
812870,628492.5,930650,291570,159082.5,338450,521300,469410,592200
810700,623989.9,930650,288920,157041.5,338450,521780,466948.4,592200
808410,640613.6,930650,286260,157681.5,338450,522150,482932.1,592200
806210,626432.4,930650,283590,157116.1,338450,522620,469316.3,592200
803800,645890.4,930650,280880,159747.3,338450,522920,486143.1,592200
801320,629008.6,930650,278150,158603.1,338450,523170,470405.5,592200
798880,633372.2,930650,275430,158723.1,338450,523450,474649.1,592200
796460,642125.4,930650,272700,159737.2,338450,523760,482388.2,592200
793950,643140.1,930650,270000,160232.2,338450,523950,482907.9,592200
791450,646728.9,930650,267320,160582.9,338450,524130,486146,592200
789000,639696.7,930650,264610,160312,338450,524390,479384.7,592200
786440,661732.2,930650,261930,163166,338450,524510,498566.2,592200
790680,790441.8,930650,266430,260858,338450,524250,529583.8,592200
794870,758180.5,930650,270920,230677.9,338450,523950,527502.6,592200
799020,747228,930650,275380,222599.3,338450,523640,524628.7,592200
803200,686315.4,930650,279860,199475.1,338450,523340,486840.3,592200
803200,657012.4,930650,280160,190163,338450,523040,466849.4,592200
803160,638135.7,930650,280440,176347.4,338450,522720,461788.3,592200
803130,635509.5,930650,280720,171117.4,338450,522410,464392.1,592200
803100,631289.6,930650,281020,182036.5,338450,522080,449253.1,592200
804790,666511.1,930650,283170,226256.8,338450,521620,440254.3,592200
806610,687998,930650,285340,247755.9,338450,521270,440242.1,592200
808370,736300.1,930650,287510,289764.2,338450,520860,446535.9,592200
810110,762279.3,930650,289650,290162.6,338450,520460,472116.7,592200
806240,749563.1,930650,289090,293041.6,338450,517150,456521.5,592200
802340,755051.5,930650,288540,305318.2,338450,513800,449733.3,592200
798500,776896.3,930650,287970,321497.2,338450,510530,455399.1,592200
794580,771489,930650,287400,310600.7,338450,507180,460888.3,592200
791100,753534.5,930650,288260,299602.8,338450,502840,453931.7,592200
787680,735771.6,930650,289140,297322.4,338450,498540,438449.2,592200
784150,777520.8,930650,289990,313997.1,338450,494160,463523.7,592200
780670,789769.9,930650,290840,321555.8,338450,489830,468214.1,592200
780320,787642.3,930650,292590,321943.6,338450,487730,465698.7,592200
779990,798800,930650,294340,321834.5,338450,485650,476965.5,592200
779620,806969.8,930650,296080,319531.1,338450,483540,487438.7,592200
779270,777486.1,930650,297830,314415.9,338450,481440,463070.2,592200
783570,776139,930650,300000,308975.5,338450,483570,467163.5,592200
787960,794726.8,930650,302210,312313.2,338450,485750,482413.6,592200
792300,780192.1,930650,304390,302893.6,338450,487910,477298.5,592200
796590,773430,930650,306600,309687.5,338450,489990,463742.5,592200
799600,781322.9,930650,307840,320118.5,338450,491760,461204.4,592200
802610,796935.2,930650,309090,324361,338450,493520,472574.2,592200
805550,810891.4,930650,310320,324674.2,338450,495230,486217.2,592200
808610,810041.9,930650,311600,326298.2,338450,497010,483743.7,592200
811250,776295.5,930650,312550,322436.7,338450,498700,453858.8,592200
813920,783550.6,930650,313550,322499.1,338450,500370,461051.5,592200
816610,817267.9,930650,314520,328331,338450,502090,488936.9,592200
819310,825340.3,930650,315520,322165.5,338450,503790,503174.8,592200
818920,813728.8,930650,315110,321569.2,338450,503810,492159.6,592200
818470,796577,930650,314710,310705.9,338450,503760,485871.1,592200
818130,791720.3,930650,314330,309775.7,338450,503800,481944.6,592200
817730,826138,930650,313930,319630.4,338450,503800,506507.6,592200
816940,822802.2,930650,313470,329775.3,338450,503470,493026.9,592200
816130,835746,930650,313010,330289.8,338450,503120,505456.2,592200
815250,839674.9,930650,312550,331029.8,338450,502700,508645.1,592200
814440,848566.1,930650,312110,331049.6,338450,502330,517516.5,592200
813860,850282.7,930650,311750,331337.9,338450,502110,518944.8,592200
813260,861435.1,930650,311370,331629.4,338450,501890,529805.7,592200
812690,859608.8,930650,311010,331804.1,338450,501680,527804.7,592200
812140,848013.7,930650,310680,331859.8,338450,501460,516153.9,592200
812760,851971.1,930650,311040,331719.9,338450,501720,520251.2,592200
813360,852369.9,930650,311400,332328.4,338450,501960,520041.5,592200
814050,865987.3,930650,311780,332469.9,338450,502270,533517.4,592200
814590,855930.2,930650,312140,329534.9,338450,502450,526395.3,592200
815030,851188.7,930650,312450,331301.1,338450,502580,519887.6,592200
815370,849512.4,930650,312720,332218.5,338450,502650,517293.9,592200
815760,846043,930650,313010,331102.2,338450,502750,514940.8,592200
816100,847089.5,930650,313320,331727.6,338450,502780,515361.9,592200
816540,870243.7,930650,313650,332509,338450,502890,537734.7,592200
817000,861450.9,930650,313980,333707.4,338450,503020,527743.5,592200
817380,861965.8,930650,314300,333671.9,338450,503080,528293.9,592200
817800,846130.8,930650,314630,329804.9,338450,503170,516325.9,592200
809080,861062.9,930650,311850,326234.4,338450,497230,534828.5,592200
800300,854434.3,930650,309030,324558.1,338450,491270,529876.2,592200
791530,842940.5,930650,306260,320528.8,338450,485270,522411.7,592200
782800,836263.5,930650,303440,317813.1,338450,479360,518450.4,592200
773970,817232.4,930650,300880,310331,338450,473090,506901.4,592200
765170,783589.6,930650,298290,291780.2,338450,466880,491809.4,592200
756330,785021.8,930650,295710,291299,338450,460620,493722.8,592200
778870,788221.6,930650,302590,296181.7,338450,476280,492039.9,592200
770990,776066.5,930650,300000,296784.4,338450,470990,479282.1,592200
763150,770500.6,930650,297420,301973.4,338450,465730,468527.2,592200
755280,775060.9,930650,294820,295014.3,338450,460460,480046.6,592200
747440,752837.6,930650,292210,286528.4,338450,455230,466309.2,592200
733310,730801.7,930650,288880,281710.4,338450,444430,449091.3,592200
719180,733288.4,930650,285510,284034.1,338450,433670,449254.3,592200
705050,749635.4,930650,282150,292817.6,338450,422900,456817.8,592200
690900,747257.5,930650,278770,295893.5,338450,412130,451364,592200
675970,744212.3,930650,274880,300202.9,338450,401090,444009.4,592200
661100,739317.2,930650,270980,299596.7,338450,390120,439720.5,592200
646190,733281.3,930650,267090,301181,338450,379100,432100.3,592200
631210,725072.4,930650,263190,294758.3,338450,368020,430314.1,592200
617780,709821.3,930650,259580,297409.8,338450,358200,412411.5,592200
604420,699684.9,930650,255980,289811.6,338450,348440,409873.3,592200
591010,655392.6,930650,252360,272699.3,338450,338650,382693.3,592200
577600,636013.9,930650,248760,266205,338450,328840,369808.9,592200
585640,629679,930650,250780,251816.8,338450,334860,377862.2,592200
593720,659021,930650,252780,269136.2,338450,340940,389884.8,592200
601750,631564.9,930650,254820,262771.7,338450,346930,368793.2,592200
609780,617793,930650,256820,260664.5,338450,352960,357128.5,592200
619200,609317.2,930650,260170,266355.7,338450,359030,342961.5,592200
628690,624340.2,930650,263520,279770.2,338450,365170,344570,592200
638210,662257.7,930650,266890,303638.9,338450,371320,358618.8,592200
647660,676487,930650,270250,303558.1,338450,377410,372928.9,592200
656910,669054.7,930650,273010,287167,338450,383900,381887.7,592200
666150,697226.5,930650,275800,292676.9,338450,390350,404549.6,592200
675450,696603.9,930650,278550,290258.4,338450,396900,406345.5,592200
684670,715708.5,930650,281300,291047.7,338450,403370,424660.8,592200
697200,718995.8,930650,284530,290293.2,338450,412670,428702.6,592200
709660,739555.2,930650,287750,299093.6,338450,421910,440461.6,592200
722150,772075.6,930650,290960,302581.1,338450,431190,469494.5,592200
734640,792018.3,930650,294160,308130.2,338450,440480,483888.1,592200
746550,801062.6,930650,297440,311654.1,338450,449110,489408.5,592200
758410,810422.2,930650,300700,312386.7,338450,457710,498035.5,592200
770350,826325.8,930650,303990,316991.9,338450,466360,509333.9,592200
782270,838097.2,930650,307290,322161.6,338450,474980,515935.6,592200
793840,842908.5,930650,310250,324137.4,338450,483590,518771.1,592200
805460,845368.3,930650,313260,324036.7,338450,492200,521331.6,592200
817030,830101.7,930650,316270,321865.1,338450,500760,508236.6,592200
828650,839991.8,930650,319260,323647.6,338450,509390,516344.2,592200
829990,830424.2,930650,319400,316933.3,338450,510590,513490.9,592200
831300,840030.4,930650,319540,317623.9,338450,511760,522406.5,592200
832620,834129.7,930650,319670,322947.4,338450,512950,511182.3,592200
833920,824945.7,930650,319820,322407.8,338450,514100,502537.9,592200
834800,832674.4,930650,319950,323879.2,338450,514850,508795.2,592200
835570,826765.6,930650,320060,316993.6,338450,515510,509772,592200
836420,822051.9,930650,320200,317661.1,338450,516220,504390.8,592200
837250,819358.8,930650,320330,311668,338450,516920,507690.8,592200
838080,831378.3,930650,320520,317570,338450,517560,513808.3,592200
838990,837708.6,930650,320770,320594.3,338450,518220,517114.3,592200
839950,794777.5,930650,321020,313333.4,338450,518930,481444.1,592200
840800,848361.4,930650,321220,320357.7,338450,519580,528003.7,592200
840850,838017.3,930650,321250,320343.5,338450,519600,517673.8,592200
840920,846882.8,930650,321300,324973.1,338450,519620,521909.7,592200
840980,834337.9,930650,321330,317243.8,338450,519650,517094.1,592200
841040,810913.3,930650,321340,312647.3,338450,519700,498266,592200
841010,803890.2,930650,321310,312374.6,338450,519700,491515.6,592200
840930,821079.1,930650,321260,313931.5,338450,519670,507147.6,592200
840850,844971,930650,321230,314012.4,338450,519620,530958.6,592200
840830,835108,930650,321190,315688.6,338450,519640,519419.4,592200
840880,852130.4,930650,321170,323011.9,338450,519710,529118.5,592200
840960,851743,930650,321160,327480.5,338450,519800,524262.5,592200
841050,837961.8,930650,321150,325048.6,338450,519900,512913.2,592200
841090,839766.8,930650,321130,325791.9,338450,519960,513974.9,592200
838280,844816.2,930650,320440,326165.5,338450,517840,518650.7,592200
835460,856504,930650,319780,327211.3,338450,515680,529292.7,592200
832610,838068.2,930650,319100,325883,338450,513510,512185.2,592200
829730,842381.8,930650,318430,328524.6,338450,511300,513857.2,592200
826240,845109.1,930650,317470,330891,338450,508770,514218.1,592200
822810,853444.6,930650,316530,330785.8,338450,506280,522658.8,592200
819300,857466.5,930650,315600,331420.4,338450,503700,526046.1,592200
815820,859849.9,930650,314630,332136.4,338450,501190,527713.5,592200
812300,866931.1,930650,313810,329840.1,338450,498490,537091,592200
808780,853538.1,930650,312940,326501.6,338450,495840,527036.5,592200
805320,850593.5,930650,312120,326172.2,338450,493200,524421.3,592200
801820,829127.1,930650,311260,320492.9,338450,490560,508634.2,592200
798550,836458.9,930650,310260,321960,338450,488290,514498.9,592200
795260,826378.6,930650,309250,320632.4,338450,486010,505746.2,592200
792030,835159.2,930650,308260,317582.4,338450,483770,517576.8,592200
788740,828452.5,930650,307270,312547.5,338450,481470,515905,592200
785260,825272.2,930650,305920,314976.9,338450,479340,510295.3,592200
781740,819462.5,930650,304600,308528.3,338450,477140,510934.2,592200
778150,786691.6,930650,303270,288943.9,338450,474880,497747.7,592200
774640,769578.1,930650,301920,285247.9,338450,472720,484330.2,592200
771640,763037.2,930650,301160,289275.1,338450,470480,473762.1,592200
768630,760958.7,930650,300420,290865.3,338450,468210,470093.4,592200
765600,760678.7,930650,299680,288619.3,338450,465920,472059.4,592200
762580,768313.4,930650,298930,294657.6,338450,463650,473655.8,592200
758440,773105,930650,297610,302980.6,338450,460830,470124.4,592200
754330,762485.7,930650,296300,301039.6,338450,458030,461446.1,592200
750270,738612.6,930650,294970,282805.9,338450,455300,455806.7,592200
746190,718225.9,930650,293670,276480.8,338450,452520,441745.1,592200
742020,721073.9,930650,292140,284365,338450,449880,436708.9,592200
737870,727228,930650,290620,292108.5,338450,447250,435119.5,592200
733830,709865.7,930650,289110,282935.6,338450,444720,426930.1,592200
676530,688167.8,930650,276740,275497.5,338450,399790,412670.3,592200
671910,667573.4,930650,275390,274456.1,338450,396520,393117.3,592200
667240,659698.2,930650,274020,282242.3,338450,393220,377455.9,592200
662570,672331,930650,272670,288370,338450,389900,383961,592200
658000,682964.9,930650,271320,294862.2,338450,386680,388102.7,592200
649730,670183,930650,268320,295933.8,338450,381410,374249.2,592200
641470,644371.8,930650,265300,281777.5,338450,376170,362594.3,592200
633210,629542.1,930650,262290,265408.9,338450,370920,364133.2,592200
625000,639681.3,930650,259270,267980.1,338450,365730,371701.2,592200
616500,623759.6,930650,255580,257420.8,338450,360920,366338.8,592200
607990,617319.1,930650,251860,257620.4,338450,356130,359698.7,592200
599440,621471.7,930650,248150,269792.1,338450,351290,351679.6,592200
590940,608074.3,930650,244440,265132.3,338450,346500,342942,592200
583590,589288.2,930650,241930,259066.1,338450,341660,330222.1,592200
576300,600258.4,930650,239450,267546.6,338450,336850,332711.8,592200
568910,601129.4,930650,236940,263672.5,338450,331970,337456.9,592200
561610,612571.8,930650,234420,267105.1,338450,327190,345466.7,592200
549600,576357.3,930650,230560,238232.6,338450,319040,338124.7,592200
537530,549754.2,930650,226690,214342.3,338450,310840,335411.9,592200
525530,598175,930650,222780,237732.9,338450,302750,360442.1,592200
513460,595564.3,930650,218920,236301.8,338450,294540,359262.5,592200
501800,604218.3,930650,215260,242402.7,338450,286540,361815.6,592200
490000,614183,930650,211580,263628,338450,278420,350555,592200
478250,558387.5,930650,207900,253268.6,338450,270350,305118.9,592200
466510,481394.6,930650,204260,219734.9,338450,262250,261659.7,592200
454170,475310.4,930650,200730,214238.7,338450,253440,261071.7,592200
441780,455758.6,930650,197210,209547,338450,244570,246211.6,592200
429480,433925.2,930650,193710,195527.1,338450,235770,238398.1,592200
417130,364038.2,930650,190180,154053.1,338450,226950,209985.1,592200
408450,320981.9,930650,186500,125405,338450,221950,195576.9,592200
399720,267476.1,930650,182810,110499.9,338450,216910,156976.2,592200
391000,282914.7,930650,179130,139421.2,338450,211870,143493.5,592200
382290,263689.8,930650,175450,128587.6,338450,206840,135102.2,592200
372140,253434.3,930650,169840,109300.5,338450,202300,144133.8,592200
361910,289804.7,930650,164240,129407.9,338450,197670,160396.8,592200
351770,318085.9,930650,158640,140683.8,338450,193130,177402.1,592200
341630,298018.7,930650,153050,115077.3,338450,188580,182941.4,592200
331350,268762.1,930650,147690,106691.1,338450,183660,162071,592200
321100,245596.7,930650,142320,89487.1,338450,178780,156109.6,592200
310810,216598.1,930650,136950,67409.7,338450,173860,149188.4,592200
300590,206683.1,930650,131620,62604.1,338450,168970,144079,592200
299520,214777.5,930650,129390,65902.2,338450,170130,148875.3,592200
298530,194095.3,930650,127180,56038.6,338450,171350,138056.7,592200
297500,186502,930650,124970,46215.5,338450,172530,140286.5,592200
296470,186341.7,930650,122750,38673.6,338450,173720,147668.1,592200
296490,200207.7,930650,121860,38263.3,338450,174630,161944.4,592200
296540,222902,930650,120970,46963.2,338450,175570,175938.8,592200
296550,246967.9,930650,120090,55334,338450,176460,191633.9,592200
296610,254911.2,930650,119180,59115.9,338450,177430,195795.3,592200
299230,261184.3,930650,120040,59355.6,338450,179190,201828.7,592200
301890,269368.1,930650,120880,61908,338450,181010,207460.1,592200
304490,294898.8,930650,121670,71952.5,338450,182820,222946.3,592200
307150,280058.1,930650,122510,62961.8,338450,184640,217096.3,592200
308810,290526.5,930650,124130,58021.5,338450,184680,232505,592200
310540,287738.7,930650,125740,60161.6,338450,184800,227577.1,592200
312250,318566.6,930650,127350,93712.3,338450,184900,224854.3,592200
313940,329710,930650,128940,110275.7,338450,185000,219434.3,592200
314590,340645.2,930650,129410,117698.6,338450,185180,222946.6,592200
315190,334456.2,930650,129870,112505.1,338450,185320,221951.1,592200
315820,326035.6,930650,130350,106699.4,338450,185470,219336.2,592200
316450,331589,930650,130840,110217.7,338450,185610,221371.3,592200
314110,312769,930650,130400,97129.2,338450,183710,215639.8,592200
311690,290621.9,930650,129990,83978.2,338450,181700,206643.7,592200
309390,291665.8,930650,129580,85512.5,338450,179810,206153.3,592200
306980,283055.5,930650,129170,84922.5,338450,177810,198133,592200
303760,254021.6,930650,129190,71303.4,338450,174570,182718.2,592200
300480,228819.7,930650,129200,61650.6,338450,171280,167169.1,592200
297260,232116.3,930650,129220,70664.9,338450,168040,161451.4,592200
293960,272569.6,930650,129250,103951.6,338450,164710,168618,592200
290920,287746.5,930650,130350,111995.4,338450,160570,175751.1,592200
287840,304740.4,930650,131470,114481.6,338450,156370,190258.8,592200
284830,320781.2,930650,132570,115316.6,338450,152260,205464.6,592200
281740,324180.3,930650,133680,114756,338450,148060,209424.3,592200
278220,311247.9,930650,134010,120830.1,338450,144210,190417.8,592200
274660,363523.9,930650,134350,146504.9,338450,140310,217019,592200
271090,400476.1,930650,134660,153863.1,338450,136430,246613,592200
267530,409206.3,930650,134980,168099.6,338450,132550,241106.7,592200
265520,406665.4,930650,134560,175036.7,338450,130960,231628.7,592200
263630,390412.6,930650,134160,158256.6,338450,129470,232156,592200
261690,399150.4,930650,133720,160198,338450,127970,238952.4,592200
259770,396149.2,930650,133320,153410,338450,126450,242739.2,592200
260540,388795.4,930650,134900,144353.9,338450,125640,244441.5,592200
261290,400703.4,930650,136480,144059.5,338450,124810,256643.9,592200
262020,399680.5,930650,138040,146731.3,338450,123980,252949.2,592200
262810,385053.6,930650,139630,138472.3,338450,123180,246581.3,592200
263650,358482.4,930650,140930,124668.6,338450,122720,233813.8,592200
264560,296607.4,930650,142250,92747,338450,122310,203860.4,592200
265360,272316.8,930650,143560,87411.7,338450,121800,184905.1,592200
266340,273586.8,930650,144890,79773.9,338450,121450,193812.9,592200
268640,252752,930650,146380,70595.8,338450,122260,182156.2,592200
271050,234640.1,930650,147850,68297.9,338450,123200,166342.2,592200
273470,268098.4,930650,149350,76184.1,338450,124120,191914.3,592200
275830,266462.2,930650,150820,80736.1,338450,125010,185726.1,592200
279080,253432.9,930650,152750,66792.9,338450,126330,186640,592200
282280,230344.5,930650,154670,63633.5,338450,127610,166711,592200
285530,218224.9,930650,156610,67597.2,338450,128920,150627.7,592200
186860,213826.3,930650,82030,67970.9,338450,104830,145855.4,592200
186840,222522.4,930650,83770,75663.5,338450,103070,146858.9,592200
186790,223078.1,930650,85490,77610.8,338450,101300,145467.3,592200
186800,255270.4,930650,87250,98795.6,338450,99550,156474.8,592200
186780,312154.4,930650,89010,131155,338450,97770,180999.4,592200
192320,351669.3,930650,92730,156090.3,338450,99590,195579,592200
197930,331013.5,930650,96490,157493.6,338450,101440,173519.9,592200
203440,338888.3,930650,100220,167247.3,338450,103220,171641,592200
209060,358929.6,930650,103990,183207.8,338450,105070,175721.8,592200
214850,365992.2,930650,107860,187726.5,338450,106990,178265.7,592200
220690,412691.2,930650,111740,211170.7,338450,108950,201520.5,592200
226530,403689.6,930650,115600,210193.5,338450,110930,193496.1,592200
232320,419100.9,930650,119470,217829.8,338450,112850,201271.1,592200
238560,439540.9,930650,123650,238044.6,338450,114910,201496.3,592200
244760,429670.1,930650,127800,232736.6,338450,116960,196933.5,592200
251050,442292.4,930650,131980,237975,338450,119070,204317.4,592200
257240,451727.2,930650,136130,238439.9,338450,121110,213287.3,592200
269480,441814.6,930650,143520,234827.2,338450,125960,206987.4,592200
281730,443873.3,930650,150940,235012.4,338450,130790,208860.9,592200
293890,454627.3,930650,158310,238122.7,338450,135580,216504.6,592200
306190,464119.5,930650,165750,234262.5,338450,140440,229857,592200
319460,474900.8,930650,173700,240002.5,338450,145760,234898.3,592200
332710,478621.3,930650,181680,245044.6,338450,151030,233576.7,592200
346020,506352.5,930650,189670,252259.1,338450,156350,254093.4,592200
359340,498477.3,930650,197640,251564.4,338450,161700,246912.9,592200
372280,494283.3,930650,204240,252728.9,338450,168040,241554.4,592200
385100,499948.8,930650,210830,255378.5,338450,174270,244570.3,592200
397990,490668.1,930650,217420,252122.1,338450,180570,238546,592200
410850,518035.7,930650,224010,260585.6,338450,186840,257450.1,592200
427480,525354.6,930650,226480,254188.4,338450,201000,271166.2,592200
444070,527331.3,930650,228940,244581.9,338450,215130,282749.4,592200
460700,553549.7,930650,231400,261880.4,338450,229300,291669.3,592200
477270,566437.1,930650,233850,265730.1,338450,243420,300707,592200
493300,566906,930650,236360,270612.7,338450,256940,296293.3,592200
509290,598100.5,930650,238850,280315.1,338450,270440,317785.4,592200
525260,620531.1,930650,241340,292381.9,338450,283920,328149.2,592200
541210,636134.9,930650,243860,296686.7,338450,297350,339448.2,592200
557660,692344.5,930650,246470,308570.4,338450,311190,383774.1,592200
574010,676037.8,930650,249090,293529.4,338450,324920,382508.4,592200
590420,646823.4,930650,251710,252251.1,338450,338710,394572.3,592200
606810,690465.3,930650,254330,291697.6,338450,352480,398767.7,592200
607160,733915.2,930650,252800,298428.1,338450,354360,435487.1,592200
607400,702095.6,930650,251260,289810.8,338450,356140,412284.8,592200
607690,702968.8,930650,249740,279087.5,338450,357950,423881.3,592200
607950,737793.4,930650,248180,297179.8,338450,359770,440613.6,592200
610710,706591.7,930650,247500,259627,338450,363210,446964.7,592200
613400,607842.4,930650,246770,195362.1,338450,366630,412480.3,592200
616160,666852.7,930650,246050,237085.7,338450,370110,429767,592200
618880,720219.5,930650,245380,276171.4,338450,373500,444048.1,592200
620470,720892.7,930650,244340,278128.9,338450,376130,442763.8,592200
622050,726906.2,930650,243320,282689.2,338450,378730,444217,592200
623680,671946.2,930650,242310,244227.5,338450,381370,427718.7,592200
625210,666763,930650,241270,246825.5,338450,383940,419937.5,592200
624300,682539.1,930650,239700,268700.5,338450,384600,413838.6,592200
623380,678172.7,930650,238140,273437.3,338450,385240,404735.4,592200
622390,700581.2,930650,236580,287790.6,338450,385810,412790.6,592200
621470,743133.2,930650,234990,313337.6,338450,386480,429795.6,592200
621470,713602.1,930650,234950,293804.8,338450,386520,419797.3,592200
621460,700936.8,930650,234910,285834.6,338450,386550,415102.2,592200
621410,640905.8,930650,234860,244816.6,338450,386550,396089.2,592200
621310,638443,930650,234810,238939.5,338450,386500,399503.5,592200
622030,575044.8,930650,235790,209593.4,338450,386240,365451.4,592200
622720,620383,930650,236800,235286.8,338450,385920,385096.2,592200
623390,639717.5,930650,237800,280040.2,338450,385590,359677.3,592200
624020,595984.8,930650,238790,246939.2,338450,385230,349045.6,592200
616180,598416.5,930650,237580,251703.7,338450,378600,346712.8,592200
608400,585691.1,930650,236400,247643.6,338450,372000,338047.5,592200
600610,590263,930650,235220,254422.6,338450,365390,335840.4,592200
592840,564200.7,930650,234010,247829.6,338450,358830,316371.1,592200
585210,496416.2,930650,232860,208430.1,338450,352350,287986.1,592200
577520,541579.7,930650,231700,239287.1,338450,345820,302292.6,592200
569890,557187.3,930650,230540,230538.5,338450,339350,326648.8,592200
562200,579952.7,930650,229370,255442.1,338450,332830,324510.6,592200
554940,569890.8,930650,228400,257438.1,338450,326540,312452.7,592200
547600,578196.1,930650,227370,255643.3,338450,320230,322552.8,592200
540270,555733.8,930650,226370,242416.9,338450,313900,313316.9,592200
532970,554786,930650,225360,238950,338450,307610,315836,592200
522760,566366.8,930650,221930,243932.5,338450,300830,322434.3,592200
512530,525124.3,930650,218480,237739.7,338450,294050,287384.6,592200
502280,518358.9,930650,215020,238056.9,338450,287260,280302,592200
492070,515500.2,930650,211580,238112.3,338450,280490,277387.9,592200
480600,541954.5,930650,207840,243690.4,338450,272760,298264.1,592200
469110,532569.4,930650,204090,229811.2,338450,265020,302758.2,592200
457610,501203.7,930650,200370,221198.1,338450,257240,280005.6,592200
446130,507809.6,930650,196650,228264.8,338450,249480,279544.8,592200
434460,497014.8,930650,192230,224607.6,338450,242230,272407.2,592200
422760,460989.3,930650,187810,201811.2,338450,234950,259178.1,592200
411100,499059.5,930650,183390,231682.9,338450,227710,267376.6,592200
399440,485458.1,930650,178990,224975.7,338450,220450,260482.4,592200
394160,475897.9,930650,177580,221604.5,338450,216580,254293.4,592200
388840,477719.1,930650,176180,225223.8,338450,212660,252495.3,592200
383660,468765.9,930650,174800,219431.6,338450,208860,249334.3,592200
378350,498640.7,930650,173400,241849.5,338450,204950,256791.2,592200
371100,515933.1,930650,170250,253832.4,338450,200850,262100.7,592200
363830,519120.4,930650,167110,254620,338450,196720,264500.4,592200
356540,508954,930650,163970,241811.7,338450,192570,267142.3,592200
410620,503100.1,930650,178210,238642.1,338450,232410,264458,592200
403960,467029.4,930650,174500,213428.1,338450,229460,253601.3,592200
397230,458665.4,930650,170800,215575.5,338450,226430,243089.9,592200
390430,477577.1,930650,167080,223728.5,338450,223350,253848.6,592200
383780,466640.5,930650,163360,215179.6,338450,220420,251460.9,592200
378130,463178.6,930650,162120,219238,338450,216010,243940.6,592200
372540,471407.4,930650,160910,228895.8,338450,211630,242511.6,592200
366940,443168,930650,159690,222900.9,338450,207250,220267.1,592200
361350,434997.9,930650,158480,218341.3,338450,202870,216656.6,592200
353990,429653.2,930650,155220,216939.7,338450,198770,212713.5,592200
346500,420516,930650,151960,204537.6,338450,194540,215978.4,592200
339080,443157.3,930650,148720,203910,338450,190360,239247.3,592200
331680,396364.3,930650,145450,186282.4,338450,186230,210081.9,592200
325420,352738.3,930650,143560,162281.8,338450,181860,190456.5,592200
319110,315390.7,930650,141650,142525.7,338450,177460,172865,592200
312820,302856.6,930650,139750,138521.3,338450,173070,164335.3,592200
306460,259089.9,930650,137830,116648.5,338450,168630,142441.4,592200
302780,227315.4,930650,136770,91695.1,338450,166010,135620.3,592200
299090,204556.5,930650,135720,83849.9,338450,163370,120706.6,592200
295390,187658.4,930650,134650,78312.5,338450,160740,109345.9,592200
291730,189860.7,930650,133580,81878.9,338450,158150,107981.8,592200
287140,166053.9,930650,132130,63034.4,338450,155010,103019.5,592200
282520,158568.2,930650,130680,60542.9,338450,151840,98025.3,592200
277990,201153.8,930650,129240,79887.6,338450,148750,121266.2,592200
273480,218129,930650,127820,93406.2,338450,145660,124722.8,592200
268290,229617.5,930650,126820,103703.8,338450,141470,125913.7,592200
263130,209793.6,930650,125840,86324.1,338450,137290,123469.5,592200
257890,214066.9,930650,124820,85312.7,338450,133070,128754.2,592200
252690,236617.1,930650,123830,99038.1,338450,128860,137579,592200
258810,265912.4,930650,127430,125693,338450,131380,140219.4,592200
264900,273263,930650,131040,147559.5,338450,133860,125703.5,592200
271030,301247.2,930650,134670,166344.3,338450,136360,134902.9,592200
277070,338298.5,930650,138250,184361.4,338450,138820,153937.1,592200
284420,357281.8,930650,142840,194062.9,338450,141580,163218.9,592200
291830,363450.9,930650,147420,205210.2,338450,144410,158240.7,592200
299200,357613,930650,152010,208812.4,338450,147190,148800.6,592200
306560,367834.3,930650,156580,212813.4,338450,149980,155020.9,592200
314060,377582.5,930650,160840,211621.3,338450,153220,165961.2,592200
321550,396259.8,930650,165090,216327.3,338450,156460,179932.5,592200
329140,411954.5,930650,169380,225878,338450,159760,186076.5,592200
336580,420685.2,930650,173610,229028.5,338450,162970,191656.7,592200
353950,437728.4,930650,180140,230146.9,338450,173810,207581.5,592200
371220,453598.4,930650,186620,230763.3,338450,184600,222835.1,592200
388550,472828.6,930650,193130,234109.3,338450,195420,238719.3,592200
405820,481143.5,930650,199630,238019.3,338450,206190,243124.2,592200
424240,499909.6,930650,206340,242260.1,338450,217900,257649.5,592200
442610,521907.2,930650,213010,246815,338450,229600,275092.2,592200
460920,583017.2,930650,219720,260394.9,338450,241200,322622.3,592200
479280,609847.6,930650,226400,270123.4,338450,252880,339724.2,592200
497660,628126.6,930650,232580,275971.6,338450,265080,352155,592200
516070,612651.5,930650,238720,269719.1,338450,277350,342932.4,592200
534400,604688,930650,244910,267777.8,338450,289490,336910.2,592200
552760,617147.4,930650,251070,268173.1,338450,301690,348974.3,592200
565290,619602.1,930650,253310,267642.1,338450,311980,351960,592200
577840,619941.4,930650,255540,263276,338450,322300,356665.4,592200
590410,631835.6,930650,257790,271108.9,338450,332620,360726.7,592200
602920,643831.4,930650,260050,272195.3,338450,342870,371636.1,592200
616250,673651.3,930650,263360,287908.6,338450,352890,385742.7,592200
629570,704352.4,930650,266660,297287.3,338450,362910,407065.1,592200
642910,732344.3,930650,269970,310627.5,338450,372940,421716.8,592200
656230,742364,930650,273260,316516.9,338450,382970,425847.1,592200
670310,760978,930650,275900,314771.5,338450,394410,446206.5,592200
684300,765147.8,930650,278550,309625,338450,405750,455522.8,592200
698450,779817.9,930650,281170,310457.3,338450,417280,469360.6,592200
712490,775489.9,930650,283830,306989.2,338450,428660,468500.7,592200
707910,772464.1,930650,279600,302722.7,338450,428310,469741.4,592200
703280,760082.2,930650,275390,290755,338450,427890,469327.2,592200
698740,746707.9,930650,271180,280810.4,338450,427560,465897.5,592200
694140,734494.9,930650,266950,278104.2,338450,427190,456390.7,592200
686930,707338.3,930650,261470,261609.9,338450,425460,445728.4,592200
679690,664946.3,930650,255970,228086.6,338450,423720,436859.7,592200
672440,604873.4,930650,250490,189592.4,338450,421950,415281,592200
665230,595237.2,930650,245000,186946.3,338450,420230,408290.9,592200
659230,592701.9,930650,240530,182817.1,338450,418700,409884.8,592200
653290,581666.5,930650,236060,183487.9,338450,417230,398178.6,592200
647370,554179.6,930650,231590,163788.7,338450,415780,390390.9,592200
641460,528414.1,930650,227130,143515.6,338450,414330,384898.5,592200
631270,493585,930650,224330,129560.7,338450,406940,364024.3,592200
621070,521433.2,930650,221500,156397,338450,399570,365036.2,592200
610930,492322.3,930650,218690,145183,338450,392240,347139.3,592200
600720,494799.1,930650,215870,138737.8,338450,384850,356061.3,592200
590610,474223.3,930650,213750,139103.1,338450,376860,335120.2,592200
580640,436508.2,930650,211650,125111.8,338450,368990,311396.4,592200
570590,429090.2,930650,209550,133230.3,338450,361040,295859.9,592200
560590,419711.8,930650,207430,133741.4,338450,353160,285970.4,592200
551870,451392,930650,206060,157591.8,338450,345810,293800.2,592200
543100,480098.9,930650,204640,173949.6,338450,338460,306149.3,592200
534350,517606.2,930650,203240,186748.7,338450,331110,330857.5,592200
525610,548137,930650,201860,213468.7,338450,323750,334668.3,592200
521030,549690.2,930650,202260,227157,338450,318770,322533.2,592200
516480,505748.4,930650,202660,204344.9,338450,313820,301403.5,592200
511870,485187.9,930650,203070,194915.2,338450,308800,290272.7,592200
507270,472806.8,930650,203470,193086.8,338450,303800,279720,592200
503310,523808.9,930650,204600,220276.7,338450,298710,303532.2,592200
499350,533374.5,930650,205770,218085.8,338450,293580,315288.7,592200
495370,546760.4,930650,206900,230747.3,338450,288470,316013.1,592200
494260,588900.8,930650,206390,257153.7,338450,287870,331747.1,592200
490850,595947.4,930650,206800,258941,338450,284050,337006.4,592200
487340,606591.7,930650,207190,264910.8,338450,280150,341680.9,592200
483940,618115.8,930650,207600,268637.5,338450,276340,349478.3,592200
480520,619086.4,930650,208010,268222.8,338450,272510,350863.6,592200
484530,632225.7,930650,210740,270156.5,338450,273790,362069.2,592200
488710,614144.6,930650,213520,257957.3,338450,275190,356187.3,592200
492760,610714,930650,216260,259262.9,338450,276500,351451.1,592200
496780,608824.5,930650,219020,263842.4,338450,277760,344982.1,592200
501540,599378.1,930650,222260,266103.8,338450,279280,333274.3,592200
506340,592151.2,930650,225520,270536,338450,280820,321615.2,592200
511050,583992.7,930650,228750,272910.8,338450,282300,311081.9,592200
515790,589212.6,930650,232000,275997.5,338450,283790,313215.1,592200
521580,591241.4,930650,235410,276080.9,338450,286170,315160.5,592200
527440,593177.8,930650,238830,274895.1,338450,288610,318282.7,592200
533210,614898.8,930650,242240,286343.5,338450,290970,328555.3,592200
539010,598929.3,930650,245650,275080,338450,293360,323849.3,592200
549720,603648,930650,248460,272352.5,338450,301260,331295.5,592200
560440,603373.5,930650,251230,274533.6,338450,309210,328839.9,592200
571170,608791.7,930650,254030,273056.5,338450,317140,335735.2,592200
581840,615173.4,930650,256830,274316.3,338450,325010,340857.1,592200
591690,609723.5,930650,259420,275549,338450,332270,334174.5,592200
601570,615757.2,930650,262050,277229.9,338450,339520,338527.3,592200
611410,611706.2,930650,264650,281149.6,338450,346760,330556.6,592200
621280,612783.4,930650,267260,281554.8,338450,354020,331228.6,592200
631660,621321.4,930650,270170,285841.8,338450,361490,335479.6,592200
642070,620535.3,930650,273060,284706.5,338450,369010,335828.8,592200
652460,650327.7,930650,275970,292007.7,338450,376490,358320,592200
662840,682546.6,930650,278860,303426.3,338450,383980,379120.3,592200
664870,705849.6,930650,278160,305459.8,338450,386710,400389.8,592200
666950,702784.5,930650,277460,305136.4,338450,389490,397648.1,592200
669040,708615.2,930650,276740,298901.1,338450,392300,409714.1,592200
671090,701378.6,930650,276030,290768.5,338450,395060,410610.1,592200
672910,714830.4,930650,275060,296909.1,338450,397850,417921.3,592200
674700,711322.8,930650,274070,297001.2,338450,400630,414321.6,592200
676520,712124.7,930650,273110,297600.8,338450,403410,414523.9,592200
678300,713560.9,930650,272120,296975,338450,406180,416585.9,592200
679190,686862.6,930650,271050,282957,338450,408140,403905.6,592200
680030,694603.7,930650,269980,283412.7,338450,410050,411191,592200
680910,679997.8,930650,268900,275937.5,338450,412010,404060.3,592200
681740,661571.6,930650,267850,267015.9,338450,413890,394555.7,592200
681040,644695,930650,267060,263913.2,338450,413980,380781.8,592200
680240,624512.8,930650,266280,247659.9,338450,413960,376852.9,592200
679590,647947.5,930650,265510,266682.4,338450,414080,381265.1,592200
678800,642558.9,930650,264730,265237.7,338450,414070,377321.2,592200
679110,640847.9,930650,264710,266264,338450,414400,374583.9,592200
679340,642061.1,930650,264660,265336.4,338450,414680,376724.7,592200
679580,637243.1,930650,264600,266185.4,338450,414980,371057.7,592200
679820,641870.2,930650,264560,263731.8,338450,415260,378138.4,592200
681170,643360.5,930650,264640,260394.1,338450,416530,382966.4,592200
682450,615294.3,930650,264690,245462.3,338450,417760,369832,592200
683760,594373.9,930650,264720,236709.4,338450,419040,357664.5,592200
685110,615500.8,930650,264810,251312,338450,420300,364188.8,592200
675730,600933.5,930650,262590,247869.6,338450,413140,353063.9,592200
666340,559979,930650,260390,227062.8,338450,405950,332916.2,592200
656950,562914.4,930650,258170,223936.6,338450,398780,338977.8,592200
647490,609852.1,930650,255940,242668.3,338450,391550,367183.8,592200
639150,649881.4,930650,254070,261034.3,338450,385080,388847.1,592200
630680,627209.5,930650,252160,241421.1,338450,378520,385788.4,592200
622310,605870.8,930650,250280,226112.8,338450,372030,379758,592200
613900,596971.6,930650,248380,226311.6,338450,365520,370660,592200
605790,550568.5,930650,246590,216733.4,338450,359200,333835.1,592200
597670,552074.9,930650,244800,217139.2,338450,352870,334935.7,592200
589550,511329.1,930650,243000,206443.4,338450,346550,304885.7,592200
581400,487375.6,930650,241200,204532.9,338450,340200,282842.7,592200
580760,457521.3,930650,242340,185771.5,338450,338420,271749.8,592200
579970,420583.1,930650,243430,170482,338450,336540,250101.1,592200
579250,421637.6,930650,244550,177727,338450,334700,243910.6,592200
578440,427370.3,930650,245660,186503,338450,332780,240867.3,592200
577160,419611.3,930650,246640,193007.1,338450,330520,226604.2,592200
575730,408180,930650,247620,190501.4,338450,328110,217678.6,592200
574360,411825.7,930650,248590,201569.9,338450,325770,210255.8,592200
572970,415773.7,930650,249540,207947.1,338450,323430,207826.6,592200
572780,433405.4,930650,250630,212592.7,338450,322150,220812.7,592200
572620,420075.8,930650,251750,204618.9,338450,320870,215456.9,592200
572330,443239.8,930650,252800,221203.9,338450,319530,222035.9,592200
572210,450790,930650,253890,223688.4,338450,318320,227101.6,592200
580770,504577.2,930650,255850,250311.1,338450,324920,254266.1,592200
589360,562982.3,930650,257830,279940.4,338450,331530,283041.9,592200
597910,584120.2,930650,259820,283205.6,338450,338090,300914.6,592200
606450,558320.6,930650,261780,259686.7,338450,344670,298633.9,592200
615090,593711.7,930650,263820,282979.9,338450,351270,310731.8,592200
623610,613467.6,930650,265850,289273.8,338450,357760,324193.8,592200
632200,626080.2,930650,267880,291528.2,338450,364320,334552,592200
640850,653429.9,930650,269900,290503.6,338450,370950,362926.3,592200
648600,659181.8,930650,271760,281713.4,338450,376840,377468.4,592200
656290,642826,930650,273630,265392.3,338450,382660,377433.7,592200
664050,658457.3,930650,275510,276129.7,338450,388540,382327.6,592200
671860,661585.4,930650,277400,275593.4,338450,394460,385992,592200
676770,674341.8,930650,278660,284838.6,338450,398110,389503.2,592200
681740,688056.8,930650,279960,290097.9,338450,401780,397958.9,592200
686680,695261.7,930650,281240,284633.5,338450,405440,410628.2,592200
691600,690026.1,930650,282530,270808.4,338450,409070,419217.7,592200
695930,696390.4,930650,283520,278718,338450,412410,417672.4,592200
700330,697970.3,930650,284540,284421.4,338450,415790,413548.9,592200
704620,702709.2,930650,285520,290072,338450,419100,412637.2,592200
665690,712790.6,930650,278270,297562.3,338450,387420,415228.3,592200
669220,741358.5,930650,279300,298255.8,338450,389920,443102.7,592200
672870,757133.5,930650,280320,299009.2,338450,392550,458124.3,592200
676570,758684.5,930650,281370,299144.5,338450,395200,459540,592200
680140,788812.6,930650,282390,314879.4,338450,397750,473933.2,592200
685280,792590.6,930650,283680,312868.7,338450,401600,479721.9,592200
690490,771199.7,930650,285000,305575.8,338450,405490,465623.9,592200
695640,750099.1,930650,286290,299490.2,338450,409350,450608.9,592200
700670,753654.2,930650,287580,303890.3,338450,413090,449763.9,592200
706430,723522.3,930650,288910,296604.9,338450,417520,426917.4,592200
712000,737396,930650,290220,307355.3,338450,421780,430040.7,592200
717660,750045.3,930650,291540,308140.8,338450,426120,441904.5,592200
723250,751866.7,930650,292830,302861.7,338450,430420,449005,592200
727860,770588.8,930650,294040,310048.7,338450,433820,460540.1,592200
732450,782895.6,930650,295220,309821.4,338450,437230,473074.2,592200
737110,787325.2,930650,296420,305641,338450,440690,481684.2,592200
741700,780723.7,930650,297600,306795.6,338450,444100,473928.1,592200
744060,742405,930650,296310,283887.9,338450,447750,458517.1,592200
746420,782557.2,930650,295000,310558.6,338450,451420,471998.6,592200
748800,796776.4,930650,293710,313147.2,338450,455090,483629.2,592200
751080,830030.2,930650,292380,319233.4,338450,458700,510796.8,592200
759340,842006.3,930650,296430,320947.8,338450,462910,521058.5,592200
767600,817858.6,930650,300440,323886,338450,467160,493972.6,592200
775870,820956.3,930650,304480,328638.4,338450,471390,492317.9,592200
784140,814594.1,930650,308500,328980,338450,475640,485614.1,592200
788170,808605.1,930650,309740,327321.8,338450,478430,481283.3,592200
792240,809167.4,930650,310960,327784.8,338450,481280,481382.6,592200
796260,813861.1,930650,312210,325232.3,338450,484050,488628.8,592200
800370,784902,930650,313460,304328.5,338450,486910,480573.5,592200
797420,759623.6,930650,312070,306676.8,338450,485350,452946.8,592200
794430,742501,930650,310670,302450.7,338450,483760,440050.3,592200
791460,772879,930650,309290,310517.7,338450,482170,462361.3,592200
788450,744138.3,930650,307890,296929.3,338450,480560,447209,592200
783830,731619.7,930650,305910,300120.3,338450,477920,431499.4,592200
779230,727877.1,930650,303910,301444.3,338450,475320,426432.8,592200
774540,731072.6,930650,301920,298194.1,338450,472620,432878.5,592200
769870,749102.9,930650,299940,297455.9,338450,469930,451647,592200
766820,748988.8,930650,298640,297150.7,338450,468180,451838.1,592200
763670,767372.9,930650,297340,309187.6,338450,466330,458185.3,592200
760590,763171.9,930650,296040,305536.1,338450,464550,457635.8,592200
757530,740233.5,930650,294780,294871.7,338450,462750,445361.8,592200
751800,701199.5,930650,292880,270998.1,338450,458920,430201.4,592200
746160,700577,930650,291030,264443.5,338450,455130,436133.5,592200
740430,733298.6,930650,289130,279835.2,338450,451300,453463.4,592200
734820,756828.5,930650,287290,286868.5,338450,447530,469960,592200
728340,725557.3,930650,285200,279048.3,338450,443140,446509,592200
721950,717626.2,930650,283110,273745.7,338450,438840,443880.5,592200
715490,723107.8,930650,281010,280951.5,338450,434480,442156.3,592200
709060,709811.3,930650,278950,280974.3,338450,430110,428837,592200
702840,692670.7,930650,276830,266620.1,338450,426010,426050.6,592200
696620,677099.1,930650,274710,263799.1,338450,421910,413300,592200
690360,672993.4,930650,272620,276666,338450,417740,396327.4,592200
684190,665868,930650,270510,282736.1,338450,413680,383131.9,592200
668910,669616.4,930650,267040,287148.8,338450,401870,382467.6,592200
653500,616206.8,930650,263560,236879.9,338450,389940,379326.9,592200
638240,634483.7,930650,260090,243605.9,338450,378150,390877.8,592200
622930,612763.2,930650,256620,265996.6,338450,366310,346766.6,592200
606810,590140.2,930650,252950,276929.7,338450,353860,313210.5,592200
590650,519328.6,930650,249270,244256.4,338450,341380,275072.2,592200
574570,477259.3,930650,245610,224833.5,338450,328960,252425.8,592200
558490,494746.8,930650,241970,236114.3,338450,316520,258632.5,592200
542410,490080.2,930650,238250,224408.8,338450,304160,265671.4,592200
526360,493072.9,930650,234540,218190.1,338450,291820,274882.8,592200
510260,479720.1,930650,230820,222820,338450,279440,256900.1,592200
494170,461645.5,930650,227110,222403.1,338450,267060,239242.4,592200
489530,430592.2,930650,226460,216423.4,338450,263070,214168.8,592200
484890,446748.5,930650,225810,220963.7,338450,259080,225784.8,592200
480310,459905.7,930650,225200,224360.8,338450,255110,235544.9,592200
475620,448039.2,930650,224550,221356.8,338450,251070,226682.4,592200
471180,456644.9,930650,223350,228356.2,338450,247830,228288.7,592200
466700,444335.9,930650,222150,225043.1,338450,244550,219292.8,592200
462310,425203.2,930650,220950,225832,338450,241360,199371.2,592200
457840,421017.5,930650,219750,215637.9,338450,238090,205379.6,592200
454200,426796,930650,218990,225329.1,338450,235210,201466.9,592200
450570,437491.3,930650,218230,232620.5,338450,232340,204870.8,592200
446920,468020,930650,217460,235652.9,338450,229460,232367.1,592200
443300,488020.1,930650,216710,244463.1,338450,226590,243557,592200
453300,493382,930650,219070,246706.6,338450,234230,246675.4,592200
463300,503196,930650,221420,249211.3,338450,241880,253984.7,592200
473190,499566.8,930650,223790,241241.5,338450,249400,258325.3,592200
483170,508233.6,930650,226140,246993.5,338450,257030,261240.1,592200
493200,542272.4,930650,228620,259254,338450,264580,283018.4,592200
503190,571051.5,930650,231130,267920.3,338450,272060,303131.2,592200
513180,580709.2,930650,233610,270011,338450,279570,310698.2,592200
523200,593821.3,930650,236100,272798.6,338450,287100,321022.7,592200
533510,603221.9,930650,238830,273605.3,338450,294680,329616.6,592200
543810,623892,930650,241540,286481.2,338450,302270,337410.8,592200
554180,622782.6,930650,244300,290035.6,338450,309880,332747,592200
564500,630014.9,930650,247040,287905.9,338450,317460,342109,592200
568610,649550.1,930650,247000,290804.3,338450,321610,358745.8,592200
572840,670274.7,930650,246980,295053.3,338450,325860,375221.4,592200
577000,661761.2,930650,246950,291289.9,338450,330050,370471.3,592200
581160,668720.5,930650,246920,298325.1,338450,334240,370395.4,592200
585240,668977.8,930650,247070,301447.9,338450,338170,367529.9,592200
589250,680858.4,930650,247240,300560.8,338450,342010,380297.6,592200
593320,673644.4,930650,247410,296857.3,338450,345910,376787.1,592200
485740,681595.3,930650,194950,299635.9,338450,290790,381959.4,592200
485020,659990.4,930650,192350,288231.3,338450,292670,371759.1,592200
484350,626005.2,930650,189730,265865.7,338450,294620,360139.5,592200
483620,676955.7,930650,187140,300379.2,338450,296480,376576.5,592200
482940,685504.1,930650,184530,299686,338450,298410,385818.1,592200
472130,688346.4,930650,179280,301159.7,338450,292850,387186.7,592200
461230,640545.6,930650,174020,266594.3,338450,287210,373951.3,592200
450410,581763.2,930650,168780,229538.2,338450,281630,352225,592200
439530,575274.3,930650,163510,229133.7,338450,276020,346140.6,592200
427660,609115.1,930650,157830,245675.3,338450,269830,363439.8,592200
415860,630574,930650,152120,260592.6,338450,263740,369981.4,592200
403940,614632,930650,146420,257605.3,338450,257520,357026.7,592200
392160,583153,930650,140740,240653.5,338450,251420,342499.5,592200
381560,536849.9,930650,135140,222220.3,338450,246420,314629.6,592200
370990,521534.8,930650,129570,219770.6,338450,241420,301764.2,592200
360440,527912.4,930650,124000,224316.9,338450,236440,303595.5,592200
349830,505110.3,930650,118410,220352.5,338450,231420,284757.8,592200
344840,499898.5,930650,122380,228082.6,338450,222460,271815.9,592200
339990,482001.3,930650,126370,215703.8,338450,213620,266297.5,592200
335030,425478.3,930650,130330,178294.4,338450,204700,247183.9,592200
330090,460664.8,930650,134280,200521.7,338450,195810,260143.1,592200
324290,488849.8,930650,136700,224317.1,338450,187590,264532.7,592200
318310,494420.9,930650,139100,222936.3,338450,179210,271484.6,592200
312370,483451.2,930650,141500,227392.1,338450,170870,256059.1,592200
306480,464755.2,930650,143920,223745.6,338450,162560,241009.6,592200
302510,443712.3,930650,146320,224964.5,338450,156190,218747.8,592200
298410,453063.5,930650,148720,224760.6,338450,149690,228302.9,592200
294410,441786.4,930650,151080,219444.5,338450,143330,222341.9,592200
290390,449865.1,930650,153490,222180.8,338450,136900,227684.3,592200
302870,448448.5,930650,158690,225921.8,338450,144180,222526.7,592200
315350,455817.9,930650,163910,230215.4,338450,151440,225602.5,592200
327850,460415.6,930650,169110,233893.5,338450,158740,226522.1,592200
340380,472679.3,930650,174300,238609,338450,166080,234070.3,592200
355270,477964.6,930650,179820,245610.5,338450,175450,232354.1,592200
370080,488813,930650,185280,250659.3,338450,184800,238153.7,592200
384920,493384.5,930650,190760,255274.4,338450,194160,238110.1,592200
399770,527122.1,930650,196250,275256.8,338450,203520,251865.3,592200
412360,535608.3,930650,200850,273244.6,338450,211510,262363.7,592200
424820,549794.2,930650,205480,272372.5,338450,219340,277421.7,592200
437370,564631.2,930650,210040,278391.6,338450,227330,286239.6,592200
449880,557042.6,930650,214640,270133.1,338450,235240,286909.5,592200
453850,556124,930650,212670,270727.6,338450,241180,285396.4,592200
457880,573698.6,930650,210680,272702.3,338450,247200,300996.3,592200
461820,552181.5,930650,208700,246497.7,338450,253120,305683.8,592200
465880,572921.9,930650,206730,257498.5,338450,259150,315423.4,592200
469770,560893.7,930650,205540,243538.6,338450,264230,317355.1,592200
473650,533632.5,930650,204330,217958.9,338450,269320,315673.6,592200
477510,527283,930650,203120,212817.1,338450,274390,314465.9,592200
481460,506723,930650,201930,193740.2,338450,279530,312982.8,592200
484700,531951,930650,200660,204331.9,338450,284040,327619.1,592200
488040,516318.1,930650,199380,193426.3,338450,288660,322891.8,592200
491280,588071.6,930650,198090,224234.7,338450,293190,363836.9,592200
494570,544634.5,930650,196810,193547.3,338450,297760,351087.2,592200
487990,474726.8,930650,195860,144466.4,338450,292130,330260.4,592200
481450,477373.2,930650,194910,146291.2,338450,286540,331082,592200
474890,475838.5,930650,193970,143784.4,338450,280920,332054.1,592200
468400,481744.6,930650,193020,157851.4,338450,275380,323893.2,592200
462130,422585,930650,192750,122729,338450,269380,299856,592200
455820,402188.6,930650,192490,105999.9,338450,263330,296188.7,592200
449530,408115.2,930650,192220,124785.9,338450,257310,283329.3,592200
443250,392267.2,930650,191950,116433.2,338450,251300,275834,592200
438020,373957.7,930650,191370,110107.8,338450,246650,263849.9,592200
432700,309383.4,930650,190750,79218.7,338450,241950,230164.7,592200
427380,279304,930650,190160,70010.4,338450,237220,209293.6,592200
422170,285313.4,930650,189580,81103.8,338450,232590,204209.6,592200
424720,263982.6,930650,192320,75573.2,338450,232400,188409.4,592200
427370,247163.8,930650,195070,76504.1,338450,232300,170659.7,592200
429950,231002.9,930650,197790,68680.9,338450,232160,162322,592200
432550,257876.5,930650,200540,83741.7,338450,232010,174134.8,592200
434690,284594.2,930650,203020,100695.4,338450,231670,183898.8,592200
436830,335713.4,930650,205510,140182.9,338450,231320,195530.5,592200
438940,404849,930650,208010,210537.9,338450,230930,194311.1,592200
441080,398102.8,930650,210470,213095.8,338450,230610,185007,592200
443560,417952.7,930650,212630,214594.5,338450,230930,203358.2,592200
446230,398482.6,930650,214790,216799.5,338450,231440,181683.1,592200
448770,405295.6,930650,216930,222520.1,338450,231840,182775.5,592200
451300,386237.8,930650,219080,210756.5,338450,232220,175481.3,592200
453800,403776.2,930650,220240,222551.3,338450,233560,181224.9,592200
456350,418212.6,930650,221440,205274.6,338450,234910,212938,592200
458840,384706.3,930650,222600,181221.9,338450,236240,203484.4,592200
461330,430091.3,930650,223760,219360.3,338450,237570,210731,592200
463480,451830.5,930650,224880,231280.8,338450,238600,220549.7,592200
465650,458727.2,930650,225970,237173,338450,239680,221554.2,592200
467800,471896,930650,227070,246606.7,338450,240730,225289.3,592200
469980,464117.9,930650,228180,242161.5,338450,241800,221956.4,592200
471660,467221.3,930650,229000,241437.6,338450,242660,225783.7,592200
473380,474424.4,930650,229840,243476.4,338450,243540,230948,592200
475120,471513.4,930650,230690,235256.4,338450,244430,236257,592200
476900,465004.1,930650,231520,231081.4,338450,245380,233922.7,592200
479860,460422.8,930650,231890,228396.6,338450,247970,232026.2,592200
482830,435973.8,930650,232250,225483,338450,250580,210490.8,592200
485760,460106.8,930650,232600,224134.1,338450,253160,235972.7,592200
488790,481981.4,930650,232980,225547.2,338450,255810,256434.2,592200
491370,458907.5,930650,233260,221788.5,338450,258110,237119,592200
494030,428091.5,930650,233530,212701.8,338450,260500,215389.7,592200
496690,382738,930650,233830,179029.8,338450,262860,203708.2,592200
451710,443797.8,930650,226040,223511.5,338450,225670,220286.3,592200
454330,477033.3,930650,226500,237452.8,338450,227830,239580.5,592200
456830,476167.5,930650,226910,236228.2,338450,229920,239939.3,592200
459370,474160.2,930650,227340,243360.6,338450,232030,230799.6,592200
461950,469102.1,930650,227790,237167.1,338450,234160,231935,592200
464470,464366.2,930650,228370,230450.2,338450,236100,233916,592200
467000,495689.5,930650,228990,236126.3,338450,238010,259563.2,592200
469540,490175.5,930650,229600,234420.8,338450,239940,255754.7,592200
472010,496751.2,930650,230180,236443.7,338450,241830,260307.5,592200
474910,482510.5,930650,230650,234638.5,338450,244260,247872,592200
477860,491451.6,930650,231120,238689.3,338450,246740,252762.3,592200
480640,515698.8,930650,231560,244741.2,338450,249080,270957.6,592200
483520,477431.4,930650,232000,237587.3,338450,251520,239844.1,592200
486090,464427.4,930650,232150,234508.3,338450,253940,229919.1,592200
488640,477818.2,930650,232270,237207.1,338450,256370,240611.1,592200
491250,500118.6,930650,232440,248589.4,338450,258810,251529.2,592200
493840,480073.9,930650,232580,237549.6,338450,261260,242524.3,592200
494660,475663.3,930650,232270,236648.1,338450,262390,239015.2,592200
495450,472662.1,930650,231940,234268.9,338450,263510,238393.2,592200
496300,497566.1,930650,231650,230137.1,338450,264650,267429,592200
497090,495384.1,930650,231340,222651.9,338450,265750,272732.2,592200
496950,507646.9,930650,230970,231625.1,338450,265980,276021.8,592200
496870,501058.4,930650,230630,233342.6,338450,266240,267715.8,592200
496760,490373.5,930650,230290,226480.2,338450,266470,263893.3,592200
496670,482832.5,930650,229930,221070.5,338450,266740,261762,592200
496740,493388.9,930650,229840,232571.9,338450,266900,260817,592200
496890,496778.4,930650,229780,229897.1,338450,267110,266881.3,592200
496970,506041,930650,229670,237718.3,338450,267300,268322.7,592200
497000,494868.1,930650,229610,232149.7,338450,267390,262718.4,592200
495900,504510.1,930650,229450,235441.5,338450,266450,269068.6,592200
494800,515269.6,930650,229260,239994.6,338450,265540,275275,592200
493680,506465.3,930650,229100,240202.7,338450,264580,266262.6,592200
492600,501324.9,930650,228950,235283.5,338450,263650,266041.4,592200
491940,517688.3,930650,228790,239508.5,338450,263150,278179.8,592200
491300,514964.1,930650,228670,239931.1,338450,262630,275033,592200
490750,521268.6,930650,228560,241970.4,338450,262190,279298.2,592200
490060,499140.4,930650,228430,235967.4,338450,261630,263173,592200
488450,518111.3,930650,227990,236833.1,338450,260460,281278.2,592200
486850,502763.8,930650,227560,234273.6,338450,259290,268490.2,592200
485250,496899.6,930650,227130,223258.9,338450,258120,273640.7,592200
483610,502098.3,930650,226700,235237.4,338450,256910,266860.9,592200
482560,476615.9,930650,225510,223549.1,338450,257050,253066.8,592200
481510,481489.4,930650,224330,222448.9,338450,257180,259040.5,592200
480460,496407.1,930650,223140,234508.5,338450,257320,261898.6,592200
479390,482729,930650,221960,230977,338450,257430,251752,592200
477910,469918,930650,219590,233460.1,338450,258320,236457.9,592200
476430,487390.2,930650,217250,242082.2,338450,259180,245308,592200
474990,427533.5,930650,214850,194418.7,338450,260140,233114.8,592200
473570,412098.3,930650,212500,178164.3,338450,261070,233934,592200
473840,411840.3,930650,212050,185258.9,338450,261790,226581.4,592200
474140,383935.2,930650,211600,177332.9,338450,262540,206602.3,592200
474440,383628.7,930650,211140,167794.2,338450,263300,215834.5,592200
474830,383498.7,930650,210690,168172,338450,264140,215326.7,592200
476120,375915.4,930650,210240,177923.5,338450,265880,197991.9,592200
477420,363335.3,930650,209770,173278.4,338450,267650,190056.9,592200
478650,363335.3,930650,209330,173278.4,338450,269320,190056.9,592200
479950,401765.8,930650,208860,190655.7,338450,271090,211110.1,592200
482900,402338.7,930650,208670,188290.1,338450,274230,214048.6,592200
485890,392995.7,930650,208480,183575.2,338450,277410,209420.5,592200
488790,392995.7,930650,208290,183575.2,338450,280500,209420.5,592200
491750,359886,930650,208110,164603.3,338450,283640,195282.7,592200
493560,369948.5,930650,208030,172290.5,338450,285530,197658,592200
495320,361116.5,930650,207950,165906.5,338450,287370,195210,592200
497130,358360.5,930650,207880,160412,338450,289250,197948.5,592200
498870,342096.9,930650,207820,155726.8,338450,291050,186370.1,592200
488280,335059.5,930650,203720,161322.5,338450,284560,173737,592200
477720,323841.8,930650,199640,151433,338450,278080,172408.8,592200
467150,282608.9,930650,195540,120340.1,338450,271610,162268.8,592200
456560,286581,930650,191450,127274.4,338450,265110,159306.6,592200
446290,288688.6,930650,187660,135128.2,338450,258630,153560.4,592200
436020,299760.6,930650,183860,135043,338450,252160,164717.6,592200
425820,277314,930650,180080,117792.4,338450,245740,159521.6,592200
415510,272239.9,930650,176280,117892.4,338450,239230,154347.5,592200
405020,255984.5,930650,172400,115118,338450,232620,140866.5,592200
394520,261582.7,930650,168540,121772.6,338450,225980,139810.1,592200
383960,278267,930650,164650,137264.5,338450,219310,141002.5,592200
373410,277672.2,930650,160790,142586.3,338450,212620,135085.9,592200
362080,258804.7,930650,156820,128631.2,338450,205260,130173.5,592200
350640,213711,930650,152810,113053.8,338450,197830,100657.2,592200
339280,228250.6,930650,148830,123901.3,338450,190450,104349.3,592200
327980,233670.3,930650,144860,130469.7,338450,183120,103200.6,592200
317140,250756.3,930650,140710,140693.6,338450,176430,110062.7,592200
306440,250605.3,930650,136610,139962,338450,169830,110643.3,592200
295660,245456.4,930650,132450,140668.9,338450,163210,104787.5,592200
284920,262605,930650,128350,151332.4,338450,156570,111272.6,592200
274920,236686.5,930650,124840,131157.1,338450,150080,105529.4,592200
264960,227535.7,930650,121370,123555.6,338450,143590,103980.1,592200
255030,259228.6,930650,117870,149772.4,338450,137160,109456.2,592200
245080,271697,930650,114410,158129.7,338450,130670,113567.3,592200
237920,258903.3,930650,111310,152966.8,338450,126610,105936.5,592200
230970,270213.7,930650,108240,160071,338450,122730,110142.7,592200
223880,279269.4,930650,105160,154269.4,338450,118720,125000,592200
216820,293274.6,930650,102080,153729.7,338450,114740,139544.9,592200
210000,274934.4,930650,99630,150803.8,338450,110370,124130.6,592200
203170,264544.9,930650,97190,139400.7,338450,105980,125144.2,592200
196290,239858.5,930650,94700,127316.8,338450,101590,112541.7,592200
218480,228124.8,930650,115240,126207.9,338450,103240,101916.9,592200
214120,209105.5,930650,114120,123565,338450,100000,85540.5,592200
209810,224651.6,930650,113000,129171.7,338450,96810,95479.9,592200
205390,215083.6,930650,111900,120005.7,338450,93490,95077.9,592200
201090,223972,930650,110800,125030,338450,90290,98942,592200
201860,211878.4,930650,112470,127662.9,338450,89390,84215.5,592200
202730,214761.1,930650,114160,125782.6,338450,88570,88978.5,592200
203510,182523.8,930650,115840,102872,338450,87670,79651.8,592200
204290,208881.1,930650,117540,120994.3,338450,86750,87886.8,592200
204410,213717.5,930650,118510,124869.1,338450,85900,88848.4,592200
204650,220228.1,930650,119520,130050.3,338450,85130,90177.8,592200
204820,214602.4,930650,120510,125117.4,338450,84310,89485,592200
204950,221396.7,930650,121500,134638.3,338450,83450,86758.4,592200
204460,251860.4,930650,121660,160785.1,338450,82800,91075.3,592200
204010,262954.2,930650,121820,171836.1,338450,82190,91118.1,592200
203560,258441.2,930650,122000,163986.8,338450,81560,94454.4,592200
203120,272541.9,930650,122180,170310.5,338450,80940,102231.4,592200
203220,304738.2,930650,122840,178046.2,338450,80380,126692,592200
203440,256286.8,930650,123500,146686.9,338450,79940,109599.9,592200
203610,289797,930650,124160,172103.6,338450,79450,117693.4,592200
203790,319445.2,930650,124800,194971.7,338450,78990,124473.5,592200
201840,230507,930650,123750,137426.8,338450,78090,93080.2,592200
199970,196887.7,930650,122710,114060.6,338450,77260,82827.1,592200
197990,194900.8,930650,121650,94866.8,338450,76340,100034,592200
196090,215492.6,930650,120610,112937.5,338450,75480,102555.1,592200
193770,222764.4,930650,119620,114298.5,338450,74150,108465.9,592200
191470,242961.5,930650,118660,127882.3,338450,72810,115079.2,592200
189150,222398.5,930650,117680,115455.4,338450,71470,106943.1,592200
186850,207825,930650,116700,105016.3,338450,70150,102808.7,592200
182700,214140.3,930650,114240,110358.9,338450,68460,103781.4,592200
178450,246290.3,930650,111770,130449.8,338450,66680,115840.5,592200
174360,210310.7,930650,109310,103699,338450,65050,106611.7,592200
170150,180794.8,930650,106830,82864.2,338450,63320,97930.6,592200
163870,144209.1,930650,103060,68646.7,338450,60810,75562.4,592200
157650,121523.6,930650,99290,62917.4,338450,58360,58606.2,592200
151400,109900.4,930650,95530,54379.5,338450,55870,55520.9,592200
145180,109470.9,930650,91760,50719.3,338450,53420,58751.6,592200
140920,129468.2,930650,90080,58998.2,338450,50840,70470,592200
136680,119104.1,930650,88440,50278.3,338450,48240,68825.8,592200
132410,110358.5,930650,86770,44838.5,338450,45640,65520,592200
128250,97173,930650,85120,38736.4,338450,43130,58436.6,592200
128910,88378.5,930650,84120,36230.5,338450,44790,52148,592200
129560,86808.4,930650,83120,34498,338450,46440,52310.4,592200
130250,104367.8,930650,82080,31587.7,338450,48170,72780.1,592200
130950,119159.2,930650,81080,33600.7,338450,49870,85558.5,592200
130620,116982.8,930650,79320,30021.3,338450,51300,86961.5,592200
130180,106233.4,930650,77550,22783.2,338450,52630,83450.2,592200
129830,98086.4,930650,75810,18921.4,338450,54020,79165,592200
129490,96884.7,930650,74050,17379.1,338450,55440,79505.6,592200
129260,94854.8,930650,72390,15982.9,338450,56870,78871.9,592200
129060,100881.5,930650,70710,17208.7,338450,58350,83672.8,592200
128890,98340,930650,69060,16429.2,338450,59830,81910.8,592200
128630,98340,930650,67390,16429.2,338450,61240,81910.8,592200
131610,98340,930650,67240,157796.064,338450,64370,81910.8,592200
134570,93492.3,930650,67110,13701.6,338450,67460,79790.7,592200
137590,93414.2,930650,66970,14009.6,338450,70620,79404.6,592200
140490,95128.7,930650,66830,14337,338450,73660,80791.7,592200
144110,92735.2,930650,66960,12732.9,338450,77150,80002.3,592200
147760,91741.3,930650,67070,10269.2,338450,80690,81472.1,592200
151370,92939.7,930650,67190,11008.8,338450,84180,81930.9,592200
154970,93781.7,930650,67310,11501.6,338450,87660,82280.1,592200
158490,99815.1,930650,67490,9575.1,338450,91000,90240,592200
162010,93850.2,930650,67660,9750.5,338450,94350,84099.7,592200
165530,89473,930650,67840,11063.6,338450,97690,78409.4,592200
169050,84046.4,930650,68030,9037.5,338450,101020,75008.9,592200
167750,91793.3,930650,68360,13723.7,338450,99390,78069.6,592200
166470,92367.4,930650,68680,13737.9,338450,97790,78629.5,592200
165160,84417.7,930650,69020,10027.5,338450,96140,74390.2,592200
163850,74553.4,930650,69350,14040.2,338450,94500,60513.2,592200
161770,60480,930650,69770,7663.9,338450,92000,52816.1,592200
159660,80843,930650,70160,8745.5,338450,89500,72097.5,592200
157560,81330.2,930650,70570,9789.7,338450,86990,71540.5,592200
155430,75630.1,930650,71000,10459.1,338450,84430,65171,592200
152980,97883.8,930650,71180,13769.8,338450,81800,84114,592200
150580,107001.2,930650,71360,18697.9,338450,79220,88303.3,592200
148040,119121.5,930650,71530,23832.9,338450,76510,95288.6,592200
145570,130534.8,930650,71740,23652.2,338450,73830,106882.6,592200
143470,127371.9,930650,69400,20129,338450,74070,107242.9,592200
141420,135743.5,930650,67070,19892.1,338450,74350,115851.4,592200
139280,133274.9,930650,64750,19423.8,338450,74530,113851.1,592200
137160,119709.9,930650,62420,18618.3,338450,74740,101091.6,592200
135130,118897.6,930650,60540,19822.3,338450,74590,99075.3,592200
133130,114218,930650,58670,21922.2,338450,74460,92295.8,592200
131150,106964.7,930650,56810,15914,338450,74340,91050.7,592200
129220,105368.7,930650,54950,14349.3,338450,74270,91019.4,592200
127050,104208.8,930650,53060,14495.4,338450,73990,89713.4,592200
125060,110335.2,930650,51190,18948.8,338450,73870,91386.4,592200
122960,138308.9,930650,49300,38451.5,338450,73660,99857.4,592200
120920,136746.6,930650,47430,36255.6,338450,73490,100491,592200
115950,121875.9,930650,44950,30727.4,338450,71000,91148.5,592200
110960,114482.3,930650,42460,26543.4,338450,68500,87938.9,592200
105950,120693,930650,40020,28090.9,338450,65930,92602.1,592200
100940,112836.7,930650,37520,21146.3,338450,63420,91690.4,592200
97300,98031.6,930650,35550,11510,338450,61750,86521.6,592200
93600,94065.8,930650,33600,8346.9,338450,60000,85718.9,592200
89870,91595.8,930650,31610,8442.2,338450,58260,83153.6,592200
32640,101362.2,930650,3190,10867.4,338450,29450,90494.8,592200
30570,106842.4,930650,2840,12744.9,338450,27730,94097.5,592200
28380,106332.4,930650,2480,14080.3,338450,25900,92252.1,592200
26270,96593.4,930650,2160,9912.4,338450,24110,86681,592200
24150,91984.7,930650,1820,8973,338450,22330,83011.7,592200
23100,88966.3,930650,1700,8348,338450,21400,80618.3,592200
22020,85280.4,930650,1590,6105.5,338450,20430,79174.9,592200
20950,86065.7,930650,1450,7745.7,338450,19500,78320,592200
19870,80960.4,930650,1320,7267.6,338450,18550,73692.8,592200
18920,79213.4,930650,1270,6650.2,338450,17650,72563.2,592200
17960,78160.6,930650,1180,5147.1,338450,16780,73013.5,592200
16980,76405.8,930650,1100,5018.4,338450,15880,71387.4,592200
16060,74463.2,930650,1030,4993.1,338450,15030,69470.1,592200
15220,73620.4,930650,960,4881.5,338450,14260,68738.9,592200
14350,73448.1,930650,890,4865,338450,13460,68583.1,592200
13530,72893.1,930650,840,4910,338450,12690,67983.1,592200
12660,71980.2,930650,750,4891.8,338450,11910,67088.4,592200
12360,74229.2,930650,690,4876,338450,11670,69353.2,592200
12030,76481.9,930650,640,5001,338450,11390,71480.9,592200
11760,76324.3,930650,590,5013.5,338450,11170,71310.8,592200
11350,75458.5,930650,530,4976,338450,10820,70482.5,592200
11100,74283.9,930650,510,4926,338450,10590,69357.9,592200
10780,73532,930650,460,4901,338450,10320,68631,592200
10450,74813.7,930650,410,4926,338450,10040,69887.7,592200
10210,74189.9,930650,370,4876,338450,9840,69313.9,592200
9820,73356.5,930650,330,4863.5,338450,9490,68493,592200
9410,71803.1,930650,300,4801,338450,9110,67002.1,592200
9040,70947.3,930650,260,4738.5,338450,8780,66208.8,592200
8660,70372.6,930650,220,4920.5,338450,8440,65452.1,592200
8370,70074.2,930650,270,5040.3,338450,8100,65033.9,592200
8070,71595.9,930650,300,5268.5,338450,7770,66327.4,592200
7800,76227.6,930650,350,7717.4,338450,7450,68510.2,592200
7530,76772.3,930650,380,8799.5,338450,7150,67972.8,592200
7400,74123.3,930650,450,7361.2,338450,6950,66762.1,592200
7310,73014.2,930650,530,6267.1,338450,6780,66747.1,592200
7220,75366.3,930650,610,7078.7,338450,6610,68287.6,592200
7150,78826.7,930650,700,10304,338450,6450,68522.7,592200
6980,83135.8,930650,920,13265.9,338450,6060,69869.9,592200
6860,87673.9,930650,1150,16176.4,338450,5710,71497.5,592200
6730,93530.8,930650,1380,20939.1,338450,5350,72591.7,592200
6600,96694.1,930650,1640,23312.1,338450,4960,73382,592200
6730,98334.1,930650,1870,24773.5,338450,4860,73560.6,592200
6780,104069.9,930650,2100,29146.9,338450,4680,74923,592200
6940,112843.5,930650,2350,35881.7,338450,4590,76961.8,592200
7030,121432.4,930650,2570,43015.5,338450,4460,78416.9,592200
7230,124825.1,930650,2900,45796.5,338450,4330,79028.6,592200
7450,135022.4,930650,3210,54341.2,338450,4240,80681.2,592200
7630,117729.5,930650,3540,42067.8,338450,4090,75661.7,592200
7790,112025.2,930650,3860,37887.6,338450,3930,74137.6,592200
8270,116968.2,930650,4620,41762.1,338450,3650,75206.1,592200
8590,124115.6,930650,5340,46638.8,338450,3250,77476.8,592200
8980,125370.1,930650,6100,47189.4,338450,2880,78180.7,592200
9350,131907.4,930650,6830,52800.6,338450,2520,79106.8,592200
9130,146718.2,930650,6790,63151.1,338450,2340,83567.1,592200
9000,160162.9,930650,6780,72589.3,338450,2220,87573.6,592200
8810,155401.5,930650,6770,68804.9,338450,2040,86596.6,592200
8610,134552.6,930650,6740,53648.3,338450,1870,80904.3,592200
7960,110117.1,930650,6130,35228.2,338450,1830,74888.9,592200
7280,108783.3,930650,5490,34009.9,338450,1790,74773.4,592200
6600,160875.3,930650,4880,71891.9,338450,1720,88983.4,592200
5920,160320.3,930650,4260,71256.4,338450,1660,89063.9,592200
5640,140710,930650,3950,56446.4,338450,1690,84263.6,592200
5350,156455.8,930650,3640,67007.4,338450,1710,89448.4,592200
5070,160010.8,930650,3320,69922.9,338450,1750,90087.9,592200
4750,176665.1,930650,3010,82314.5,338450,1740,94350.6,592200
5920,179714,930650,3470,84542.4,338450,2450,95171.6,592200
7090,171285.8,930650,3910,80173.9,338450,3180,91111.9,592200
8260,163502.6,930650,4380,75742.2,338450,3880,87760.4,592200
9420,154514.9,930650,4830,68154,338450,4590,86360.9,592200
11040,146968.8,930650,5760,62098,338450,5280,84870.8,592200
12660,144729.6,930650,6700,59673.7,338450,5960,85055.9,592200
14280,147735.8,930650,7660,60098.9,338450,6620,87636.9,592200
15880,149115.1,930650,8600,59768,338450,7280,89347.1,592200
18080,150826,930650,9950,58330,338450,8130,92496,592200
20250,155013.8,930650,11280,60313.8,338450,8970,94700,592200
22460,160131.4,930650,12620,64459.6,338450,9840,95671.8,592200
24630,151960.3,930650,13960,65064.5,338450,10670,86895.8,592200
29570,164232.4,930650,16740,63805.9,338450,12830,100426.5,592200
34540,159903.2,930650,19510,61452.9,338450,15030,98450.3,592200
39530,160512,930650,22300,59852.4,338450,17230,100659.6,592200
44540,158137.9,930650,25090,59773.5,338450,19450,98364.4,592200
49310,156021.6,930650,27530,54253.4,338450,21780,101768.2,592200
54120,152201.2,930650,29990,50242.2,338450,24130,101959,592200
58880,131451.6,930650,32410,41621.2,338450,26470,89830.4,592200
63700,141274,930650,34850,43492.4,338450,28850,97781.6,592200
68240,149872.5,930650,36760,41935,338450,31480,107937.5,592200
72870,138127.2,930650,38690,38675.3,338450,34180,99451.9,592200
77410,124126.3,930650,40600,38628.3,338450,36810,85498,592200
82010,136223.7,930650,42520,39979,338450,39490,96244.7,592200
88360,166254.8,930650,45180,48784.8,338450,43180,117470,592200
94660,166060.5,930650,47840,51315.5,338450,46820,114745,592200
101030,195851.6,930650,50470,70968.5,338450,50560,124883.1,592200
107370,228579.2,930650,53130,94074.8,338450,54240,134504.4,592200
113720,251098.6,930650,55890,105316.5,338450,57830,145782.1,592200
119980,245457.3,930650,58640,98901.7,338450,61340,146555.6,592200
126350,245627.3,930650,61400,96809,338450,64950,148818.3,592200
207300,257863.8,930650,111580,118695.6,338450,95720,139168.2,592200
215200,250403.8,930650,115610,118607.6,338450,99590,131796.2,592200
223030,242068.7,930650,119630,115003.8,338450,103400,127064.9,592200
230970,245072.9,930650,123670,113490.7,338450,107300,131582.2,592200
238780,255006.5,930650,127670,117441.9,338450,111110,137564.6,592200
245960,266829.1,930650,130800,112712.9,338450,115160,154116.2,592200
253100,267946,930650,133910,107649,338450,119190,160297,592200
260340,267799.7,930650,137060,106066.2,338450,123280,161733.5,592200
267520,295906.4,930650,140190,123195.1,338450,127330,172711.3,592200
275140,330848,930650,143850,146837.5,338450,131290,184010.5,592200
282710,348606.3,930650,147490,161621.6,338450,135220,186984.7,592200
290350,333995.9,930650,151160,150436.8,338450,139190,183559.1,592200
297920,328756.2,930650,154810,141012.3,338450,143110,187743.9,592200
304880,367883,930650,157860,184734.2,338450,147020,183148.8,592200
311980,381740.6,930650,160950,193701.2,338450,151030,188039.4,592200
318950,376980.9,930650,164020,178570.4,338450,154930,198410.5,592200
325990,371614.4,930650,167090,176873.1,338450,158900,194741.3,592200
331660,385832.8,930650,169080,181327.2,338450,162580,204505.6,592200
337420,395619.1,930650,171100,189571.9,338450,166320,206047.2,592200
343160,453302.9,930650,173120,224838,338450,170040,228464.9,592200
348900,470948.1,930650,175140,233726.5,338450,173760,237221.6,592200
353750,467323.3,930650,176330,223509.8,338450,177420,243813.5,592200
358590,442798.9,930650,177510,216690.9,338450,181080,226108,592200
363460,438917.6,930650,178690,215930.6,338450,184770,222987,592200
368320,447949.5,930650,179900,216500.6,338450,188420,231448.9,592200
374080,475829.9,930650,181580,222291.6,338450,192500,253538.3,592200
379880,482899.6,930650,183280,231013,338450,196600,251886.6,592200
385610,488782.3,930650,184970,240791.7,338450,200640,247990.6,592200
391410,505513.3,930650,186680,250145.5,338450,204730,255367.8,592200
399670,519357.8,930650,189630,253224.6,338450,210040,266133.2,592200
407890,516994.3,930650,192570,248041.2,338450,215320,268953.1,592200
416120,535049.9,930650,195530,251250.6,338450,220590,283799.3,592200
424370,549735.2,930650,198470,254947.6,338450,225900,294787.6,592200
432510,537952.7,930650,201650,246319.1,338450,230860,291633.6,592200
440750,529583.1,930650,204810,241234.9,338450,235940,288348.2,592200
448900,523890.8,930650,207980,238708.3,338450,240920,285182.5,592200
457100,533590.1,930650,211150,237805.6,338450,245950,295784.5,592200
464920,557553.5,930650,214520,246830,338450,250400,310723.5,592200
472680,551387.1,930650,217920,245660.1,338450,254760,305727,592200
480490,551326.1,930650,221300,243771.9,338450,259190,307554.2,592200
488290,540329.7,930650,224680,242791.3,338450,263610,297538.4,592200
496260,541286.3,930650,226630,243205.8,338450,269630,298080.5,592200
504330,543144.4,930650,228610,242356.5,338450,275720,300787.9,592200
512330,580076.9,930650,230580,253776.3,338450,281750,326300.6,592200
520310,612468.3,930650,232500,272231.3,338450,287810,340237,592200
526020,638348.9,930650,233290,284575.5,338450,292730,353773.4,592200
531820,638703.3,930650,234070,280235.7,338450,297750,358467.6,592200
537640,664423,930650,234870,287243.9,338450,302770,377179.1,592200
543360,681860.1,930650,235640,295451.8,338450,307720,386408.3,592200
549780,677728.1,930650,237210,292880.4,338450,312570,384847.7,592200
556160,683001.6,930650,238740,294673.5,338450,317420,388328.1,592200
562550,700608.1,930650,240300,298466,338450,322250,402142.1,592200
568890,709022.3,930650,241840,301812.8,338450,327050,407209.5,592200
574340,685486.9,930650,243260,298287.3,338450,331080,387199.6,592200
579780,660683.5,930650,244680,294494.8,338450,335100,366188.7,592200
585220,676479.5,930650,246080,301462.9,338450,339140,375016.6,592200
590600,674954.7,930650,247470,297216.2,338450,343130,377738.5,592200
597380,635324.5,930650,250170,277601.8,338450,347210,357722.7,592200
604050,629985.2,930650,252860,277827.4,338450,351190,352157.8,592200
610820,639018.6,930650,255550,284771.4,338450,355270,354247.2,592200
617560,649314.9,930650,258250,291759.8,338450,359310,357555.1,592200
622840,634342.9,930650,259690,287464.8,338450,363150,346878.1,592200
628180,637566.2,930650,261150,286015,338450,367030,351551.2,592200
633420,657249.1,930650,262600,279728.6,338450,370820,377520.5,592200
638710,685209.9,930650,264040,294173.6,338450,374670,391036.3,592200
646270,691549.9,930650,266010,282128.8,338450,380260,409421.1,592200
653860,704207.4,930650,267980,282490.2,338450,385880,421717.2,592200
661350,719464.8,930650,269970,291807.6,338450,391380,427657.2,592200
668850,718719.2,930650,271920,293199,338450,396930,425520.2,592200
676710,701958.3,930650,274340,278307.5,338450,402370,423650.8,592200
684450,708390.1,930650,276770,276211,338450,407680,432179.1,592200
692280,708024.5,930650,279170,271661.9,338450,413110,436362.6,592200
700120,702865.6,930650,281610,265418.5,338450,418510,437447.1,592200
707100,704593.8,930650,283460,268252.5,338450,423640,436341.3,592200
714100,706045.6,930650,285300,266183.5,338450,428800,439862.1,592200
721100,719847.9,930650,287140,274124.6,338450,433960,445723.3,592200
728180,732650,930650,289020,277098.1,338450,439160,455551.9,592200
727040,733815.5,930650,288570,274219.4,338450,438470,459596.1,592200
725970,743394.6,930650,288100,278297.4,338450,437870,465097.2,592200
724820,731283.6,930650,287660,277911.3,338450,437160,453372.3,592200
723770,719012.8,930650,287220,274496.1,338450,436550,444516.7,592200
722580,740354.8,930650,286850,274685.8,338450,435730,465669,592200
721430,739468.5,930650,286460,269218.5,338450,434970,470250,592200
720200,706318.6,930650,286070,264003.6,338450,434130,442315,592200
719030,712106.5,930650,285660,265417.6,338450,433370,446688.9,592200
717780,706468.2,930650,285120,270246.2,338450,432660,436222,592200
716510,681972.2,930650,284570,269359.2,338450,431940,412613,592200
715270,688809.6,930650,284010,265091.2,338450,431260,423718.4,592200
714000,685846.8,930650,283410,264219.1,338450,430590,421627.7,592200
707380,685858.2,930650,281500,265439.7,338450,425880,420418.5,592200
700910,677804.3,930650,279590,263927.3,338450,421320,413877,592200
694330,679837.3,930650,277670,264591.5,338450,416660,415245.8,592200
687770,685876.2,930650,275760,266959.3,338450,412010,418916.9,592200
681590,675462.7,930650,273880,267598.3,338450,407710,407864.4,592200
675410,679259.8,930650,271990,269982.2,338450,403420,409277.6,592200
669170,677146,930650,270120,272871.8,338450,399050,404274.2,592200
737040,681035.1,930650,291250,273589.3,338450,445790,407445.8,592200
735570,688572.9,930650,290840,274662.8,338450,444730,413910.1,592200
734150,688222.7,930650,290480,273129.5,338450,443670,415093.2,592200
732710,687693,930650,290080,270789.4,338450,442630,416903.6,592200
731300,675615,930650,289700,265663.9,338450,441600,409951.1,592200
723350,654887.3,930650,287520,258371.2,338450,435830,396516.1,592200
715550,654632.5,930650,285370,257833.5,338450,430180,396799,592200
707700,651665.5,930650,283200,257551.7,338450,424500,394113.8,592200
699890,649008.4,930650,281060,257952.7,338450,418830,391055.7,592200
691940,644158.4,930650,278930,256267.9,338450,413010,387890.5,592200
683960,630457.4,930650,276760,252360.7,338450,407200,378096.7,592200
676060,628620.2,930650,274630,251562.4,338450,401430,377057.8,592200
668110,642106.5,930650,272500,254452.1,338450,395610,387654.4,592200
660260,628841.8,930650,270250,252230.8,338450,390010,376611,592200
652350,619692.2,930650,268020,250368.3,338450,384330,369323.9,592200
644520,613939.3,930650,265790,248029.4,338450,378730,365909.9,592200
636620,605073.4,930650,263570,243387,338450,373050,361686.4,592200
625750,604737.5,930650,260730,242496.3,338450,365020,362241.2,592200
614740,604690.5,930650,257890,240739.1,338450,356850,363951.4,592200
603810,588020.9,930650,255050,234143.2,338450,348760,353877.7,592200
592890,581139.9,930650,252210,234068.5,338450,340680,347071.4,592200
581720,576548.4,930650,249080,233675.6,338450,332640,342872.8,592200
570550,576358.5,930650,245940,235080.8,338450,324610,341277.7,592200
559380,569079.8,930650,242800,233685.4,338450,316580,335394.4,592200
548200,568485,930650,239650,235409.9,338450,308550,333075.1,592200
538230,560729.6,930650,237140,231806.2,338450,301090,328923.4,592200
528180,547814.3,930650,234620,226101.7,338450,293560,321712.6,592200
518270,535738.1,930650,232110,225626.1,338450,286160,310112,592200
508220,528847.2,930650,229580,226542.9,338450,278640,302304.3,592200
501100,523750.5,930650,227760,225389.2,338450,273340,298361.3,592200
493970,511805.7,930650,225930,221778.3,338450,268040,290027.4,592200
486780,504919.8,930650,224070,219897.4,338450,262710,285022.4,592200
479670,512522.1,930650,222260,223623.1,338450,257410,288899,592200
471770,516459,930650,219910,225454.3,338450,251860,291004.7,592200
463850,503251.4,930650,217520,224482.1,338450,246330,278769.3,592200
456020,497472.2,930650,215170,224878.5,338450,240850,272593.7,592200
448070,496759.3,930650,212800,228795.2,338450,235270,267964.1,592200
439660,492242.5,930650,210520,225196.5,338450,229140,267046,592200
431290,487595.2,930650,208240,221979.1,338450,223050,265616.1,592200
422920,466758.3,930650,205940,219515.3,338450,216980,247243,592200
414570,444487,930650,203660,212219.7,338450,210910,232267.3,592200
404510,417433.3,930650,200210,200828,338450,204300,216605.3,592200
394420,412286.9,930650,196750,200277.9,338450,197670,212009,592200
384320,384528.6,930650,193310,195182.2,338450,191010,189346.4,592200
374280,382009.1,930650,189830,192377.6,338450,184450,189631.5,592200
364890,381446.5,930650,186470,193063.9,338450,178420,188382.6,592200
355540,368635.9,930650,183110,187489.2,338450,172430,181146.7,592200
346110,335924.3,930650,179730,176413.7,338450,166380,159510.6,592200
336740,318083.9,930650,176360,174298.7,338450,160380,143785.2,592200
327650,320051.6,930650,173290,175515.7,338450,154360,144535.9,592200
318630,308690.8,930650,170260,169572.2,338450,148370,139118.6,592200
309490,293000.9,930650,167230,166638.6,338450,142260,126362.3,592200
300400,278338,930650,164180,157635.7,338450,136220,120702.3,592200
297940,269872.3,930650,162760,153334.5,338450,135180,116537.8,592200
295480,259182.5,930650,161360,145820.3,338450,134120,113362.2,592200
293020,254113.1,930650,159950,142108.3,338450,133070,112004.8,592200
290570,249810.9,930650,158540,139827.6,338450,132030,109983.3,592200
287830,242841.1,930650,156900,133431.3,338450,130930,109409.8,592200
285100,235699.1,930650,155260,128933.9,338450,129840,106765.2,592200
282380,232105.7,930650,153620,129626.7,338450,128760,102479,592200
279600,226615.3,930650,151980,124609.9,338450,127620,102005.4,592200
277310,222411.9,930650,150640,122486.8,338450,126670,99925.1,592200
275060,217302.8,930650,149300,117120.2,338450,125760,100182.6,592200
272700,220470.8,930650,147940,117185,338450,124760,103285.8,592200
270500,215365.1,930650,146610,115498.7,338450,123890,99866.4,592200
274070,213401.9,930650,147370,112409.2,338450,126700,100992.7,592200
277680,208784.1,930650,148130,111819.8,338450,129550,96964.3,592200
281270,220068.5,930650,148900,117654.3,338450,132370,102414.2,592200
284850,222442.4,930650,149660,117306.8,338450,135190,105135.6,592200
289480,215208.8,930650,151360,113785.8,338450,138120,101423,592200
294210,214231.8,930650,153060,117100.5,338450,141150,97131.3,592200
298890,231092,930650,154740,123665,338450,144150,107427,592200
303600,226511.6,930650,156450,119776.6,338450,147150,106735,592200
308220,213259.1,930650,158320,111682.5,338450,149900,101576.6,592200
312800,207411.8,930650,160180,109609.2,338450,152620,97802.6,592200
317320,209977,930650,162050,110669.9,338450,155270,99307.1,592200
321900,231570.5,930650,163910,118362.6,338450,157990,113207.9,592200
321210,251713.7,930650,163950,129829.5,338450,157260,121884.2,592200
320470,269260.2,930650,163960,141292.5,338450,156510,127967.7,592200
319770,271064.1,930650,163980,145889.1,338450,155790,125175,592200
319050,266040.2,930650,164010,149197.6,338450,155040,116842.6,592200
317240,277684.4,930650,163600,155666.6,338450,153640,122017.8,592200
315620,286525.2,930650,163250,157494,338450,152370,129031.2,592200
313910,289458.9,930650,162840,160435.6,338450,151070,129023.3,592200
312220,292964.3,930650,162480,158702.6,338450,149740,134261.7,592200
311110,288118.2,930650,162010,157442.1,338450,149100,130676.1,592200
309880,287090.2,930650,161560,155192.7,338450,148320,131897.5,592200
308780,297646.1,930650,161100,153576.9,338450,147680,144069.2,592200
307590,296463,930650,160650,149791.1,338450,146940,146671.9,592200
305460,292416.9,930650,159600,145900.9,338450,145860,146516,592200
303380,279512.1,930650,158550,134682.9,338450,144830,144829.2,592200
301340,262037.9,930650,157520,130686.7,338450,143820,131351.2,592200
299240,253671.3,930650,156480,136882.7,338450,142760,116788.6,592200
296770,275644.1,930650,155070,149903.5,338450,141700,125740.6,592200
294240,272079.1,930650,153690,144522.9,338450,140550,127556.2,592200
291710,252667.7,930650,152290,138816.7,338450,139420,113851,592200
213190,258072.5,930650,128310,147343.2,338450,84880,110729.3,592200
209540,259856,930650,126490,152006.6,338450,83050,107849.4,592200
205930,265566.9,930650,124680,159398.7,338450,81250,106168.2,592200
202250,261506.5,930650,122860,155539.6,338450,79390,105966.9,592200
198690,257137.8,930650,121030,153165.1,338450,77660,103972.7,592200
200330,253705,930650,121670,150331.6,338450,78660,103373.4,592200
202020,266465.8,930650,122330,156317,338450,79690,110148.8,592200
203670,263871.9,930650,122960,153552.2,338450,80710,110319.7,592200
205320,265208.9,930650,123610,156096.2,338450,81710,109112.7,592200
206930,264470.1,930650,124270,155338.7,338450,82660,109131.4,592200
208550,275275.1,930650,124940,160902.1,338450,83610,114373,592200
210160,275215.2,930650,125610,157715.5,338450,84550,117499.7,592200
211800,259720.5,930650,126290,146831.1,338450,85510,112889.4,592200
213680,254590.5,930650,127050,143482.9,338450,86630,111107.6,592200
215550,247344.1,930650,127790,137130,338450,87760,110214.1,592200
217470,236564.2,930650,128570,128518.1,338450,88900,108046.1,592200
219310,231976.4,930650,129310,122469.7,338450,90000,109506.7,592200
222590,235889.4,930650,130630,124382.2,338450,91960,111507.2,592200
225810,246324.2,930650,131990,130526.5,338450,93820,115797.7,592200
229110,255612.3,930650,133300,139012,338450,95810,116600.3,592200
232310,268962.7,930650,134600,144404.9,338450,97710,124557.8,592200
234940,274933.7,930650,135270,144923.9,338450,99670,130009.8,592200
237610,268978.6,930650,135960,143824.8,338450,101650,125153.8,592200
240200,280646.7,930650,136580,151671.2,338450,103620,128975.5,592200
242820,281444.8,930650,137250,150389.3,338450,105570,131055.5,592200
245530,292990.7,930650,137880,156011.4,338450,107650,136979.3,592200
248150,292098.6,930650,138500,158269.2,338450,109650,133829.4,592200
250810,305516.3,930650,139110,165816,338450,111700,139700.3,592200
253520,328248.4,930650,139730,171923.7,338450,113790,156324.7,592200
251770,304880.4,930650,139440,168476.8,338450,112330,136403.6,592200
250060,293831,930650,139130,159361.3,338450,110930,134469.7,592200
248380,308137.5,930650,138850,165762.4,338450,109530,142375.1,592200
246700,310010.5,930650,138550,164121.2,338450,108150,145889.3,592200
244150,300734,930650,137460,159345.1,338450,106690,141388.9,592200
241720,273928,930650,136390,147304.7,338450,105330,126623.3,592200
239200,271502.7,930650,135340,140358.3,338450,103860,131144.4,592200
236740,250517.2,930650,134290,129019.4,338450,102450,121497.8,592200
232720,235613.3,930650,132700,114026.8,338450,100020,121586.5,592200
228790,228216.6,930650,131130,104898.3,338450,97660,123318.3,592200
224730,210521,930650,129550,95306.1,338450,95180,115214.9,592200
220800,195202.1,930650,127990,87795.7,338450,92810,107406.4,592200
213040,182497,930650,123300,79535.4,338450,89740,102961.6,592200
205200,163156.2,930650,118630,67199.7,338450,86570,95956.5,592200
197360,156333,930650,113930,62627.5,338450,83430,93705.5,592200
189600,172399.2,930650,109250,69697.3,338450,80350,102701.9,592200
183500,151963.6,930650,105890,62276.4,338450,77610,89687.2,592200
177390,140835.4,930650,102540,56972.7,338450,74850,83862.7,592200
171340,145734.2,930650,99190,59843,338450,72150,85891.2,592200
165210,133208.7,930650,95840,52775.8,338450,69370,80432.9,592200
158880,134316.5,930650,92220,49666.4,338450,66660,84650.1,592200
152480,129792.1,930650,88580,49801.3,338450,63900,79990.8,592200
146140,121638.5,930650,84950,43655.4,338450,61190,77983.1,592200
139720,123225.9,930650,81320,42898.8,338450,58400,80327.1,592200
140230,127229.3,930650,80450,41834.3,338450,59780,85395,592200
140740,134666.2,930650,79580,46819.2,338450,61160,87847,592200
141250,134557.5,930650,78700,47067.3,338450,62550,87490.2,592200
141780,135585.9,930650,77840,44999.5,338450,63940,90586.4,592200
140530,134231.4,930650,75470,40438.8,338450,65060,93792.6,592200
139250,125103.9,930650,73140,34766.6,338450,66110,90337.3,592200
137920,126866.4,930650,70750,37851.3,338450,67170,89015.1,592200
136670,122409.9,930650,68420,37450,338450,68250,84959.9,592200
137650,126828.9,930650,68330,37034.1,338450,69320,89794.8,592200
138550,131217.1,930650,68240,37140.3,338450,70310,94076.8,592200
139520,128728.3,930650,68170,39292.7,338450,71350,89435.6,592200
140450,133733.5,930650,68080,41377,338450,72370,92356.5,592200
142790,129167.6,930650,69330,36574.5,338450,73460,92593.1,592200
145130,130783.8,930650,70580,39931.8,338450,74550,90852,592200
147450,124647.6,930650,71820,36445.6,338450,75630,88202,592200
149710,123011.3,930650,73070,34578.2,338450,76640,88433.1,592200
152200,113117.5,930650,74080,28455.5,338450,78120,84662,592200
154640,114952.9,930650,75080,29705.5,338450,79560,85247.4,592200
157180,108911.3,930650,76090,28825.5,338450,81090,80085.8,592200
159570,112336.3,930650,77090,32846.2,338450,82480,79490.1,592200
161830,131296.2,930650,78170,49786.7,338450,83660,81509.5,592200
164080,122195.6,930650,79280,44802,338450,84800,77393.6,592200
166260,104256.9,930650,80370,33765.3,338450,85890,70491.6,592200
168450,106217.4,930650,81470,35437.4,338450,86980,70780,592200
164960,111973.8,930650,79850,39169.6,338450,85110,72804.2,592200
161440,117484.6,930650,78260,43806.1,338450,83180,73678.5,592200
158000,138278.1,930650,76660,55834.1,338450,81340,82444,592200
154520,104857.7,930650,75060,32016.7,338450,79460,72841,592200
150690,106077,930650,73310,33383.9,338450,77380,72693.1,592200
146910,131678.6,930650,71570,54451.4,338450,75340,77227.2,592200
143120,152483.9,930650,69810,69495.7,338450,73310,82988.2,592200
139360,152042,930650,68090,69844.6,338450,71270,82197.4,592200
134050,163534.1,930650,65160,76402,338450,68890,87132.1,592200
128790,146750.5,930650,62240,63415.3,338450,66550,83335.2,592200
123510,136371.6,930650,59350,57779.4,338450,64160,78592.2,592200
118310,121086.1,930650,56430,48471.1,338450,61880,72615,592200
112350,114340.6,930650,53510,43788.4,338450,58840,70552.2,592200
106400,106830,930650,50570,38252.3,338450,55830,68577.7,592200
100400,95698,930650,47640,30406.9,338450,52760,65291.1,592200
94420,86443.2,930650,44690,23654,338450,49730,62789.2,592200
89220,85308.8,930650,42220,22602.4,338450,47000,62706.4,592200
84000,81777.8,930650,39760,19902.5,338450,44240,61875.3,592200
78840,79399.7,930650,37290,17720.5,338450,41550,61679.2,592200
66430,76269.5,930650,34120,15255.2,338450,32310,61014.3,592200
61370,75329.6,930650,30340,13371.2,338450,31030,61958.4,592200
56340,74812.1,930650,26540,12244.8,338450,29800,62567.3,592200
51270,75706.9,930650,22770,12557.5,338450,28500,63149.4,592200
46230,72760.7,930650,18990,9736.7,338450,27240,63024,592200
45770,66732.8,930650,18570,5951.1,338450,27200,60781.7,592200
45390,66598.2,930650,18180,5565,338450,27210,61033.2,592200
44880,66335.3,930650,17770,5386.5,338450,27110,60948.8,592200
44460,66281.7,930650,17390,5276.1,338450,27070,61005.6,592200
43930,65702.9,930650,16660,5091.1,338450,27270,60611.8,592200
43280,65718,930650,15920,4847,338450,27360,60871,592200
42630,66471.6,930650,15170,4847,338450,27460,61624.6,592200
42050,67715,930650,14420,4843.2,338450,27630,62871.8,592200
41310,67318.9,930650,13500,4959.1,338450,27810,62359.8,592200
40590,68101.7,930650,12610,5245.5,338450,27980,62856.2,592200
39870,68433.8,930650,11680,5382.9,338450,28190,63050.9,592200
39120,68256.1,930650,10780,5213.6,338450,28340,63042.5,592200
38700,68281.1,930650,10670,5083,338450,28030,63198.1,592200
38360,67658.2,930650,10610,4766.8,338450,27750,62891.4,592200
37920,68270.7,930650,10530,4451,338450,27390,63819.7,592200
37470,66958.8,930650,10430,4401,338450,27040,62557.8,592200
36920,66405.2,930650,10160,4313.5,338450,26760,62091.7,592200
36340,65915.3,930650,9870,4113.5,338450,26470,61801.8,592200
35770,65437.2,930650,9580,4001,338450,26190,61436.2,592200
35250,66137.6,930650,9300,4001,338450,25950,62136.6,592200
34500,66220.7,930650,8890,4001,338450,25610,62219.7,592200
33840,66648.4,930650,8490,4001,338450,25350,62647.4,592200
33180,66131.4,930650,8090,3951,338450,25090,62180.4,592200
32520,67565.9,930650,7660,4001,338450,24860,63564.9,592200
31390,66984.8,930650,7580,4001,338450,23810,62983.8,592200
30190,68539.4,930650,7460,4518,338450,22730,64021.4,592200
29040,70144.3,930650,7370,5752.5,338450,21670,64391.8,592200
27940,70900.8,930650,7290,6582.4,338450,20650,64318.4,592200
26950,80737.9,930650,7370,14154.6,338450,19580,66583.3,592200
26010,75656.1,930650,7460,10456,338450,18550,65200.1,592200
25010,71855.6,930650,7530,7758.1,338450,17480,64097.5,592200
24010,71795.3,930650,7580,7685.1,338450,16430,64110.2,592200
22980,71947,930650,7570,7597.2,338450,15410,64349.8,592200
21860,70771.6,930650,7540,7076.5,338450,14320,63695.1,592200
20810,69013.7,930650,7510,6315.7,338450,13300,62698,592200
19760,70026.1,930650,7490,6603.6,338450,12270,63422.5,592200
19830,73928.9,930650,7870,9779.3,338450,11960,64149.6,592200
19950,75376.8,930650,8270,11133.8,338450,11680,64243,592200
20070,77936.9,930650,8680,12880.7,338450,11390,65056.2,592200
20160,82527.1,930650,9060,16263.1,338450,11100,66264,592200
19220,85191.2,930650,8590,17557.5,338450,10630,67633.7,592200
18250,83562.9,930650,8090,16553.3,338450,10160,67009.6,592200
17220,83198.4,930650,7610,16303,338450,9610,66895.4,592200
16320,78791.3,930650,7130,14012.2,338450,9190,64779.1,592200
15730,77242.9,930650,6910,12449.8,338450,8820,64793.1,592200
15210,80681.4,930650,6700,13219.5,338450,8510,67461.9,592200
14570,87456.3,930650,6490,17994.5,338450,8080,69461.8,592200
14050,89462.7,930650,6270,18877.7,338450,7780,70585,592200
14170,89068,930650,6400,17680.8,338450,7770,71387.2,592200
14350,87134.6,930650,6550,15665.1,338450,7800,71469.5,592200
14480,88032,930650,6690,17158.6,338450,7790,70873.4,592200
14700,87427.2,930650,6840,18091.6,338450,7860,69335.6,592200
14910,84892.9,930650,7060,17037.9,338450,7850,67855,592200
15080,84332.8,930650,7250,16277,338450,7830,68055.8,592200
15300,90030.8,930650,7470,19951.7,338450,7830,70079.1,592200
15440,99565.3,930650,7650,26570.3,338450,7790,72995,592200
15420,105986.1,930650,7670,30032.5,338450,7750,75953.6,592200
15420,105595.4,930650,7680,27534.4,338450,7740,78061,592200
15390,105836,930650,7690,27505.1,338450,7700,78330.9,592200
15370,110080.2,930650,7710,29390.6,338450,7660,80689.6,592200
19800,120474.9,930650,10080,37029.6,338450,9720,83445.3,592200
24310,132441.4,930650,12450,46715.4,338450,11860,85726,592200
28840,150705.2,930650,14840,59023,338450,14000,91682.2,592200
33330,167818.1,930650,17260,71525.9,338450,16070,96292.2,592200
37840,171290.2,930650,19530,73539.9,338450,18310,97750.3,592200
42380,171567.5,930650,21810,71231.9,338450,20570,100335.6,592200
46910,178728,930650,24090,72624,338450,22820,106104,592200
51410,177131.6,930650,26370,70782,338450,25040,106349.6,592200
56290,177988.1,930650,28860,69708,338450,27430,108280.1,592200
61100,189282.2,930650,31330,75476.6,338450,29770,113805.6,592200
66030,202109.9,930650,33810,88609.1,338450,32220,113500.8,592200
70920,219549.6,930650,36280,103644.1,338450,34640,115905.5,592200
80450,259535.8,930650,42210,120780.1,338450,38240,138755.7,592200
90030,250088.9,930650,48100,124612.5,338450,41930,125476.4,592200
99590,232335.1,930650,54010,113937.4,338450,45580,118397.7,592200
109110,243650,930650,59920,120175.8,338450,49190,123474.2,592200
118820,272197.6,930650,65790,123175.3,338450,53030,149022.3,592200
128500,281735.4,930650,71660,122926.1,338450,56840,158809.3,592200
138230,295499.4,930650,77570,131562.5,338450,60660,163936.9,592200
147920,306765.7,930650,83410,148685.3,338450,64510,158080.4,592200
157080,333838.3,930650,88550,164898.2,338450,68530,168940.1,592200
166230,355629.4,930650,93670,179396.5,338450,72560,176232.9,592200
175470,384012.8,930650,98820,198242,338450,76650,185770.8,592200
184630,405249.1,930650,103950,209176.3,338450,80680,196072.8,592200
193560,422944.4,930650,108850,212145.8,338450,84710,210798.6,592200
202500,436480.5,930650,113750,214118.7,338450,88750,222361.8,592200
211420,441358.6,930650,118650,217877.9,338450,92770,223480.7,592200
220370,456848.3,930650,123530,224261.7,338450,96840,232586.6,592200
229030,481671.9,930650,128500,230297.5,338450,100530,251374.4,592200
237730,497892.7,930650,133500,233356,338450,104230,264536.7,592200
246440,489131.2,930650,138480,233783.3,338450,107960,255347.9,592200
414930,489914,930650,213350,233988.1,338450,201580,255925.9,592200
427610,501031.7,930650,218170,233234.2,338450,209440,267797.5,592200
440360,514652.4,930650,222980,233352.9,338450,217380,281299.5,592200
453050,532929.4,930650,227790,235536.9,338450,225260,297392.5,592200
465830,537241.2,930650,232610,235900.3,338450,233220,301340.9,592200
473190,532029.1,930650,233900,234147.3,338450,239290,297881.8,592200
480620,530174.1,930650,235170,235622.8,338450,245450,294551.3,592200
487930,529577.1,930650,236420,236351.5,338450,251510,293225.6,592200
495260,528242.6,930650,237680,237554.4,338450,257580,290688.2,592200
502450,541789.7,930650,239790,239976.6,338450,262660,301813.1,592200
509550,547908.7,930650,241890,239863.7,338450,267660,308045,592200
516650,560166.8,930650,243990,240593,338450,272660,319573.8,592200
523790,567848.4,930650,246090,243889.6,338450,277700,323958.8,592200
532510,580742.6,930650,248050,247919.4,338450,284460,332823.2,592200
541280,602485.2,930650,249990,257204,338450,291290,345281.2,592200
550010,618581.7,930650,251930,263118.2,338450,298080,355463.5,592200
558700,613722.7,930650,253860,256739.8,338450,304840,356982.9,592200
567960,615956.2,930650,255950,255925.1,338450,312010,360031.1,592200
577150,621698.4,930650,258000,257803.6,338450,319150,363894.8,592200
586340,647486.1,930650,260050,263088.5,338450,326290,384397.6,592200
595610,656492.3,930650,262130,260169.7,338450,333480,396322.6,592200
603250,670316.8,930650,263710,264016.9,338450,339540,406299.9,592200
610920,673434.9,930650,265330,262686.7,338450,345590,410748.2,592200
618590,683707.1,930650,266910,268128.4,338450,351680,415578.7,592200
626270,674546.3,930650,268510,270721,338450,357760,403825.3,592200
634090,692661.4,930650,270240,277301.5,338450,363850,415359.9,592200
641840,690996.7,930650,271970,270055.9,338450,369870,420940.8,592200
649640,704425,930650,273710,272187.7,338450,375930,432237.3,592200
657420,700066.3,930650,275450,270870.4,338450,381970,429195.9,592200
662100,701966.9,930650,276860,273618.5,338450,385240,428348.4,592200
666580,709320.2,930650,278260,279733.3,338450,388320,429586.9,592200
671200,713516.2,930650,279680,282272.4,338450,391520,431243.8,592200
675670,707645.3,930650,281080,277084.2,338450,394590,430561.1,592200
679540,728405.2,930650,282420,286390.7,338450,397120,442014.5,592200
683380,753976.1,930650,283800,300078.2,338450,399580,453897.9,592200
687200,776121.4,930650,285160,309558.4,338450,402040,466563,592200
691070,768975.3,930650,286520,305178.3,338450,404550,463797,592200
694610,755551.4,930650,287820,297319.4,338450,406790,458232,592200
698170,754596,930650,289100,293340.7,338450,409070,461255.3,592200
701710,727516.3,930650,290410,286023.4,338450,411300,441492.9,592200
705250,691842.6,930650,291690,277436.8,338450,413560,414405.8,592200
702120,673034,930650,290150,272843.4,338450,411970,400190.6,592200
699030,666638.4,930650,288600,269579.3,338450,410430,397059.1,592200
695990,650448.8,930650,287060,258753.1,338450,408930,391695.7,592200
692850,664826.3,930650,285520,262387.7,338450,407330,402438.6,592200
689540,639605.2,930650,283900,252112.7,338450,405640,387492.5,592200
686150,612693.2,930650,282280,235975.8,338450,403870,376717.4,592200
682760,599746.1,930650,280630,234463.9,338450,402130,365282.2,592200
679350,610551.1,930650,279000,248904.9,338450,400350,361646.2,592200
674420,620192.2,930650,276090,262013.5,338450,398330,358178.7,592200
669460,632540.4,930650,273150,272902.5,338450,396310,359637.9,592200
664480,653310.5,930650,270230,282775.3,338450,394250,370535.2,592200
659510,659350.1,930650,267300,293791.7,338450,392210,365558.4,592200
644820,661731.6,930650,259420,294922.8,338450,385400,366808.8,592200
630030,659232.7,930650,251530,290509.9,338450,378500,368722.8,592200
615320,625366.6,930650,243650,273773.8,338450,371670,351592.8,592200
600560,596544.2,930650,235750,255738.9,338450,364810,340805.3,592200
586860,512971.6,930650,229460,213698.2,338450,357400,299273.4,592200
573050,487906.6,930650,223120,199289.8,338450,349930,288616.8,592200
559380,454299.3,930650,216830,186173.1,338450,342550,268126.2,592200
545590,457208,930650,210500,191883.6,338450,335090,265324.4,592200
528810,456764.5,930650,201550,197720.7,338450,327260,259043.8,592200
512020,432269.6,930650,192560,188173.9,338450,319460,244095.7,592200
495250,378701.7,930650,183560,159585.1,338450,311690,219116.6,592200
478520,333402.5,930650,174580,135164.2,338450,303940,198238.3,592200
458420,316280.1,930650,166160,118767.6,338450,292260,197512.5,592200
438350,304952,930650,157780,110398.2,338450,280570,194553.8,592200
418250,283167.2,930650,149380,99670.9,338450,268870,183496.3,592200
398190,274046.3,930650,140970,92906.9,338450,257220,181139.4,592200
379780,281438.1,930650,133360,85974.9,338450,246420,195463.2,592200
361450,241933.9,930650,125720,69010.1,338450,235730,172923.8,592200
343060,228956,930650,118110,67204.8,338450,224950,161751.2,592200
324660,217431.4,930650,110500,62281.4,338450,214160,155150,592200
306240,214556.1,930650,102590,64941.3,338450,203650,149614.8,592200
287660,223189,930650,94680,77152.4,338450,192980,146036.6,592200
269260,211590,930650,86770,71814,338450,182490,139776,592200
250700,206412.9,930650,78850,70832.7,338450,171850,135580.2,592200
240290,194395.4,930650,76490,64022.7,338450,163800,130372.7,592200
229750,184007.7,930650,74120,62216,338450,155630,121791.7,592200
219250,182378.8,930650,71760,54772.5,338450,147490,127606.3,592200
208790,166833.3,930650,69380,46784.3,338450,139410,120049,592200
198630,163883.5,930650,66990,48466.7,338450,131640,115416.8,592200
188540,141747.6,930650,64570,40486.9,338450,123970,101260.7,592200
178450,140862,930650,62190,45318.1,338450,116260,95543.9,592200
168310,166986.3,930650,59790,57341.3,338450,108520,109645,592200
158680,178295.5,930650,57640,67420.9,338450,101040,110874.6,592200
149070,199962,930650,55520,77317.9,338450,93550,122644.1,592200
139390,202560,930650,53360,77820.6,338450,86030,124739.4,592200
129780,194567.8,930650,51240,77802.9,338450,78540,116764.9,592200
125090,180135.5,930650,50020,76925.7,338450,75070,103209.8,592200
120450,190870.8,930650,48790,78884.5,338450,71660,111986.3,592200
115780,198845.2,930650,47580,82764.9,338450,68200,116080.3,592200
111140,179260.2,930650,46370,68723.7,338450,64770,110536.5,592200
106880,152078,930650,45580,50067.8,338450,61300,102010.2,592200
102650,153630.9,930650,44830,52507.2,338450,57820,101123.7,592200
98430,150673.9,930650,44040,51358,338450,54390,99315.9,592200
178360,154110.1,930650,88530,60110.3,338450,89830,93999.8,592200
176650,151511.5,930650,88750,62306.9,338450,87900,89204.6,592200
174930,116307.3,930650,88950,53152.6,338450,85980,63154.7,592200
173260,131827.3,930650,89190,47566.4,338450,84070,84260.9,592200
171500,125311.2,930650,89390,55903.1,338450,82110,69408.1,592200
171230,147069.5,930650,88590,61791.5,338450,82640,85278,592200
170900,155870.7,930650,87780,66418.9,338450,83120,89451.8,592200
170590,148395.1,930650,86970,58449.7,338450,83620,89945.4,592200
170270,143451.7,930650,86150,51282.4,338450,84120,92169.3,592200
170150,125861.6,930650,85700,43583.9,338450,84450,82277.7,592200
170020,131647.1,930650,85240,45899.8,338450,84780,85747.3,592200
169960,142441.9,930650,84800,51806.3,338450,85160,90635.6,592200
169820,140449.6,930650,84350,48467,338450,85470,91982.6,592200
171150,129116.2,930650,85240,41378.7,338450,85910,87737.5,592200
172570,131185.8,930650,86140,44662.9,338450,86430,86522.9,592200
173870,137072.6,930650,87050,49400.8,338450,86820,87671.8,592200
175250,128748,930650,87960,42514.9,338450,87290,86233.1,592200
173340,122210.9,930650,87080,38854.9,338450,86260,83356,592200
171370,124610.5,930650,86230,41127.3,338450,85140,83483.2,592200
169410,130865.7,930650,85370,39918.3,338450,84040,90947.4,592200
167480,140855.1,930650,84530,44301.7,338450,82950,96553.4,592200
164610,140236.5,930650,82600,42419,338450,82010,97817.5,592200
161780,131791.9,930650,80680,37060.8,338450,81100,94731.1,592200
158860,132048.5,930650,78710,37716.9,338450,80150,94331.6,592200
155960,132765.8,930650,76770,39427.9,338450,79190,93337.9,592200
153750,137207.7,930650,75770,43880.2,338450,77980,93327.5,592200
151460,134889.6,930650,74760,42677.1,338450,76700,92212.5,592200
149330,138438.5,930650,73790,43416.3,338450,75540,95022.2,592200
147040,135190.8,930650,72760,43013.3,338450,74280,92177.5,592200
143270,133627.8,930650,70620,39238.1,338450,72650,94389.7,592200
139490,153237.1,930650,68460,49085,338450,71030,104152.1,592200
135730,158119.9,930650,66340,55836.9,338450,69390,102283,592200
131960,147500.3,930650,64200,46648.6,338450,67760,100851.7,592200
129960,137965.1,930650,63660,41799.5,338450,66300,96165.6,592200
128020,134670.1,930650,63130,39491.7,338450,64890,95178.4,592200
126010,136649.5,930650,62580,41366.9,338450,63430,95282.6,592200
124010,130304.3,930650,62060,38160.8,338450,61950,92143.5,592200
121860,133182.7,930650,60930,38900.8,338450,60930,94281.9,592200
119680,125862.5,930650,59780,34068.3,338450,59900,91794.2,592200
117470,122131.1,930650,58640,33469.9,338450,58830,88661.2,592200
115320,70586.9,930650,57520,20869.4,338450,57800,49717.5,592200
114040,68280.1,930650,56150,21792.8,338450,57890,46487.3,592200
112720,66927.8,930650,54820,21413.4,338450,57900,45514.4,592200
111390,65076.8,930650,53460,18330.6,338450,57930,46746.2,592200
110120,61397.3,930650,52120,15064.4,338450,58000,46332.9,592200
107760,98409.1,930650,50280,21303.5,338450,57480,77105.6,592200
105320,103395.9,930650,48430,23997.1,338450,56890,79398.8,592200
102860,103654.7,930650,46570,26204.5,338450,56290,77450.2,592200
100490,102266.4,930650,44730,25084.2,338450,55760,77182.2,592200
98860,106639.8,930650,43490,26220.3,338450,55370,80419.5,592200
97190,103434.5,930650,42270,23710.8,338450,54920,79723.7,592200
95580,106615,930650,41050,25955.1,338450,54530,80659.9,592200
93990,109657.3,930650,39860,28125.6,338450,54130,81531.7,592200
92990,112556.5,930650,38910,29040,338450,54080,83516.5,592200
92000,110633.9,930650,37980,30024,338450,54020,80609.9,592200
91050,112603.1,930650,37040,28361.2,338450,54010,84241.9,592200
90140,111818.1,930650,36130,27519.9,338450,54010,84298.2,592200
90050,111515.9,930650,35680,27058.1,338450,54370,84457.8,592200
89920,111355.7,930650,35220,27716.5,338450,54700,83639.2,592200
89850,107161.6,930650,34790,24193.8,338450,55060,82967.8,592200
89730,96881.2,930650,34350,20586.7,338450,55380,76294.5,592200
89950,99974.4,930650,34260,18391.1,338450,55690,81583.3,592200
90300,103408.1,930650,34130,19477.6,338450,56170,83930.5,592200
90540,105808.7,930650,34020,21327.6,338450,56520,84481.1,592200
90790,101731.2,930650,33930,19055,338450,56860,82676.2,592200
89230,100827.1,930650,32680,18572.7,338450,56550,82254.4,592200
87700,103605.2,930650,31450,19443,338450,56250,84162.2,592200
86070,108337.2,930650,30200,21350.1,338450,55870,86987.1,592200
84520,106944.7,930650,28970,20675.1,338450,55550,86269.6,592200
82750,112580.7,930650,27910,24512.1,338450,54840,88068.6,592200
81010,112725.8,930650,26910,24311.3,338450,54100,88414.5,592200
79320,112064,930650,25880,22880.7,338450,53440,89183.3,592200
77590,111642.2,930650,24860,21107.7,338450,52730,90534.5,592200
75900,112658.9,930650,24030,21180,338450,51870,91478.9,592200
74310,116009.3,930650,23200,23192.9,338450,51110,92816.4,592200
72660,113572.4,930650,22360,21413.2,338450,50300,92159.2,592200
71000,111187.5,930650,21520,20725.1,338450,49480,90462.4,592200
69300,108606.9,930650,20430,20147.3,338450,48870,88459.6,592200
67610,109492.7,930650,19370,22199.5,338450,48240,87293.2,592200
65930,114594.8,930650,18280,26811.1,338450,47650,87783.7,592200
64240,111146.4,930650,17220,23822.9,338450,47020,87323.5,592200
62840,105392.7,930650,16370,19741.3,338450,46470,85651.4,592200
61470,100451.7,930650,15520,17675.6,338450,45950,82776.1,592200
60070,103180.4,930650,14660,19141.4,338450,45410,84039,592200
58670,105364.7,930650,13810,20346.2,338450,44860,85018.5,592200
57740,104473.9,930650,13310,17377.1,338450,44430,87096.8,592200
56770,103893.7,930650,12780,16643.2,338450,43990,87250.5,592200
55800,100581,930650,12290,13313.5,338450,43510,87267.5,592200
54800,97846.5,930650,11770,11355.8,338450,43030,86490.7,592200
54250,93718.4,930650,11620,8094.2,338450,42630,85624.2,592200
53570,92445.5,930650,11460,7141,338450,42110,85304.5,592200
53020,93407.6,930650,11320,7566.6,338450,41700,85841,592200
52340,92440.9,930650,11150,8268.9,338450,41190,84172,592200
51670,93703.3,930650,10880,9316.2,338450,40790,84387.1,592200
50900,93328.2,930650,10620,9242.4,338450,40280,84085.8,592200
50140,92360.2,930650,10350,7848.1,338450,39790,84512.1,592200
38260,97814.5,930650,6300,11352.4,338450,31960,86462.1,592200
36800,97442.9,930650,5760,11644.5,338450,31040,85798.4,592200
35310,97867.8,930650,5220,11702.4,338450,30090,86165.4,592200
33820,94205.7,930650,4670,10497.9,338450,29150,83707.8,592200
32340,88724,930650,4160,7913.8,338450,28180,80810.2,592200
32880,86590.9,930650,4280,6840.5,338450,28600,79750.4,592200
33350,86068.1,930650,4450,6907.6,338450,28900,79160.5,592200
33890,84471,930650,4580,6705.1,338450,29310,77765.9,592200
34350,83976.9,930650,4710,6543.3,338450,29640,77433.6,592200
34970,83823.8,930650,4820,6679.8,338450,30150,77144,592200
35600,80980.4,930650,4950,5887.9,338450,30650,75092.5,592200
36170,79999.3,930650,5060,5834.2,338450,31110,74165.1,592200
36760,78568,930650,5180,5591.2,338450,31580,72976.8,592200
36690,76770.8,930650,5210,5247.1,338450,31480,71523.7,592200
36700,76362.3,930650,5250,5016.1,338450,31450,71346.2,592200
36660,76830.4,930650,5290,4930.5,338450,31370,71899.9,592200
36560,75592.5,930650,5300,4828.2,338450,31260,70764.3,592200
35740,74287.5,930650,5330,4738.5,338450,30410,69549,592200
34860,72238.7,930650,5360,4451,338450,29500,67787.7,592200
34030,71412.1,930650,5380,4401.1,338450,28650,67011,592200
33180,71062.5,930650,5380,4510.6,338450,27800,66551.9,592200
31870,71467.1,930650,4970,4778.9,338450,26900,66688.2,592200
30580,68218.2,930650,4560,4767.5,338450,26020,63450.7,592200
29340,71805,930650,4180,5210.4,338450,25160,66594.6,592200
28060,71564.7,930650,3780,5063.7,338450,24280,66501,592200
27180,71272.1,930650,3510,4865.1,338450,23670,66407,592200
26300,73630.1,930650,3240,6751.6,338450,23060,66878.5,592200
25410,72509.1,930650,3000,5487,338450,22410,67022.1,592200
24510,73127.3,930650,2740,4867.3,338450,21770,68260,592200
23620,72241.2,930650,2680,4764.3,338450,20940,67476.9,592200
22690,72284.4,930650,2610,4801.1,338450,20080,67483.3,592200
21760,72686.5,930650,2530,4801,338450,19230,67885.5,592200
20860,71859.2,930650,2470,4813.5,338450,18390,67045.7,592200
20000,71457.9,930650,2370,4817.7,338450,17630,66640.2,592200
19120,71519.7,930650,2240,4801,338450,16880,66718.7,592200
18230,71239.7,930650,2130,4815.3,338450,16100,66424.4,592200
17340,71423.7,930650,2020,4926,338450,15320,66497.7,592200
16280,71812.2,930650,1950,5001,338450,14330,66811.2,592200
15160,72181.8,930650,1890,5051,338450,13270,67130.8,592200
14110,72196.5,930650,1800,5126,338450,12310,67070.5,592200
13080,71490.9,930650,1740,5126,338450,11340,66364.9,592200
12030,71640.4,930650,1650,5115.3,338450,10380,66525.1,592200
10940,70158.7,930650,1530,5026,338450,9410,65132.7,592200
9890,69310.2,930650,1420,4901,338450,8470,64409.2,592200
8810,68934.9,930650,1300,4913.5,338450,7510,64021.4,592200
7820,67914.3,930650,1140,4851,338450,6680,63063.3,592200
6860,67982.3,930650,1000,4913.5,338450,5860,63068.8,592200
5850,67449.6,930650,850,4901,338450,5000,62548.6,592200
4850,67452.4,930650,700,4901,338450,4150,62551.4,592200
4340,67419.7,930650,590,4917.7,338450,3750,62502,592200
3780,67294.7,930650,490,4976,338450,3290,62318.7,592200
3230,67177.9,930650,410,5001,338450,2820,62176.9,592200
2640,66999.7,930650,280,5001,338450,2360,61998.7,592200
2450,66599.8,930650,280,5001,338450,2170,61598.8,592200
2260,65936.4,930650,290,4926,338450,1970,61010.4,592200
2060,64111,930650,290,4801,338450,1770,59310,592200
1830,63503.7,930650,280,4776,338450,1550,58727.7,592200
1680,62183.8,930650,290,4676,338450,1390,57507.8,592200
1510,64463.2,930650,300,4801,338450,1210,59662.2,592200
1360,64284.1,930650,300,4801,338450,1060,59483.1,592200
1200,64287.1,930650,310,4801,338450,890,59486.1,592200
1160,64278.7,930650,320,4801,338450,840,59477.7,592200
1090,62919.8,930650,340,4726,338450,750,58193.8,592200
1050,61235.9,930650,340,4601,338450,710,56634.9,592200
950,61315.9,930650,350,4601,338450,600,56714.9,592200
930,61357.2,930650,320,4638.5,338450,610,56718.7,592200
910,58774.2,930650,310,4501,338450,600,54273.2,592200
840,61807,930650,270,4726,338450,570,57081,592200
840,63922.3,930650,250,4851,338450,590,59071.3,592200
810,64420,930650,220,4901,338450,590,59519,592200
750,64392.3,930650,190,4901,338450,560,59491.3,592200
770,64780.9,930650,170,4901,338450,600,59879.9,592200
770,64887.3,930650,150,4926,338450,620,59961.3,592200
770,64837.3,930650,130,5001,338450,640,59836.3,592200
760,64986.3,930650,120,5001,338450,640,59985.3,592200
740,64970.7,930650,110,5001,338450,630,59969.7,592200
740,64917.8,930650,80,5001,338450,660,59916.8,592200
810,64809.8,930650,100,5001,338450,710,59808.8,592200
840,64849.8,930650,90,5001,338450,750,59848.8,592200
900,65083.4,930650,110,5001,338450,790,60082.4,592200
950,65209.2,930650,120,5001,338450,830,60208.2,592200
1000,65288.7,930650,130,5001,338450,870,60287.7,592200
1060,65368,930650,130,5001,338450,930,60367,592200
1130,65270.8,930650,130,5001,338450,1000,60269.8,592200
1250,65132.3,930650,140,5001,338450,1110,60131.3,592200
1260,65221.2,930650,140,5001,338450,1120,60220.2,592200
1290,65367.8,930650,150,5001,338450,1140,60366.8,592200
1330,65545,930650,160,5001,338450,1170,60544,592200
1420,65708.1,930650,170,5001,338450,1250,60707.1,592200
1560,66086.3,930650,210,5001,338450,1350,61085.3,592200
1680,66153.8,930650,280,5001,338450,1400,61152.8,592200
1840,66640.2,930650,330,5063.5,338450,1510,61576.7,592200
1960,66882.5,930650,380,5101,338450,1580,61781.5,592200
2060,66851.3,930650,420,5101,338450,1640,61750.3,592200
2190,66657,930650,480,5101,338450,1710,61556,592200
2290,66811.1,930650,540,5129.6,338450,1750,61681.5,592200
6770,67699.8,930650,1740,5276,338450,5030,62423.8,592200
7130,68275.1,930650,1810,5301,338450,5320,62974.1,592200
7560,68055.1,930650,1900,5301,338450,5660,62754.1,592200
7990,68713.6,930650,1980,5301,338450,6010,63412.6,592200
8400,69935.4,930650,2050,5413.5,338450,6350,64521.9,592200
8970,69455.8,930650,2210,5426,338450,6760,64029.8,592200
9450,69234.3,930650,2360,5488.5,338450,7090,63745.8,592200
9970,69765.7,930650,2530,5500.8,338450,7440,64264.9,592200
10520,70327.3,930650,2700,5501,338450,7820,64826.3,592200
11030,69855.8,930650,2880,5728.5,338450,8150,64127.3,592200
11550,71485.4,930650,3060,6756.2,338450,8490,64729.2,592200
12070,72570.6,930650,3250,7233.3,338450,8820,65337.3,592200
12590,73561.5,930650,3420,7417.5,338450,9170,66144,592200
13110,74698.6,930650,3630,8049.3,338450,9480,66649.3,592200
13650,75193.7,930650,3830,7417.1,338450,9820,67776.6,592200
14150,75752,930650,4020,6691.6,338450,10130,69060.4,592200
14640,75063.1,930650,4200,6557.8,338450,10440,68505.3,592200
16800,73425.4,930650,4730,6044,338450,12070,67381.4,592200
18960,75305.1,930650,5280,6191.1,338450,13680,69114,592200
21070,77543.2,930650,5790,6285.1,338450,15280,71258.1,592200
23170,80457.3,930650,6350,6676.1,338450,16820,73781.2,592200
25310,81091.3,930650,6860,7137,338450,18450,73954.3,592200
27370,82004.5,930650,7330,7595.3,338450,20040,74409.2,592200
29440,85849.2,930650,7820,8858,338450,21620,76991.2,592200
31540,88462.5,930650,8300,9350.6,338450,23240,79111.9,592200
33740,86792.2,930650,8800,9165.7,338450,24940,77626.5,592200
35980,85457.1,930650,9290,8660.6,338450,26690,76796.5,592200
38210,87772.7,930650,9780,10066.5,338450,28430,77706.2,592200
40430,87653.5,930650,10270,10340.6,338450,30160,77312.9,592200
42760,88389.8,930650,11890,10723.3,338450,30870,77666.5,592200
45120,96466.3,930650,13490,14573.3,338450,31630,81893,592200
47430,96485.5,930650,15090,12820,338450,32340,83665.5,592200
49820,97254.5,930650,16700,14285.4,338450,33120,82969.1,592200
52240,94709.9,930650,18360,14592.3,338450,33880,80117.6,592200
54630,96086.9,930650,20030,15521,338450,34600,80565.9,592200
57000,88692.9,930650,21710,12799.7,338450,35290,75893.2,592200
59360,87029.1,930650,23360,12483.8,338450,36000,74545.3,592200
61760,84077.2,930650,25130,12083.6,338450,36630,71993.6,592200
64080,83259.1,930650,26870,12093.9,338450,37210,71165.2,592200
66380,86445.6,930650,28600,12732.6,338450,37780,73713,592200
68810,91339.5,930650,30350,14230.2,338450,38460,77109.3,592200
67810,90382.4,930650,30210,14697.1,338450,37600,75685.3,592200
66780,92752.4,930650,30070,15648.1,338450,36710,77104.3,592200
65780,90031.8,930650,29940,15871.1,338450,35840,74160.7,592200
64730,88761.6,930650,29780,16586.7,338450,34950,72174.9,592200
63250,87577.8,930650,29470,17351.8,338450,33780,70226,592200
61800,88524.7,930650,29210,18356.8,338450,32590,70167.9,592200
60330,72144.4,930650,28890,20993.7,338450,31440,51150.7,592200
58810,66198.9,930650,28580,20515,338450,30230,45683.9,592200
57260,65793.7,930650,28020,20453.1,338450,29240,45340.6,592200
55680,63786.9,930650,27450,21203.4,338450,28230,42583.5,592200
54070,61542.5,930650,26870,19556.3,338450,27200,41986.2,592200
52530,61082.8,930650,26310,18672.4,338450,26220,42410.4,592200
52220,67576,930650,26010,20828.6,338450,26210,46747.4,592200
52000,72069.6,930650,25700,23452,338450,26300,48617.6,592200
51690,76466.2,930650,25370,25999.3,338450,26320,50466.9,592200
51400,76009.9,930650,25060,26448.5,338450,26340,49561.4,592200
51350,74501.9,930650,24860,24746.4,338450,26490,49755.5,592200
51280,74109.8,930650,24680,24681.1,338450,26600,49428.7,592200
51250,73622.9,930650,24480,25067.9,338450,26770,48555,592200
51170,72702.5,930650,24290,24673.7,338450,26880,48028.8,592200
51770,71721.6,930650,24640,25669.4,338450,27130,46052.2,592200
52350,72935.3,930650,25020,24836.4,338450,27330,48098.9,592200
52980,71337.2,930650,25390,25549.7,338450,27590,45787.5,592200
53590,71919.1,930650,25750,24577.5,338450,27840,47341.6,592200
61210,69834.2,930650,29130,23956.6,338450,32080,45877.6,592200
68760,71968.3,930650,32510,25248.4,338450,36250,46719.9,592200
76250,69101.9,930650,35860,24121.4,338450,40390,44980.5,592200
83890,68772.1,930650,39240,23126.4,338450,44650,45645.7,592200
91470,72413.3,930650,42450,22692.2,338450,49020,49721.1,592200
99160,78176.1,930650,45660,23963.3,338450,53500,54212.8,592200
106810,92046.6,930650,48890,27562.5,338450,57920,64484.1,592200
114390,97941.2,930650,52100,30276.9,338450,62290,67664.3,592200
122580,99412.6,930650,55980,30169.1,338450,66600,69243.5,592200
130750,103003.7,930650,59860,31275.7,338450,70890,71728,592200
138880,107427,930650,63720,33494.9,338450,75160,73932.1,592200
147080,112379.7,930650,67600,35963.2,338450,79480,76416.5,592200
150740,120638.7,930650,69250,34534.7,338450,81490,86104,592200
154430,126021.2,930650,70900,30914.7,338450,83530,95106.5,592200
158110,137714.3,930650,72540,31602.6,338450,85570,106111.7,592200
161730,130550.1,930650,74210,30903.5,338450,87520,99646.6,592200
163680,117939.6,930650,74360,28716.8,338450,89320,89222.8,592200
165700,120426.9,930650,74560,30141.8,338450,91140,90285.1,592200
167610,131343.2,930650,74720,37697.8,338450,92890,93645.4,592200
169610,142789.6,930650,74920,42803.6,338450,94690,99986,592200
172530,147106.3,930650,76370,40743.9,338450,96160,106362.4,592200
175460,118570.1,930650,77830,35413.7,338450,97630,83156.4,592200
178400,108806,930650,79280,34827.4,338450,99120,73978.6,592200
181350,114694.1,930650,80740,38278.9,338450,100610,76415.2,592200
178690,118153,930650,79290,39374,338450,99400,78779,592200
176000,126350.7,930650,77860,44033.9,338450,98140,82316.8,592200
173320,134088.2,930650,76380,48911.3,338450,96940,85176.9,592200
170650,134813.6,930650,74930,51960.2,338450,95720,82853.4,592200
167900,128858.7,930650,73020,55113.6,338450,94880,73745.1,592200
165050,123858,930650,71040,51950.9,338450,94010,71907.1,592200
162280,122043.5,930650,69110,52835.4,338450,93170,69208.1,592200
167930,125675.7,930650,69020,55577.9,338450,98910,70097.8,592200
164610,136778.2,930650,66680,56787.2,338450,97930,79991,592200
161260,175249.5,930650,64360,64436.3,338450,96900,110813.2,592200
157880,169478.4,930650,62000,53440.3,338450,95880,116038.1,592200
154520,167221.6,930650,59660,50625.2,338450,94860,116596.4,592200
151650,163712.3,930650,58340,48827.3,338450,93310,114885,592200
148870,169146.6,930650,57030,50434.7,338450,91840,118711.9,592200
145970,171104,930650,55690,49716.9,338450,90280,121387.1,592200
143120,171262.4,930650,54360,49877.8,338450,88760,121384.6,592200
139290,172168.8,930650,52480,47603.3,338450,86810,124565.5,592200
135400,170333.9,930650,50630,47488.4,338450,84770,122845.5,592200
131530,166223,930650,48760,45106.4,338450,82770,121116.6,592200
127670,158885.8,930650,46900,43006.7,338450,80770,115879.1,592200
124580,152024.2,930650,45330,38985.7,338450,79250,113038.5,592200
121590,146470.8,930650,43810,33079.4,338450,77780,113391.4,592200
118490,143090,930650,42260,30221.6,338450,76230,112868.4,592200
115430,133460.9,930650,40690,24169.5,338450,74740,109291.4,592200
114370,127121.7,930650,40260,19330.3,338450,74110,107791.4,592200
113300,129465,930650,39820,19049.1,338450,73480,110415.9,592200
112290,142875.4,930650,39410,24807,338450,72880,118068.4,592200
111230,141180.3,930650,38990,20880.7,338450,72240,120299.6,592200
110640,146285.3,930650,38920,23531.7,338450,71720,122753.6,592200
110120,145830.6,930650,38880,22906.7,338450,71240,122923.9,592200
109550,146856.7,930650,38800,21448.4,338450,70750,125408.3,592200
108990,141612,930650,38760,20522.1,338450,70230,121089.9,592200
108770,143782.7,930650,39110,20534.9,338450,69660,123247.8,592200
108630,147099.4,930650,39500,20857.4,338450,69130,126242,592200
108380,151746.9,930650,39860,22094,338450,68520,129652.9,592200
108170,155802.4,930650,40230,23227.8,338450,67940,132574.6,592200
106730,160911.3,930650,40040,25300.7,338450,66690,135610.6,592200
105310,162298.1,930650,39850,25790.4,338450,65460,136507.7,592200
103830,159555.8,930650,39630,25683.1,338450,64200,133872.7,592200
102460,156866,930650,39450,25925,338450,63010,130941,592200
100330,156370.2,930650,38640,25592,338450,61690,130778.2,592200
98260,155356.7,930650,37800,26000.6,338450,60460,129356.1,592200
96110,151005,930650,36980,25378.9,338450,59130,125626.1,592200
93970,144462.5,930650,36170,24519.3,338450,57800,119943.2,592200
91820,137899.7,930650,35410,24656.9,338450,56410,113242.8,592200
89710,118781.4,930650,34640,21841.1,338450,55070,96940.3,592200
87590,113524.7,930650,33900,19728,338450,53690,93796.7,592200
85460,100651.6,930650,33120,15936.3,338450,52340,84715.3,592200
79760,90262.2,930650,30760,12928.8,338450,49000,77333.4,592200
74020,81424.1,930650,28410,10823.2,338450,45610,70600.9,592200
68230,73415,930650,26020,8828.4,338450,42210,64586.6,592200
62510,67769.9,930650,23670,7380.4,338450,38840,60389.5,592200
56460,63662.5,930650,21310,6354.9,338450,35150,57307.6,592200
50400,60753,930650,18980,5600.7,338450,31420,55152.3,592200
44400,58196,930650,16640,4376.1,338450,27760,53819.9,592200
38300,57432.8,930650,14300,4313.5,338450,24000,53119.3,592200
32410,59237.3,930650,12080,4415.3,338450,20330,54822,592200
26500,59478.5,930650,9850,4413.5,338450,16650,55065,592200
20640,59457.7,930650,7620,4301,338450,13020,55156.7,592200
14780,60166.2,930650,5390,4386.7,338450,9390,55779.5,592200
13490,60293.5,930650,4850,4401,338450,8640,55892.5,592200
12330,60510.5,930650,4340,4415.3,338450,7990,56095.2,592200
11110,60578.5,930650,3800,4401,338450,7310,56177.5,592200
9970,60837.8,930650,3280,4476,338450,6690,56361.8,592200
9050,60694.7,930650,2990,4488.5,338450,6060,56206.2,592200
8280,60390.9,930650,2700,4413.5,338450,5580,55977.4,592200
7440,60453.8,930650,2400,4451,338450,5040,56002.8,592200
6600,60759.5,930650,2130,4538.5,338450,4470,56221,592200
5790,61127.1,930650,1810,4818,338450,3980,56309.1,592200
5040,62011.8,930650,1470,5108.4,338450,3570,56903.4,592200
4200,62955.4,930650,1150,5172.1,338450,3050,57783.3,592200
3450,63662.4,930650,840,5115.4,338450,2610,58547,592200
4140,64964.8,930650,1010,5488.4,338450,3130,59476.4,592200
4870,66754.8,930650,1230,5889.6,338450,3640,60865.2,592200
5590,69257.9,930650,1440,6128,338450,4150,63129.9,592200
6290,70505.2,930650,1640,6039.6,338450,4650,64465.6,592200
7160,72310.6,930650,1950,6382,338450,5210,65928.6,592200
8060,74511.5,930650,2240,6775.7,338450,5820,67735.8,592200
8890,75869.9,930650,2560,7397.8,338450,6330,68472.1,592200
9750,77795.9,930650,2880,8138.4,338450,6870,69657.5,592200
10530,80670.9,930650,3050,9598.2,338450,7480,71072.7,592200
11290,87744.7,930650,3240,11651.2,338450,8050,76093.5,592200
12110,92819.3,930650,3420,12534,338450,8690,80285.3,592200
12830,97850.5,930650,3620,12927.8,338450,9210,84922.7,592200
12730,96963.6,930650,3650,11514.1,338450,9080,85449.5,592200
12590,94396.2,930650,3700,11081.2,338450,8890,83315,592200
12400,91030.2,930650,3740,11889.4,338450,8660,79140.8,592200
12320,87444.6,930650,3810,11315.3,338450,8510,76129.3,592200
11720,84599.2,930650,3540,10671.4,338450,8180,73927.8,592200
11170,83318.6,930650,3260,10636.1,338450,7910,72682.5,592200
10620,83284.5,930650,3000,10726.7,338450,7620,72557.8,592200
10020,83402.4,930650,2720,10009.6,338450,7300,73392.8,592200
9420,82276.9,930650,2420,9325.8,338450,7000,72951.1,592200
8850,82614.7,930650,2130,9391.9,338450,6720,73222.8,592200
8230,81258,930650,1800,9133.1,338450,6430,72124.9,592200
7690,77940.1,930650,1500,7944.4,338450,6190,69995.7,592200
7020,75857.8,930650,1330,7137.2,338450,5690,68720.6,592200
6500,73932.3,930650,1190,6568.2,338450,5310,67364.1,592200
5850,73214.7,930650,1020,6227.7,338450,4830,66987,592200
5250,71107.3,930650,860,5764,338450,4390,65343.3,592200
4740,69455.2,930650,780,5593.3,338450,3960,63861.9,592200
4230,68538.2,930650,670,5297.9,338450,3560,63240.3,592200
3630,67902.8,930650,540,4982.4,338450,3090,62920.4,592200
1740,67173.5,930650,290,4901,338450,1450,62272.5,592200
1380,67243.1,930650,220,4929.6,338450,1160,62313.5,592200
1080,66901.8,930650,170,4963.5,338450,910,61938.3,592200
700,65566.7,930650,70,4901,338450,630,60665.7,592200
380,65506.8,930650,20,5041.3,338450,360,60465.5,592200
900,67156.6,930650,110,5189.9,338450,790,61966.7,592200
1470,68430.2,930650,190,5425.3,338450,1280,63004.9,592200
1970,69812.7,930650,250,5752.9,338450,1720,64059.8,592200
2510,71482.5,930650,340,5897.5,338450,2170,65585,592200
3060,72802.8,930650,450,5974.9,338450,2610,66827.9,592200
3640,75512.4,930650,540,6150,338450,3100,69362.4,592200
4230,77519.7,930650,680,6354.5,338450,3550,71165.2,592200
4820,77858.8,930650,780,6262.5,338450,4040,71596.3,592200
5380,80267.5,930650,820,6844,338450,4560,73423.5,592200
5980,82924.7,930650,870,7006.5,338450,5110,75918.2,592200
6630,82098.8,930650,900,6919,338450,5730,75179.8,592200
7240,83865.5,930650,950,7155.5,338450,6290,76710,592200
7820,84365.1,930650,1180,7339,338450,6640,77026.1,592200
8350,84508.3,930650,1400,7421,338450,6950,77087.3,592200
8880,80292.2,930650,1630,7031.4,338450,7250,73260.8,592200
9420,79211,930650,1870,6907.1,338450,7550,72303.9,592200
9740,78761.9,930650,2070,7138.1,338450,7670,71623.8,592200
10090,78218.6,930650,2290,7285.1,338450,7800,70933.5,592200
10460,75479.1,930650,2510,6724.3,338450,7950,68754.8,592200
10790,73728.5,930650,2710,5953.5,338450,8080,67775,592200
11170,72921.1,930650,2900,5427.2,338450,8270,67493.9,592200
11600,74207,930650,3100,5653.2,338450,8500,68553.8,592200
11980,76825.7,930650,3280,7065,338450,8700,69760.7,592200
12390,76060.7,930650,3460,6241.9,338450,8930,69818.8,592200
13150,77785.5,930650,3890,5792.8,338450,9260,71992.7,592200
13960,78545.9,930650,4320,6136,338450,9640,72409.9,592200
14770,82713.1,930650,4750,10312.5,338450,10020,72400.6,592200
15550,85584.4,930650,5150,11850.6,338450,10400,73733.8,592200
16250,91619.8,930650,5490,13870,338450,10760,77749.8,592200
16960,99950.4,930650,5840,18227.9,338450,11120,81722.5,592200
17670,101139.1,930650,6180,17736.7,338450,11490,83402.4,592200
18370,107807.4,930650,6510,19796.1,338450,11860,88011.3,592200
18930,113714.6,930650,6700,20421.6,338450,12230,93293,592200
19580,114528.5,930650,6900,19063.5,338450,12680,95465,592200
20250,115512.2,930650,7110,18758.6,338450,13140,96753.6,592200
20810,113762.8,930650,7290,19469.8,338450,13520,94293,592200
21480,107624.7,930650,7470,16598.1,338450,14010,91026.6,592200
22120,100670,930650,7670,14905,338450,14450,85765,592200
22780,96396.3,930650,7870,11710.5,338450,14910,84685.8,592200
23410,90898.8,930650,8060,11638.9,338450,15350,79259.9,592200
24140,86768,930650,8240,11453.1,338450,15900,75314.9,592200
24830,86375.8,930650,8410,12134.7,338450,16420,74241.1,592200
25510,82856,930650,8590,10783.7,338450,16920,72072.3,592200
26230,80815.6,930650,8780,9515.9,338450,17450,71299.7,592200
26810,78242.6,930650,8980,7741.9,338450,17830,70500.7,592200
27360,78518.7,930650,9160,7171.6,338450,18200,71347.1,592200
27960,75068.3,930650,9350,5815.5,338450,18610,69252.8,592200
28570,69474.1,930650,9560,5443.9,338450,19010,64030.2,592200
29490,68885.4,930650,9840,5501,338450,19650,63384.4,592200
30610,68067.9,930650,10160,5438.5,338450,20450,62629.4,592200
31640,66086.9,930650,10450,5363.5,338450,21190,60723.4,592200
32620,65809.8,930650,10740,5413,338450,21880,60396.8,592200
33680,68982.4,930650,10950,5515.3,338450,22730,63467.1,592200
34770,70114.9,930650,11080,5601,338450,23690,64513.9,592200
35870,72191.4,930650,11270,5744.3,338450,24600,66447.1,592200
36910,71821.2,930650,11440,5779.5,338450,25470,66041.7,592200
38190,74250.6,930650,11730,6185.5,338450,26460,68065.1,592200
39470,75689.1,930650,12030,6350.1,338450,27440,69339,592200
40730,73635.4,930650,12320,6627.8,338450,28410,67007.6,592200
42030,75237,930650,12610,8032.3,338450,29420,67204.7,592200
42870,76931.7,930650,12730,9250.2,338450,30140,67681.5,592200
43690,76510.3,930650,12870,8290.2,338450,30820,68220.1,592200
44500,78693.9,930650,12970,8086.1,338450,31530,70607.8,592200
45300,79264.3,930650,13080,7812,338450,32220,71452.3,592200
45930,79138.2,930650,13350,7742.1,338450,32580,71396.1,592200
46520,81959.8,930650,13620,10027.6,338450,32900,71932.2,592200
47160,82529.8,930650,13880,10648.4,338450,33280,71881.4,592200
47720,85601.4,930650,14150,12494.4,338450,33570,73107,592200
48280,91379.7,930650,14530,15161.1,338450,33750,76218.6,592200
48760,95238.6,930650,14920,17451.5,338450,33840,77787.1,592200
49360,95917.1,930650,15300,17557.6,338450,34060,78359.5,592200
49890,94315.4,930650,15680,15965.9,338450,34210,78349.5,592200
53230,94493.7,930650,18090,15354.4,338450,35140,79139.3,592200
56560,90312.8,930650,20510,13115.4,338450,36050,77197.4,592200
59930,84739.4,930650,22940,10518.9,338450,36990,74220.5,592200
63220,80007,930650,25320,9445.5,338450,37900,70561.5,592200
68240,76607.3,930650,29080,9169.1,338450,39160,67438.2,592200
73200,74728.1,930650,32880,9561.6,338450,40320,65166.5,592200
78250,73094,930650,36640,10155.6,338450,41610,62938.4,592200
83200,76338.6,930650,40400,12961.4,338450,42800,63377.2,592200
89080,77275.9,930650,44940,14823.3,338450,44140,62452.6,592200
94940,79032.9,930650,49470,16485.1,338450,45470,62547.8,592200
100840,82073.7,930650,53980,19808.1,338450,46860,62265.6,592200
106700,84833,930650,58510,21412.7,338450,48190,63420.3,592200
119590,87245.8,930650,65880,22851.9,338450,53710,64393.9,592200
132370,93759,930650,73210,26214.4,338450,59160,67544.6,592200
145250,107590,930650,80560,35310.2,338450,64690,72279.8,592200
158180,117518.4,930650,87900,43256.2,338450,70280,74262.2,592200
170100,121453.8,930650,94670,45516.5,338450,75430,75937.3,592200
182100,133808,930650,101450,54387.3,338450,80650,79420.7,592200
194120,156821.5,930650,108230,70087.6,338450,85890,86733.9,592200
142000,152868.4,930650,86010,65553.6,338450,55990,87314.8,592200
155010,158807.9,930650,94400,79308.9,338450,60610,79499,592200
167990,160154.1,930650,102830,91753,338450,65160,68401.1,592200
180870,162539.5,930650,111240,95163.9,338450,69630,67375.6,592200
193900,184305.5,930650,119650,110839.7,338450,74250,73465.8,592200
199540,217956.3,930650,120840,132275.8,338450,78700,85680.5,592200
205160,246304.4,930650,122000,149338.9,338450,83160,96965.5,592200
210800,267747.9,930650,123180,158049.6,338450,87620,109698.3,592200
216440,265829.6,930650,124350,152751.5,338450,92090,113078.1,592200
223120,267883.3,930650,126440,152096.7,338450,96680,115786.6,592200
229780,274315.9,930650,128530,155523.6,338450,101250,118792.3,592200
236440,289663,930650,130610,159564.8,338450,105830,130098.2,592200
243120,290194.6,930650,132700,155432.8,338450,110420,134761.8,592200
251010,318440.2,930650,136130,173180.6,338450,114880,145259.6,592200
258790,326875.7,930650,139540,182104.7,338450,119250,144771,592200
266670,329068.5,930650,142970,177621.8,338450,123700,151446.7,592200
274490,328720.8,930650,146400,174610.3,338450,128090,154110.5,592200
276530,340170.5,930650,146520,179237.8,338450,130010,160932.7,592200
278550,350951.4,930650,146670,185995.4,338450,131880,164956,592200
280630,342076.9,930650,146820,183914.6,338450,133810,158162.3,592200
282610,334278.2,930650,146950,182216,338450,135660,152062.2,592200
284400,334257.4,930650,147450,181554.8,338450,136950,152702.6,592200
286160,331696.9,930650,147930,177574.8,338450,138230,154122.1,592200
287870,304897.4,930650,148450,161151.8,338450,139420,143745.6,592200
289590,308876.7,930650,148930,165455.2,338450,140660,143421.5,592200
290730,300157.4,930650,149120,162859.4,338450,141610,137298,592200
291820,299559.9,930650,149320,158961.7,338450,142500,140598.2,592200
292860,305714.6,930650,149500,159262.2,338450,143360,146452.4,592200
294000,306449.9,930650,149690,157266.2,338450,144310,149183.7,592200
294580,320452.2,930650,149920,163610.1,338450,144660,156842.1,592200
295180,324506.5,930650,150170,165513.5,338450,145010,158993,592200
295810,306928.8,930650,150400,154344,338450,145410,152584.8,592200
296430,292578.3,930650,150640,143296.5,338450,145790,149281.8,592200
296140,283364.3,930650,150350,137109.6,338450,145790,146254.7,592200
295810,273845.8,930650,150030,135039.1,338450,145780,138806.7,592200
295570,261878.4,930650,149750,130012.4,338450,145820,131866,592200
295230,260828.3,930650,149440,125867.6,338450,145790,134960.7,592200
293940,255576,930650,148620,123210,338450,145320,132366,592200
292750,258891.3,930650,147820,126252.9,338450,144930,132638.4,592200
291550,257838.5,930650,147050,124849.3,338450,144500,132989.2,592200
290270,271783.6,930650,146230,134295.4,338450,144040,137488.2,592200
285960,299363.8,930650,143990,146405.5,338450,141970,152958.3,592200
281620,295258.1,930650,141740,140523.4,338450,139880,154734.7,592200
277280,295786.9,930650,139500,138797.9,338450,137780,156989,592200
272960,300156.5,930650,137270,144785.8,338450,135690,155370.7,592200
269250,312992.3,930650,134790,149538.3,338450,134460,163454,592200
265620,306203.1,930650,132370,146128.1,338450,133250,160075,592200
261950,306542.7,930650,129900,144998.2,338450,132050,161544.5,592200
258190,293880,930650,127450,138085.4,338450,130740,155794.6,592200
253130,306661.5,930650,124150,143845.5,338450,128980,162816,592200
248060,317395.2,930650,120870,150321.4,338450,127190,167073.8,592200
243010,317577,930650,117560,150115.8,338450,125450,167461.2,592200
238000,314560.9,930650,114280,146042,338450,123720,168518.9,592200
238250,348294.2,930650,113820,162384.2,338450,124430,185910,592200
238460,349965,930650,113360,161324.3,338450,125100,188640.7,592200
238700,356514.9,930650,112880,164542.2,338450,125820,191972.7,592200
239000,355621.2,930650,112440,169001.4,338450,126560,186619.8,592200
240900,353058,930650,113010,165630.1,338450,127890,187427.9,592200
242810,343218.3,930650,113590,162560.3,338450,129220,180658,592200
244730,360147.2,930650,114170,163237.3,338450,130560,196909.9,592200
246640,362842,930650,114740,169004.4,338450,131900,193837.6,592200
248980,368824.9,930650,115450,171031.5,338450,133530,197793.4,592200
251140,358058.2,930650,116160,165536.6,338450,134980,192521.6,592200
253430,350727.4,930650,116860,154664.7,338450,136570,196062.7,592200
255730,344039.9,930650,117580,144056.1,338450,138150,199983.8,592200
260970,350321.3,930650,120430,146795.3,338450,140540,203526,592200
266210,378115.4,930650,123240,154508,338450,142970,223607.4,592200
271450,385711,930650,126100,161671.4,338450,145350,224039.6,592200
276700,399628.4,930650,128940,167707.3,338450,147760,231921.1,592200
280970,394241.3,930650,131250,152610.1,338450,149720,241631.2,592200
285230,408857.2,930650,133580,172751.1,338450,151650,236106.1,592200
289500,395687.7,930650,135870,170112,338450,153630,225575.7,592200
293790,423955.7,930650,138210,182354.4,338450,155580,241601.3,592200
298300,424506.5,930650,140460,180464.6,338450,157840,244041.9,592200
302940,403111.7,930650,142720,169010.7,338450,160220,234101,592200
307470,397875.9,930650,144980,171263.9,338450,162490,226612,592200
312070,399000.2,930650,147270,175620,338450,164800,223380.2,592200
312230,413727.2,930650,147930,181514.7,338450,164300,232212.5,592200
312380,428720.5,930650,148610,186370.2,338450,163770,242350.3,592200
312520,436347.3,930650,149280,194644.2,338450,163240,241703.1,592200
312750,445471.1,930650,149970,201345.8,338450,162780,244125.3,592200
312390,436555.9,930650,150560,196132.2,338450,161830,240423.7,592200
312070,449827.6,930650,151180,211301.4,338450,160890,238526.2,592200
311710,452009.2,930650,151800,219227.1,338450,159910,232782.1,592200
311340,448695.7,930650,152420,230459.6,338450,158920,218236.1,592200
311190,474408.4,930650,153090,233516.6,338450,158100,240891.8,592200
310930,465530.5,930650,153770,229808.8,338450,157160,235721.7,592200
310800,435258.5,930650,154430,213385,338450,156370,221873.5,592200
310570,415261.2,930650,155110,202728.7,338450,155460,212532.5,592200
307680,402471.7,930650,153440,195059.1,338450,154240,207412.6,592200
304760,386268,930650,151790,190787.7,338450,152970,195480.3,592200
301860,380560.2,930650,150110,189884,338450,151750,190676.2,592200
298960,386322.5,930650,148430,191203,338450,150530,195119.5,592200
295870,388768.2,930650,146600,196345.7,338450,149270,192422.5,592200
292730,387255,930650,144740,196115.1,338450,147990,191139.9,592200
289590,370443.2,930650,142920,184621.7,338450,146670,185821.5,592200
274630,362288,930650,136300,180583.5,338450,138330,181704.5,592200
269930,358651.3,930650,133490,178453.5,338450,136440,180197.8,592200
265240,356937.7,930650,130690,175067.8,338450,134550,181869.9,592200
260560,335893.4,930650,127910,161847,338450,132650,174046.4,592200
255850,332768.3,930650,125090,159362.1,338450,130760,173406.2,592200
257710,349203.4,930650,125880,162968.9,338450,131830,186234.5,592200
259480,341815.5,930650,126660,166258.8,338450,132820,175556.7,592200
261230,341420.8,930650,127430,164173.1,338450,133800,177247.7,592200
263060,333437.5,930650,128240,157274.8,338450,134820,176162.7,592200
264110,312834.8,930650,128660,146736.2,338450,135450,166098.6,592200
265100,322067.8,930650,129090,151908.9,338450,136010,170158.9,592200
266150,335837.4,930650,129520,156703.7,338450,136630,179133.7,592200
267190,320437.4,930650,129940,144452,338450,137250,175985.4,592200
268280,317039.4,930650,130070,141387.4,338450,138210,175652,592200
269300,312260.8,930650,130190,140144.1,338450,139110,172116.7,592200
270380,309373.8,930650,130310,139326.1,338450,140070,170047.7,592200
271440,317384.5,930650,130480,146952.3,338450,140960,170432.2,592200
272510,318649.7,930650,130710,142320,338450,141800,176329.7,592200
273530,328671.8,930650,130950,146948.9,338450,142580,181722.9,592200
274560,323077.5,930650,131200,147360.3,338450,143360,175717.2,592200
275570,310501.8,930650,131440,144346.3,338450,144130,166155.5,592200
277500,327880.4,930650,132700,156770.4,338450,144800,171110,592200
279460,348117.6,930650,133970,171943.4,338450,145490,176174.2,592200
281360,345857.9,930650,135210,167478,338450,146150,178379.9,592200
283290,342801.1,930650,136460,165193.8,338450,146830,177607.3,592200
284700,355029.8,930650,137110,172564,338450,147590,182465.8,592200
286190,352071,930650,137790,164896.5,338450,148400,187174.5,592200
287710,382187.4,930650,138440,179277.7,338450,149270,202909.7,592200
289160,366955.6,930650,139100,168348.9,338450,150060,198606.7,592200
292480,344749.4,930650,140250,155736.9,338450,152230,189012.5,592200
295680,362443.3,930650,141430,164142.5,338450,154250,198300.8,592200
298850,394834.4,930650,142600,178677.6,338450,156250,216156.8,592200
302000,388628.8,930650,143740,177066.9,338450,158260,211561.9,592200
305100,393277.3,930650,145070,177940.3,338450,160030,215337,592200
308070,386961.4,930650,146420,174636,338450,161650,212325.4,592200
310990,367595.4,930650,147710,171652.3,338450,163280,195943.1,592200
314030,371411.6,930650,149030,175495.5,338450,165000,195916.1,592200
315950,375177,930650,149330,178378.8,338450,166620,196798.2,592200
317840,366016,930650,149580,170683.5,338450,168260,195332.5,592200
319740,376758.4,930650,149850,169598.2,338450,169890,207160.2,592200
321690,379842.6,930650,150120,168605,338450,171570,211237.6,592200
319570,397565.7,930650,148150,172872.7,338450,171420,224693,592200
317440,407430.3,930650,146190,172595,338450,171250,234835.3,592200
315270,411291.2,930650,144230,165702.3,338450,171040,245588.9,592200
313100,408043,930650,142290,159076.2,338450,170810,248966.8,592200
312910,405465.4,930650,141590,160391.3,338450,171320,245074.1,592200
312610,423660.1,930650,140890,166434.1,338450,171720,257226,592200
312410,442169.6,930650,140200,175561.6,338450,172210,266608,592200
312210,464252.5,930650,139510,183348.5,338450,172700,280904,592200
312550,472111.1,930650,138750,187124.7,338450,173800,284986.4,592200
313000,474517.3,930650,137990,189129.1,338450,175010,285388.2,592200
313370,478335.6,930650,137230,195386,338450,176140,282949.6,592200
313720,484437.1,930650,136450,192005.8,338450,177270,292431.3,592200
316120,495874.5,930650,136760,201608.6,338450,179360,294265.9,592200
318470,495026.7,930650,137060,205833.8,338450,181410,289192.9,592200
320850,444769.4,930650,137380,181237.2,338450,183470,263532.2,592200
323150,442263.3,930650,137660,180214.6,338450,185490,262048.7,592200
325330,420628,930650,137780,171310.6,338450,187550,249317.4,592200
327480,405803.9,930650,137920,176343.8,338450,189560,229460.1,592200
329670,377954.2,930650,138050,159208.4,338450,191620,218745.8,592200
331880,394278.5,930650,138170,171487,338450,193710,222791.5,592200
334230,360634.7,930650,138360,151140.7,338450,195870,209494,592200
336710,356528.5,930650,138560,146121.9,338450,198150,210406.6,592200
339170,357713.2,930650,138740,137265.2,338450,200430,220448,592200
341600,369858.2,930650,138940,146996.5,338450,202660,222861.7,592200
343890,359913.8,930650,140850,144179.2,338450,203040,215734.6,592200
346180,370779.7,930650,142760,150341.9,338450,203420,220437.8,592200
348510,346020.9,930650,144700,138625.6,338450,203810,207395.3,592200
350810,345139.2,930650,146620,136241.1,338450,204190,208898.1,592200
352740,335364.4,930650,148430,123643.4,338450,204310,211721,592200
354710,340140.8,930650,150280,128311.5,338450,204430,211829.3,592200
356610,370531,930650,152090,152142.2,338450,204520,218388.8,592200
358560,345503.6,930650,153940,139735,338450,204620,205768.6,592200
360450,376147.6,930650,156190,150713.6,338450,204260,225434,592200
362370,393919.8,930650,158460,162893.1,338450,203910,231026.7,592200
364230,339652.4,930650,160710,148889.1,338450,203520,190763.3,592200
366030,356873.8,930650,162920,150685.8,338450,203110,206188,592200
364690,376277.9,930650,163110,155481.1,338450,201580,220796.8,592200
363370,348171.3,930650,163310,148168.8,338450,200060,200002.5,592200
361970,344503.4,930650,163490,148499.6,338450,198480,196003.8,592200
360580,334351,930650,163680,141242,338450,196900,193109,592200
358940,321115.7,930650,163380,133102.9,338450,195560,188012.8,592200
357260,322685.9,930650,163080,131376.7,338450,194180,191309.2,592200
355620,351089.2,930650,162760,144730.8,338450,192860,206358.4,592200
353910,380525.1,930650,162470,164558.1,338450,191440,215967,592200
352690,393762.9,930650,162700,175444.7,338450,189990,218318.2,592200
351380,398645.2,930650,162890,174621.9,338450,188490,224023.3,592200
350080,404179.5,930650,163120,175591.5,338450,186960,228588,592200
348820,418210.5,930650,163310,188746.3,338450,185510,229464.2,592200
345300,399139.7,930650,161480,177530.7,338450,183820,221609,592200
341770,387723.7,930650,159610,175924.3,338450,182160,211799.4,592200
338210,397226.3,930650,157730,178929.8,338450,180480,218296.5,592200
334680,390177.5,930650,155880,179809.5,338450,178800,210368,592200
332090,390430.7,930650,154420,181335.9,338450,177670,209094.8,592200
329520,395113.2,930650,152970,176760.3,338450,176550,218352.9,592200
326900,380155.6,930650,151510,164738.9,338450,175390,215416.7,592200
358250,399603.2,930650,156820,177801.1,338450,201430,221802.1,592200
354820,406241,930650,155280,180291.1,338450,199540,225949.9,592200
351370,399059.9,930650,153790,178134.3,338450,197580,220925.6,592200
347960,397690.7,930650,152260,179087.3,338450,195700,218603.4,592200
344490,415589.7,930650,150740,185431.8,338450,193750,230157.9,592200
344080,399152.3,930650,150590,178477.1,338450,193490,220675.2,592200
343600,384857.3,930650,150440,171712.4,338450,193160,213144.9,592200
343150,396307,930650,150290,179645.2,338450,192860,216661.8,592200
342700,407692.4,930650,150120,182426.7,338450,192580,225265.7,592200
343680,416980.3,930650,150400,178112.8,338450,193280,238867.5,592200
344540,420840.4,930650,150660,182077.1,338450,193880,238763.3,592200
345580,416860.1,930650,150950,185607.9,338450,194630,231252.2,592200
346540,417594.4,930650,151220,182461.8,338450,195320,235132.6,592200
347650,421400.2,930650,151560,185617.9,338450,196090,235782.3,592200
348700,411271.8,930650,151900,185380.6,338450,196800,225891.2,592200
349770,393739,930650,152230,177036.1,338450,197540,216702.9,592200
350900,374256.3,930650,152560,165044.8,338450,198340,209211.5,592200
356920,364061.1,930650,155360,154642.3,338450,201560,209418.8,592200
363230,390020,930650,158200,167895.4,338450,205030,222124.6,592200
369300,398426.1,930650,161010,172454.4,338450,208290,225971.7,592200
375500,393305.6,930650,163820,168691.6,338450,211680,224614,592200
380190,367800.7,930650,166270,154575.3,338450,213920,213225.4,592200
384930,361420.8,930650,168730,149273.2,338450,216200,212147.6,592200
389580,402383,930650,171170,170561.2,338450,218410,231821.8,592200
394390,399638.4,930650,173640,166206.2,338450,220750,233432.2,592200
399160,415729.9,930650,176160,176509.9,338450,223000,239220,592200
403890,426182.3,930650,178650,183490,338450,225240,242692.3,592200
408630,447994.7,930650,181130,197240.5,338450,227500,250754.2,592200
413410,443113.4,930650,183650,197236.3,338450,229760,245877.1,592200
416320,455152,930650,183760,204890.7,338450,232560,250261.3,592200
419340,470752.7,930650,183880,217706.3,338450,235460,253046.4,592200
422340,490946.5,930650,183970,229129.9,338450,238370,261816.6,592200
425340,510823.3,930650,184110,240851,338450,241230,269972.3,592200
428450,513626.8,930650,184280,236279.6,338450,244170,277347.2,592200
431580,504007.3,930650,184470,227342.3,338450,247110,276665,592200
434690,511270.5,930650,184660,232477.8,338450,250030,278792.7,592200
437840,520236.4,930650,184850,239245.8,338450,252990,280990.6,592200
441060,501849.6,930650,185580,230267,338450,255480,271582.6,592200
444350,508885.2,930650,186300,229623.2,338450,258050,279262,592200
447610,502008,930650,187030,225736.7,338450,260580,276271.3,592200
450890,510138.8,930650,187770,231289.3,338450,263120,278849.5,592200
450960,512215.5,930650,187470,228577.1,338450,263490,283638.4,592200
451010,493983.1,930650,187150,215783.7,338450,263860,278199.4,592200
451080,501481.9,930650,186850,219307.3,338450,264230,282174.6,592200
451190,497968.8,930650,186570,215227.1,338450,264620,282741.7,592200
451660,530470.7,930650,186570,233889.1,338450,265090,296581.6,592200
452040,508080.5,930650,186560,221067.9,338450,265480,287012.6,592200
452550,438874.8,930650,186570,202258,338450,265980,236616.8,592200
453000,478772.8,930650,186570,228012,338450,266430,250760.8,592200
453460,483692.6,930650,186810,215277.9,338450,266650,268414.7,592200
453920,531754.6,930650,187060,225978.9,338450,266860,305775.7,592200
454450,545361,930650,187300,233133.9,338450,267150,312227.1,592200
454890,539554.5,930650,187540,227719.6,338450,267350,311834.9,592200
458860,558479.8,930650,188960,226586.7,338450,269900,331893.1,592200
462810,566636,930650,190410,235171.4,338450,272400,331464.6,592200
466760,541674.9,930650,191830,229038.1,338450,274930,312636.8,592200
470740,552291.1,930650,193270,231662.9,338450,277470,320628.2,592200
474230,561951.1,930650,193980,232914.7,338450,280250,329036.4,592200
477590,560799.4,930650,194690,233332.8,338450,282900,327466.6,592200
481050,536732,930650,195420,219531.7,338450,285630,317200.3,592200
484490,535699.1,930650,196130,214191.4,338450,288360,321507.7,592200
489120,566218.2,930650,197610,234536.1,338450,291510,331682.1,592200
493720,596378.1,930650,199120,238671.9,338450,294600,357706.2,592200
498390,594071.3,930650,200620,243321.2,338450,297770,350750.1,592200
502970,579157.1,930650,202100,233625.7,338450,300870,345531.4,592200
503460,552081.6,930650,203760,230045.7,338450,299700,322035.9,592200
503990,575332.4,930650,205400,242352.8,338450,298590,332979.6,592200
504440,553156.6,930650,207060,239439.3,338450,297380,313717.3,592200
504890,545711.1,930650,208700,229531.9,338450,296190,316179.2,592200
503520,534230.4,930650,209210,225905.9,338450,294310,308324.5,592200
502110,528915.1,930650,209660,224005.9,338450,292450,304909.2,592200
500620,491765.7,930650,210150,206930.9,338450,290470,284834.8,592200
499230,486501.6,930650,210630,206896.6,338450,288600,279605,592200
497230,476479.8,930650,210820,206211.9,338450,286410,270267.9,592200
495170,485736.7,930650,211020,208828.4,338450,284150,276908.3,592200
493100,503373.4,930650,211200,220521.3,338450,281900,282852.1,592200
491050,495272.9,930650,211390,219679.4,338450,279660,275593.5,592200
486450,499308.6,930650,210320,219830.5,338450,276130,279478.1,592200
481960,508078.3,930650,209290,218377.7,338450,272670,289700.6,592200
477310,524073.7,930650,208240,218736.5,338450,269070,305337.2,592200
472720,513566.7,930650,207160,216738.3,338450,265560,296828.4,592200
466930,505695.3,930650,205410,228464.2,338450,261520,277231.1,592200
461080,505972.3,930650,203620,234972.9,338450,257460,270999.4,592200
455320,500995.5,930650,201860,234150.4,338450,253460,266845.1,592200
449510,481343.9,930650,200070,221614.4,338450,249440,259729.5,592200
444440,470234.2,930650,198490,213514.8,338450,245950,256719.4,592200
439240,455956.8,930650,196900,205007.5,338450,242340,250949.3,592200
434070,451809.3,930650,195290,200338.6,338450,238780,251470.7,592200
428930,465093.8,930650,193710,214437.1,338450,235220,250656.7,592200
421130,461204,930650,190130,216929.6,338450,231000,244274.4,592200
413320,442636.2,930650,186570,201891.7,338450,226750,240744.5,592200
405610,415391.1,930650,183000,189931.5,338450,222610,225459.6,592200
397840,448222.1,930650,179440,206989,338450,218400,241233.1,592200
389840,485946.8,930650,175770,230819.7,338450,214070,255127.1,592200
381740,488357.4,930650,172090,232171.7,338450,209650,256185.7,592200
373660,476522.8,930650,168390,226427.5,338450,205270,250095.3,592200
354330,433009.2,930650,165450,206151.3,338450,188880,226857.9,592200
349120,430376.5,930650,163120,199732.3,338450,186000,230644.2,592200
343990,419923.4,930650,160810,193429.9,338450,183180,226493.5,592200
338810,406857,930650,158490,188018.3,338450,180320,218838.7,592200
333670,428108.8,930650,156160,200546.4,338450,177510,227562.4,592200
331290,430199,930650,154450,205809.5,338450,176840,224389.5,592200
328940,424798.3,930650,152760,208305.2,338450,176180,216493.1,592200
326590,448337.6,930650,151060,222961.3,338450,175530,225376.3,592200
324230,445813.4,930650,149340,221999.2,338450,174890,223814.2,592200
321840,422777.3,930650,147560,204568.2,338450,174280,218209.1,592200
319370,409014.4,930650,145790,192637,338450,173580,216377.4,592200
316940,393288.5,930650,144000,185366.5,338450,172940,207922,592200
314490,377162,930650,142210,177251.1,338450,172280,199910.9,592200
312420,358331.6,930650,140720,163933.1,338450,171700,194398.5,592200
310310,369608.8,930650,139230,171965.3,338450,171080,197643.5,592200
308150,368455.9,930650,137740,167809.1,338450,170410,200646.8,592200
306090,359952,930650,136250,166266.8,338450,169840,193685.2,592200
309230,350153.1,930650,137670,161898.4,338450,171560,188254.7,592200
312470,372193.3,930650,139060,170022.1,338450,173410,202171.2,592200
315700,351998.9,930650,140500,160743.4,338450,175200,191255.5,592200
318900,362693.1,930650,141910,162773.4,338450,176990,199919.7,592200
322220,380326.9,930650,143580,170790.6,338450,178640,209536.3,592200
325380,395174.9,930650,145250,182817,338450,180130,212357.9,592200
328680,387783.1,930650,146910,173788.8,338450,181770,213994.3,592200
331890,389325.8,930650,148580,169502.7,338450,183310,219823.1,592200
334050,385665.9,930650,149490,160553.9,338450,184560,225112,592200
336120,375740.8,930650,150380,154567.9,338450,185740,221172.9,592200
338260,375810.5,930650,151290,156217.8,338450,186970,219592.7,592200
340300,376288.1,930650,152180,157536.6,338450,188120,218751.5,592200
342670,374049.9,930650,152530,155079.1,338450,190140,218970.8,592200
345030,370993.9,930650,152910,152423.9,338450,192120,218570,592200
347390,378290.5,930650,153270,154221.9,338450,194120,224068.6,592200
349680,382656.9,930650,153570,157675.2,338450,196110,224981.7,592200
354310,380705.3,930650,155390,154493.3,338450,198920,226212,592200
358910,379344.3,930650,157190,152537.7,338450,201720,226806.6,592200
363590,387188.3,930650,159010,155201.5,338450,204580,231986.8,592200
368180,401784.1,930650,160810,159920.9,338450,207370,241863.2,592200
373200,396962.7,930650,162870,162469.1,338450,210330,234493.6,592200
378230,401478.7,930650,164920,168095.3,338450,213310,233383.4,592200
383290,409488.9,930650,166970,178161.2,338450,216320,231327.7,592200
388300,415408.8,930650,169030,183098.5,338450,219270,232310.3,592200
389580,427706.8,930650,168600,184843.2,338450,220980,242863.6,592200
390910,410284.7,930650,168140,173972.7,338450,222770,236312,592200
392200,416943.7,930650,167720,175361.5,338450,224480,241582.2,592200
393450,439256.7,930650,167300,183252.6,338450,226150,256004.1,592200
394210,463193,930650,166340,190044.8,338450,227870,273148.2,592200
394960,496315.9,930650,165410,202620.9,338450,229550,293695,592200
395740,547656.1,930650,164490,230429.3,338450,231250,317226.8,592200
396470,550885.5,930650,163550,234893.2,338450,232920,315992.3,592200
396780,555249,930650,162610,235716.8,338450,234170,319532.2,592200
397150,551985.5,930650,161660,232942.3,338450,235490,319043.2,592200
397470,541714.6,930650,160730,236507,338450,236740,305207.6,592200
397750,561942,930650,159800,241302.6,338450,237950,320639.4,592200
406810,543075,930650,163190,230271,338450,243620,312804,592200
415820,541511.4,930650,166590,226630.6,338450,249230,314880.8,592200
424910,561236,930650,169980,237010.2,338450,254930,324225.8,592200
433920,563200.2,930650,173360,242359.2,338450,260560,320841,592200
442350,542987.9,930650,176430,234555.2,338450,265920,308432.7,592200
450770,526354.3,930650,179480,227315.6,338450,271290,299038.7,592200
459220,499279.6,930650,182540,218215,338450,276680,281064.6,592200
467720,520644.9,930650,185590,230863.9,338450,282130,289781,592200
476030,514371.2,930650,189120,232534,338450,286910,281837.2,592200
484350,492893.2,930650,192610,221508.3,338450,291740,271384.9,592200
492720,487051.4,930650,196110,218439.4,338450,296610,268612,592200
501040,492752.3,930650,199610,226169.3,338450,301430,266583,592200
491230,474776.5,930650,199160,217879.7,338450,292070,256896.8,592200
481430,479754.2,930650,198730,220810.5,338450,282700,258943.7,592200
471580,487435.2,930650,198300,224915,338450,273280,262520.2,592200
461800,480721,930650,197840,226248.1,338450,263960,254472.9,592200
451440,437014,930650,197200,211056.7,338450,254240,225957.3,592200
441060,442736.4,930650,196520,217451.2,338450,244540,225285.2,592200
430670,436827.5,930650,195860,209041.9,338450,234810,227785.6,592200
420310,437509.7,930650,195180,209956.3,338450,225130,227553.4,592200
409990,437696.7,930650,194350,208846.4,338450,215640,228850.3,592200
399630,448694.5,930650,193490,215064.7,338450,206140,233629.8,592200
389340,454377.9,930650,192640,218332.7,338450,196700,236045.2,592200
379050,434024.4,930650,191800,209988.9,338450,187250,224035.5,592200
376580,437237.1,930650,191220,209773.9,338450,185360,227463.2,592200
374170,455734.4,930650,190650,217854,338450,183520,237880.4,592200
371770,456991.2,930650,190090,214770.5,338450,181680,242220.7,592200
369330,474610.5,930650,189510,224506.3,338450,179820,250104.2,592200
366060,450258.4,930650,188500,212676.3,338450,177560,237582.1,592200
362830,455438.7,930650,187480,220828.8,338450,175350,234609.9,592200
359610,464750.6,930650,186470,227128.1,338450,173140,237622.5,592200
356340,450709.5,930650,185460,222744.3,338450,170880,227965.2,592200
352980,437751.4,930650,184230,219219.6,338450,168750,218531.8,592200
349560,414118.1,930650,182990,211995.1,338450,166570,202123,592200
346170,390728.7,930650,181790,200795.7,338450,164380,189933,592200
342770,392763.4,930650,180570,203443.1,338450,162200,189320.3,592200
340870,388378.4,930650,180390,207892.7,338450,160480,180485.7,592200
338900,391646.1,930650,180210,212376.5,338450,158690,179269.6,592200
337020,382002.7,930650,180030,208694.6,338450,156990,173308.1,592200
335080,385073,930650,179830,211415.9,338450,155250,173657.1,592200
333690,391860.8,930650,179530,214230.4,338450,154160,177630.4,592200
332500,363178.9,930650,179260,197415.7,338450,153240,165763.2,592200
331170,356395.3,930650,178970,189490,338450,152200,166905.3,592200
394430,381313.2,930650,188740,196671.4,338450,205690,184641.8,592200
392280,384978.2,930650,188580,195608.3,338450,203700,189369.9,592200
390140,392843.5,930650,188410,199423.9,338450,201730,193419.6,592200
388000,394826.7,930650,188250,200264.1,338450,199750,194562.6,592200
385870,409008,930650,188060,206077.3,338450,197810,202930.7,592200
387160,409897.7,930650,189320,203518.5,338450,197840,206379.2,592200
388450,409880.9,930650,190620,197300.5,338450,197830,212580.4,592200
389740,420197.4,930650,191900,199495.8,338450,197840,220701.6,592200
391000,423962.4,930650,193170,200385.9,338450,197830,223576.5,592200
393300,422963.4,930650,194660,203684,338450,198640,219279.4,592200
395660,421682.6,930650,196180,202640.9,338450,199480,219041.7,592200
398030,419179.1,930650,197690,201132.8,338450,200340,218046.3,592200
400380,392098.4,930650,199220,185839.9,338450,201160,206258.5,592200
402080,413574.5,930650,200890,198710.2,338450,201190,214864.3,592200
403790,419692.2,930650,202580,206627.7,338450,201210,213064.5,592200
405600,407081.3,930650,204280,201352,338450,201320,205729.3,592200
407290,396395.5,930650,205980,197157.8,338450,201310,199237.7,592200
409030,395370.3,930650,207240,195148.6,338450,201790,200221.7,592200
410820,390733.6,930650,208540,190631.9,338450,202280,200101.7,592200
412600,405252.4,930650,209800,197774.5,338450,202800,207477.9,592200
414380,425578.8,930650,211110,212231.3,338450,203270,213347.5,592200
416150,429082,930650,212590,218954.5,338450,203560,210127.5,592200
417910,419721.2,930650,214090,214498.8,338450,203820,205222.4,592200
419620,392905.3,930650,215560,196255.2,338450,204060,196650.1,592200
421350,392501.7,930650,217040,197801.3,338450,204310,194700.4,592200
422600,413184.3,930650,218490,209409.4,338450,204110,203774.9,592200
423920,422911.1,930650,219930,214408.5,338450,203990,208502.6,592200
425210,419930.3,930650,221390,212540.4,338450,203820,207389.9,592200
426510,402890.3,930650,222820,202150.3,338450,203690,200740,592200
426680,399544.1,930650,222870,201765.6,338450,203810,197778.5,592200
426940,388073,930650,222890,197065.7,338450,204050,191007.3,592200
427110,390243.8,930650,222960,199513,338450,204150,190730.8,592200
427260,390923.4,930650,223000,200860,338450,204260,190063.4,592200
427680,404332.3,930650,222980,210059.5,338450,204700,194272.8,592200
428070,419876.5,930650,222970,217589.7,338450,205100,202286.8,592200
428460,416900.7,930650,222950,214522.6,338450,205510,202378.1,592200
428900,413327.6,930650,222920,212975,338450,205980,200352.6,592200
429370,414803.3,930650,222830,214817.4,338450,206540,199985.9,592200
429870,417800.6,930650,222710,218596.8,338450,207160,199203.8,592200
430430,403667.4,930650,222620,209330.4,338450,207810,194337,592200
430910,414531.8,930650,222520,214174.1,338450,208390,200357.7,592200
433630,427562.1,930650,222890,219996,338450,210740,207566.1,592200
436280,437992.9,930650,223270,222685.2,338450,213010,215307.7,592200
438940,422592.9,930650,223610,218696,338450,215330,203896.9,592200
441670,395755.9,930650,224010,205231.5,338450,217660,190524.4,592200
444370,405694.6,930650,224260,211995.6,338450,220110,193699,592200
447060,381280.2,930650,224520,199179.4,338450,222540,182100.8,592200
449850,417109.4,930650,224820,212006.7,338450,225030,205102.7,592200
452560,435900.4,930650,225060,217779.1,338450,227500,218121.3,592200
455230,435666.3,930650,225200,211670.8,338450,230030,223995.5,592200
457930,427415.9,930650,225350,212386.1,338450,232580,215029.8,592200
460690,423815.9,930650,225510,215384.2,338450,235180,208431.7,592200
463400,416587.7,930650,225660,216874.3,338450,237740,199713.4,592200
463950,421138,930650,226050,220382.7,338450,237900,200755.3,592200
464550,416870.5,930650,226440,221819.3,338450,238110,195051.2,592200
465180,404943.5,930650,226860,215073.1,338450,238320,189870.4,592200
465760,401663.4,930650,227260,212636.5,338450,238500,189026.9,592200
465840,395773.3,930650,227530,208264.2,338450,238310,187509.1,592200
465960,369139,930650,227810,199279.6,338450,238150,169859.4,592200
466020,366016.8,930650,228080,202301.7,338450,237940,163715.1,592200
466010,391061.4,930650,228350,201783,338450,237660,189278.4,592200
465580,377737,930650,228170,200589.3,338450,237410,177147.7,592200
465080,368929,930650,227980,193579.9,338450,237100,175349.1,592200
464660,376858,930650,227780,206627.5,338450,236880,170230.5,592200
464110,364288.6,930650,227580,204104.5,338450,236530,160184.1,592200
454570,373895.7,930650,225280,210599.5,338450,229290,163296.2,592200
444900,388647.5,930650,222980,211748.3,338450,221920,176899.2,592200
435230,376797.2,930650,220660,207975.4,338450,214570,168821.8,592200
425630,376504.4,930650,218360,210024.5,338450,207270,166479.9,592200
416820,369671.8,930650,216560,208739.7,338450,200260,160932.1,592200
407980,363112.4,930650,214780,208594.9,338450,193200,154517.5,592200
399200,361295,930650,212970,209166.3,338450,186230,152128.7,592200
390440,368505.9,930650,211200,206637.9,338450,179240,161868,592200
381280,361681.4,930650,209380,206887.7,338450,171900,154793.7,592200
372160,367431.9,930650,207620,207743.3,338450,164540,159688.6,592200
363030,348404.7,930650,205820,202399.1,338450,157210,146005.6,592200
353980,347692.4,930650,204060,194338.9,338450,149920,153353.5,592200
350260,349109.9,930650,203060,200151.4,338450,147200,148958.5,592200
346560,342954,930650,202100,197068.5,338450,144460,145885.5,592200
342900,363283.4,930650,201100,207586.1,338450,141800,155697.3,592200
339190,329788.4,930650,200110,195454.2,338450,139080,134334.2,592200
335170,358695.1,930650,198740,210670.7,338450,136430,148024.4,592200
331170,359809.2,930650,197380,209583.4,338450,133790,150225.8,592200
327130,334284.1,930650,196000,204692.8,338450,131130,129591.3,592200
323130,335685.8,930650,194620,208357,338450,128510,127328.8,592200
319850,357857.7,930650,193500,212462,338450,126350,145395.7,592200
316540,349440.3,930650,192360,205745.3,338450,124180,143695,592200
313200,354208.1,930650,191210,209071.1,338450,121990,145137,592200
309970,351279.7,930650,190110,206966.3,338450,119860,144313.4,592200
308090,342274.4,930650,189500,200268.2,338450,118590,142006.2,592200
306160,341657.2,930650,188910,203249,338450,117250,138408.2,592200
304310,334905.5,930650,188320,200420,338450,115990,134485.5,592200
302400,325244,930650,187710,194842.8,338450,114690,130401.2,592200
300680,304478.2,930650,187180,181720.8,338450,113500,122757.4,592200
299000,316058.5,930650,186650,189066,338450,112350,126992.5,592200
297260,305439.4,930650,186130,182592.5,338450,111130,122846.9,592200
262740,272224.7,930650,171420,161803.3,338450,91320,110421.4,592200
257940,274307.6,930650,169350,163612.3,338450,88590,110695.3,592200
253190,276371.9,930650,167290,163390.7,338450,85900,112981.2,592200
248430,278554.2,930650,165230,165682.3,338450,83200,112871.9,592200
243670,282320.3,930650,163140,169095.8,338450,80530,113224.5,592200
242730,290577.9,930650,161770,173039.6,338450,80960,117538.3,592200
241840,290422.7,930650,160390,172753,338450,81450,117669.7,592200
240900,301662.5,930650,159000,177677.5,338450,81900,123985,592200
240080,307995.5,930650,157630,181970,338450,82450,126025.5,592200
239510,312957.7,930650,156890,184514.2,338450,82620,128443.5,592200
239000,306375.5,930650,156140,177476.7,338450,82860,128898.8,592200
238440,305807.4,930650,155410,176349.4,338450,83030,129458,592200
237940,308253.4,930650,154690,175967.5,338450,83250,132285.9,592200
236670,308538.9,930650,153550,178479.3,338450,83120,130059.6,592200
235500,298812.1,930650,152410,179624.2,338450,83090,119187.9,592200
234260,279743.8,930650,151260,172657.2,338450,83000,107086.6,592200
233040,274289.6,930650,150120,166350,338450,82920,107939.6,592200
235140,300696.7,930650,151340,178614.6,338450,83800,122082.1,592200
237300,306476.5,930650,152590,187078.5,338450,84710,119398,592200
239420,312218.5,930650,153810,188952.1,338450,85610,123266.4,592200
241520,294156.8,930650,155060,183116.6,338450,86460,111040.2,592200
244370,311465.1,930650,156690,185739.7,338450,87680,125725.4,592200
247240,331106.4,930650,158370,195227.3,338450,88870,135879.1,592200
250080,306569.4,930650,160000,194525.5,338450,90080,112043.9,592200
253020,311721.6,930650,161680,186343.7,338450,91340,125377.9,592200
256690,316940.7,930650,163860,194540.7,338450,92830,122400,592200
260280,307149,930650,166050,188757.6,338450,94230,118391.4,592200
263990,314052.7,930650,168260,198207.1,338450,95730,115845.6,592200
267550,323811.4,930650,170430,203072,338450,97120,120739.4,592200
267900,322164.9,930650,170520,201705.8,338450,97380,120459.1,592200
268320,315682.9,930650,170630,199339.9,338450,97690,116343,592200
268740,312044.2,930650,170720,198501.3,338450,98020,113542.9,592200
269070,309539.4,930650,170820,197653.1,338450,98250,111886.3,592200
269980,310680.2,930650,171300,198409.3,338450,98680,112270.9,592200
270810,312113.7,930650,171740,200104.3,338450,99070,112009.4,592200
271760,324096.1,930650,172250,206761.6,338450,99510,117334.5,592200
272570,314296.6,930650,172690,201261.8,338450,99880,113034.8,592200
272250,302549.9,930650,172280,191480,338450,99970,111069.9,592200
271870,285291.7,930650,171890,178625.7,338450,99980,106666,592200
271530,289744.7,930650,171490,179887.4,338450,100040,109857.3,592200
271130,297406.4,930650,171080,182927.1,338450,100050,114479.3,592200
268720,314123.9,930650,169220,179600.1,338450,99500,134523.8,592200
266280,293336,930650,167360,173987.9,338450,98920,119348.1,592200
263850,290505.3,930650,165540,173414.9,338450,98310,117090.4,592200
261420,292940.6,930650,163680,179379,338450,97740,113561.6,592200
258720,294406.4,930650,161780,179122.2,338450,96940,115284.2,592200
256030,287090,930650,159850,169965.9,338450,96180,117124.1,592200
253370,271313.7,930650,157920,160062.2,338450,95450,111251.5,592200
250650,291634.6,930650,155990,166752.8,338450,94660,124881.8,592200
248200,303948.8,930650,154260,166708.8,338450,93940,137240,592200
245740,290947.3,930650,152530,166262.3,338450,93210,124685,592200
243280,299327.6,930650,150820,171624.3,338450,92460,127703.3,592200
240840,316646,930650,149100,182654.4,338450,91740,133991.6,592200
244400,318932.5,930650,150190,181987.8,338450,94210,136944.7,592200
247870,307763.2,930650,151270,174370.3,338450,96600,133392.9,592200
251390,322048.2,930650,152320,178662.8,338450,99070,143385.4,592200
254850,305238.5,930650,153420,171715.4,338450,101430,133523.1,592200
257380,310018.5,930650,154000,174396.1,338450,103380,135622.4,592200
259990,298069.7,930650,154590,167815.8,338450,105400,130253.9,592200
262490,314008.7,930650,155140,181735.4,338450,107350,132273.3,592200
264980,342068.3,930650,155730,193375.4,338450,109250,148692.9,592200
266550,334101.7,930650,156290,191945.9,338450,110260,142155.8,592200
268040,343389.4,930650,156830,193493.2,338450,111210,149896.2,592200
269590,355700,930650,157380,202213,338450,112210,153487,592200
271110,363855.9,930650,157920,204354.9,338450,113190,159501,592200
273170,348064.3,930650,158880,201403.3,338450,114290,146661,592200
275170,344786.2,930650,159830,203142.6,338450,115340,141643.6,592200
277180,346825.3,930650,160790,203778.7,338450,116390,143046.6,592200
279240,352631.2,930650,161730,207955.9,338450,117510,144675.3,592200
281060,349949.2,930650,162680,207102.3,338450,118380,142846.9,592200
282890,355822.5,930650,163640,206120.2,338450,119250,149702.3,592200
284740,361175.3,930650,164620,205724.5,338450,120120,155450.8,592200
286610,371722.1,930650,165570,209549.1,338450,121040,162173,592200
287920,378954.5,930650,166260,215826.1,338450,121660,163128.4,592200
289260,392895.3,930650,166900,219637.3,338450,122360,173258,592200
290610,385931.7,930650,167580,216667.4,338450,123030,169264.3,592200
292000,381771.7,930650,168270,216101.9,338450,123730,165669.8,592200
288760,374776.3,930650,166290,213891.3,338450,122470,160885,592200
285590,369225.9,930650,164300,212517.8,338450,121290,156708.1,592200
282410,377857.7,930650,162350,215239,338450,120060,162618.7,592200
279220,363895.9,930650,160390,214934.1,338450,118830,148961.8,592200
276790,371804.8,930650,158640,215115.9,338450,118150,156688.9,592200
274330,357954.1,930650,156890,209632.1,338450,117440,148322,592200
271860,353135.4,930650,155110,205229.8,338450,116750,147905.6,592200
269430,344797.3,930650,153360,198672.7,338450,116070,146124.6,592200
266910,306026,930650,151600,181454.4,338450,115310,124571.6,592200
264440,280238.9,930650,149830,168388.1,338450,114610,111850.8,592200
261980,294219.2,930650,148100,170310.7,338450,113880,123908.5,592200
259460,297067.7,930650,146340,179233.7,338450,113120,117834,592200
257280,283781.7,930650,145120,173037.5,338450,112160,110744.2,592200
255180,266034,930650,143930,161154.8,338450,111250,104879.2,592200
252980,258164,930650,142700,154800.9,338450,110280,103363.1,592200
250890,271097.3,930650,141500,151998.5,338450,109390,119098.8,592200
249520,278433,930650,140930,154282.1,338450,108590,124150.9,592200
248120,284013.6,930650,140370,158262.3,338450,107750,125751.3,592200
246730,275262.8,930650,139810,151904.7,338450,106920,123358.1,592200
289880,268406.4,930650,169700,150511.6,338450,120180,117894.8,592200
286580,260433.2,930650,168000,143120.7,338450,118580,117312.5,592200
283270,277010.6,930650,166290,154479,338450,116980,122531.6,592200
279930,281476.9,930650,164590,163884.2,338450,115340,117592.7,592200
276630,258315.3,930650,162900,153176.5,338450,113730,105138.8,592200
274530,247907.1,930650,161620,137119.9,338450,112910,110787.2,592200
272340,223949.8,930650,160360,120511,338450,111980,103438.8,592200
270190,229997,930650,159080,124188.8,338450,111110,105808.2,592200
268070,239761.9,930650,157820,128745.9,338450,110250,111016,592200
264650,236151.3,930650,155770,126961.7,338450,108880,109189.6,592200
261190,219967,930650,153730,117571.3,338450,107460,102395.7,592200
257780,208054.9,930650,151690,112048.9,338450,106090,96006,592200
254360,212745.9,930650,149630,112664.2,338450,104730,100081.7,592200
251160,200733.4,930650,147740,109729.2,338450,103420,91004.2,592200
247940,217196.6,930650,145820,116580.2,338450,102120,100616.4,592200
244730,225828.3,930650,143920,123807.8,338450,100810,102020.5,592200
241540,224203,930650,142000,128464.9,338450,99540,95738.1,592200
236140,204488.3,930650,138450,119006,338450,97690,85482.3,592200
230750,196136.9,930650,134900,112603.5,338450,95850,83533.4,592200
225360,208055.8,930650,131340,111813.4,338450,94020,96242.4,592200
219930,224961.5,930650,127800,117515.7,338450,92130,107445.8,592200
214390,228599.1,930650,123970,120604.1,338450,90420,107995,592200
208750,223296.5,930650,120150,115546.3,338450,88600,107750.2,592200
203110,198840.6,930650,116320,105541.1,338450,86790,93299.5,592200
197560,199286.4,930650,112510,102485.1,338450,85050,96801.3,592200
192760,183696.2,930650,108930,88378,338450,83830,95318.2,592200
187970,165602.2,930650,105350,75897.4,338450,82620,89704.8,592200
183130,150902.4,930650,101750,65215.6,338450,81380,85686.8,592200
178380,163447.6,930650,98190,70395.1,338450,80190,93052.5,592200
172990,155754.7,930650,94840,67614.2,338450,78150,88140.5,592200
167460,156633.3,930650,91460,67383.4,338450,76000,89249.9,592200
162020,154316.9,930650,88130,65402.4,338450,73890,88914.5,592200
156570,160360.4,930650,84750,68676.1,338450,71820,91684.3,592200
150490,152420.6,930650,80830,62802.5,338450,69660,89618.1,592200
144390,143626.3,930650,76940,56213.1,338450,67450,87413.2,592200
138240,133898.7,930650,73030,49264.4,338450,65210,84634.3,592200
132150,126173.2,930650,69110,43615.9,338450,63040,82557.3,592200
126150,124656.1,930650,65360,40056.7,338450,60790,84599.4,592200
120160,126476.4,930650,61630,39655,338450,58530,86821.4,592200
114170,130318.7,930650,57890,41277.3,338450,56280,89041.4,592200
108180,124614.6,930650,54150,35239.9,338450,54030,89374.7,592200
106510,122251.2,930650,53050,32822.1,338450,53460,89429.1,592200
104980,113056,930650,51940,27558.8,338450,53040,85497.2,592200
103420,117680,930650,50810,27795.2,338450,52610,89884.8,592200
101780,117497.8,930650,49740,28377.4,338450,52040,89120.4,592200
100700,117127.4,930650,48790,29190.8,338450,51910,87936.6,592200
99540,115553.5,930650,47860,29544.3,338450,51680,86009.2,592200
98460,127280.2,930650,46900,34104.2,338450,51560,93176,592200
97360,138776.3,930650,45960,38806.2,338450,51400,99970.1,592200
96650,141950.2,930650,44950,38967.8,338450,51700,102982.4,592200
95920,144444.5,930650,43970,39337.5,338450,51950,105107,592200
95190,149108,930650,43010,42147.3,338450,52180,106960.7,592200
94430,169208,930650,42020,53167.7,338450,52410,116040.3,592200
102080,162544.2,930650,43940,48696.9,338450,58140,113847.3,592200
109700,159224.1,930650,45850,43181.4,338450,63850,116042.7,592200
117390,158347.1,930650,47770,40205.2,338450,69620,118141.9,592200
125010,159121.2,930650,49680,42568.4,338450,75330,116552.8,592200
132800,166571.2,930650,51870,41224.6,338450,80930,125346.6,592200
140450,182612.2,930650,54040,46197,338450,86410,136415.2,592200
148210,189350.8,930650,56230,52574.4,338450,91980,136776.4,592200
156020,181744.1,930650,58420,48192.4,338450,97600,133551.7,592200
164920,189695.9,930650,61460,49639.4,338450,103460,140056.5,592200
173980,195205.1,930650,64550,49791.8,338450,109430,145413.3,592200
182970,207187.8,930650,67590,56300.5,338450,115380,150887.3,592200
191990,214033.6,930650,70650,61172.4,338450,121340,152861.2,592200
198180,212850.3,930650,74740,64796.8,338450,123440,148053.5,592200
204490,207966.1,930650,78830,65980.8,338450,125660,141985.3,592200
210740,218323.2,930650,82900,72606.5,338450,127840,145716.7,592200
217020,209264,930650,86990,70276.1,338450,130030,138987.9,592200
223830,197558.5,930650,90950,67387.2,338450,132880,130171.3,592200
230510,206853.3,930650,94890,74728.3,338450,135620,132125,592200
237360,203257.1,930650,98870,64075.5,338450,138490,139181.6,592200
244080,196071.8,930650,102830,56673.5,338450,141250,139398.3,592200
250550,218796,930650,107040,69030.4,338450,143510,149765.6,592200
256990,220531.9,930650,111280,70742.6,338450,145710,149789.3,592200
263460,241864.8,930650,115500,75011.6,338450,147960,166853.2,592200
269910,268209.6,930650,119740,81166.7,338450,150170,187042.9,592200
273140,266039.2,930650,120400,77913.9,338450,152740,188125.3,592200
276410,270522.4,930650,121060,78043.5,338450,155350,192478.9,592200
279580,289273.3,930650,121710,89141.4,338450,157870,200131.9,592200
282790,296130.1,930650,122370,94957.7,338450,160420,201172.4,592200
284870,285084.4,930650,122260,94788.8,338450,162610,190295.6,592200
286920,301485.4,930650,122080,99321.5,338450,164840,202163.9,592200
289030,271664.4,930650,121940,94951.2,338450,167090,176713.2,592200
291120,285000.9,930650,121800,105265.7,338450,169320,179735.2,592200
291520,302130,930650,120530,107610.9,338450,170990,194519.1,592200
292130,298372.4,930650,119280,105218.6,338450,172850,193153.8,592200
292650,305108.5,930650,118020,107620.9,338450,174630,197487.6,592200
293070,293120.3,930650,116750,110764.5,338450,176320,182355.8,592200
292320,313053.8,930650,117600,106770.9,338450,174720,206282.9,592200
291460,328794.4,930650,118460,114229.8,338450,173000,214564.6,592200
290620,327212,930650,119290,116156.1,338450,171330,211055.9,592200
289770,335830.1,930650,120140,128326.9,338450,169630,207503.2,592200
288470,331005.6,930650,120670,133960.1,338450,167800,197045.5,592200
287140,335348.4,930650,121220,143513.6,338450,165920,191834.8,592200
285830,327785,930650,121760,140833.4,338450,164070,186951.6,592200
228370,322866.7,930650,97000,134591.7,338450,131370,188275,592200
227750,320899.3,930650,98280,136962.9,338450,129470,183936.4,592200
227040,317813.8,930650,99580,136243.5,338450,127460,181570.3,592200
226380,316863.1,930650,100890,137680.8,338450,125490,179182.3,592200
225680,297300.5,930650,102170,133200.1,338450,123510,164100.4,592200
228380,298289.1,930650,104150,137513.8,338450,124230,160775.3,592200
231040,309928.8,930650,106100,138685.6,338450,124940,171243.2,592200
233760,314343.2,930650,108080,142502.4,338450,125680,171840.8,592200
236410,312741,930650,110030,146104.4,338450,126380,166636.6,592200
238570,320844.5,930650,112090,151443,338450,126480,169401.5,592200
240700,313552.6,930650,114160,146503.4,338450,126540,167049.2,592200
242950,290575.1,930650,116230,132574,338450,126720,158001.1,592200
245090,285302.7,930650,118300,130317,338450,126790,154985.7,592200
247720,285091.1,930650,120360,130677.5,338450,127360,154413.6,592200
250440,286362.3,930650,122460,129660.9,338450,127980,156701.4,592200
253060,304480.6,930650,124540,143488.9,338450,128520,160991.7,592200
255740,314096.8,930650,126620,150485.3,338450,129120,163611.5,592200
256380,330507.1,930650,126900,161179.2,338450,129480,169327.9,592200
257010,301761.4,930650,127180,146454.7,338450,129830,155306.7,592200
257680,294777.8,930650,127440,142866.3,338450,130240,151911.5,592200
258340,262802.1,930650,127740,132456.4,338450,130600,130345.7,592200
259380,269672.5,930650,128560,128335.7,338450,130820,141336.8,592200
260470,273315.2,930650,129390,129485.5,338450,131080,143829.7,592200
261510,256599.4,930650,130220,117246.6,338450,131290,139352.8,592200
262580,254229.3,930650,131030,115809,338450,131550,138420.3,592200
263760,255191.6,930650,131890,118333.8,338450,131870,136857.8,592200
265060,254230,930650,132770,122692.5,338450,132290,131537.5,592200
266210,234060,930650,133630,110941.6,338450,132580,123118.4,592200
267430,236804.1,930650,134490,115778.2,338450,132940,121025.9,592200
266090,232361.6,930650,134240,112501.7,338450,131850,119859.9,592200
264680,242041.7,930650,133950,118970.8,338450,130730,123070.9,592200
263240,242730.9,930650,133670,121228.1,338450,129570,121502.8,592200
261870,242525.2,930650,133400,123242,338450,128470,119283.2,592200
259720,245758.9,930650,133280,127661.2,338450,126440,118097.7,592200
257620,232938.7,930650,133180,122832.5,338450,124440,110106.2,592200
255530,236527.4,930650,133080,129942.2,338450,122450,106585.2,592200
253400,235824.8,930650,132950,125233.6,338450,120450,110591.2,592200
251170,238291.9,930650,132440,124993.7,338450,118730,113298.2,592200
248910,244283.1,930650,131930,127700.1,338450,116980,116583,592200
246640,241402.3,930650,131390,128343.1,338450,115250,113059.2,592200
244410,241992.1,930650,130890,124861.5,338450,113520,117130.6,592200
240420,239041.6,930650,128900,123904.5,338450,111520,115137.1,592200
236350,227897.7,930650,126950,118476.7,338450,109400,109421,592200
232350,234612.1,930650,124970,123959.2,338450,107380,110652.9,592200
228380,234612.1,930650,123010,123959.2,338450,105370,110652.9,592200
225000,251393.6,930650,121920,137981,338450,103080,113412.6,592200
221730,244699.4,930650,120820,134187.8,338450,100910,110511.6,592200
218410,246738.5,930650,119730,139726.9,338450,98680,107011.6,592200
215190,225482.7,930650,118650,137293.4,338450,96540,88189.3,592200
210770,213770.2,930650,116580,128733.5,338450,94190,85036.7,592200
206290,204636.5,930650,114480,126115.7,338450,91810,78520.8,592200
201950,207000.2,930650,112410,121334.3,338450,89540,85665.9,592200
197550,185879.2,930650,110340,108397.8,338450,87210,77481.4,592200
199520,182533.7,930650,110930,110450.3,338450,88590,72083.4,592200
201420,185048.3,930650,111530,113604.6,338450,89890,71443.7,592200
203320,189590.9,930650,112130,115568.3,338450,91190,74022.6,592200
205310,191460.4,930650,112740,114961.6,338450,92570,76498.8,592200
206390,185842.2,930650,112810,112189.9,338450,93580,73652.3,592200
207660,205558,930650,112910,113073.6,338450,94750,92484.4,592200
208780,220440.3,930650,113000,117981,338450,95780,102459.3,592200
209940,223248.6,930650,113090,118584.5,338450,96850,104664.1,592200
211220,231644.3,930650,113500,121516.4,338450,97720,110127.9,592200
212500,241184.3,930650,113900,126465.5,338450,98600,114718.8,592200
213730,235579.6,930650,114330,118466,338450,99400,117113.6,592200
214980,233592.6,930650,114730,114319.4,338450,100250,119273.2,592200
215590,230842.6,930650,114970,110931.5,338450,100620,119911.1,592200
216240,226203.4,930650,115240,108304.3,338450,101000,117899.1,592200
216830,218901.3,930650,115470,101898.1,338450,101360,117003.2,592200
217420,218276.3,930650,115700,97302.3,338450,101720,120974,592200
217670,214322.7,930650,115680,93333.1,338450,101990,120989.6,592200
217920,215473.9,930650,115670,92706.2,338450,102250,122767.7,592200
218130,175015.6,930650,115640,79520.6,338450,102490,95495,592200
218360,174229.4,930650,115630,75192.9,338450,102730,99036.5,592200
218450,202093.6,930650,115450,84818.8,338450,103000,117274.8,592200
218500,219883.4,930650,115310,98192.2,338450,103190,121691.2,592200
218520,211401.8,930650,115140,94857.9,338450,103380,116543.9,592200
218620,195899.3,930650,114980,84791.2,338450,103640,111108.1,592200
214820,193327.9,930650,112960,80581.9,338450,101860,112746,592200
211020,180346.9,930650,110900,73954.7,338450,100120,106392.2,592200
207230,177566.3,930650,108860,75970.8,338450,98370,101595.5,592200
203410,167659.5,930650,106820,73309.4,338450,96590,94350.1,592200
199960,168279,930650,104820,70506.4,338450,95140,97772.6,592200
196540,155868.9,930650,102800,63239.2,338450,93740,92629.7,592200
193070,147223.3,930650,100770,56965.7,338450,92300,90257.6,592200
189670,146202.4,930650,98750,57466.3,338450,90920,88736.1,592200
185090,151746.3,930650,96110,60779.1,338450,88980,90967.2,592200
180550,156488.1,930650,93490,65624.3,338450,87060,90863.8,592200
176000,158425.9,930650,90850,69769.9,338450,85150,88656,592200
171440,164818.1,930650,88210,74598.1,338450,83230,90220,592200
167690,161182,930650,85540,70453.1,338450,82150,90728.9,592200
163960,156501.4,930650,82880,66472.5,338450,81080,90028.9,592200
160240,164967.6,930650,80210,72360.3,338450,80030,92607.3,592200
156570,172665,930650,77540,79218.1,338450,79030,93446.9,592200
152340,173034.3,930650,74510,79331.3,338450,77830,93703,592200
148190,158100.3,930650,71500,68696.7,338450,76690,89403.6,592200
144000,146962.6,930650,68490,61035.8,338450,75510,85926.8,592200
133020,142998.4,930650,71130,61066.5,338450,61890,81931.9,592200
128940,135915.6,930650,68680,55156.3,338450,60260,80759.3,592200
124860,131219.3,930650,66240,52587.4,338450,58620,78631.9,592200
120840,118633,930650,63790,44981.3,338450,57050,73651.7,592200
116770,109649.7,930650,61370,38902.7,338450,55400,70747,592200
114660,110389.3,930650,59910,38925.8,338450,54750,71463.5,592200
112620,109576.4,930650,58480,37583.4,338450,54140,71993,592200
110520,107980.5,930650,57010,37134.1,338450,53510,70846.4,592200
108450,102615.6,930650,55580,33571.4,338450,52870,69044.2,592200
105810,100498.1,930650,53590,32933.2,338450,52220,67564.9,592200
103200,104149,930650,51610,35434.2,338450,51590,68714.8,592200
100640,99815.9,930650,49630,32971.9,338450,51010,66844,592200
98020,103441.5,930650,47630,35827.7,338450,50390,67613.8,592200
95420,109030,930650,46060,39850.8,338450,49360,69179.2,592200
92790,108082.4,930650,44470,38965.2,338450,48320,69117.2,592200
90280,106940.6,930650,42920,37357.6,338450,47360,69583,592200
87720,106160.8,930650,41340,36104.8,338450,46380,70056,592200
87100,94842,930650,40540,28027.3,338450,46560,66814.7,592200
86520,92720.3,930650,39740,26346.3,338450,46780,66374,592200
85860,95863.8,930650,38950,28480.3,338450,46910,67383.5,592200
85320,97000.6,930650,38180,29439.8,338450,47140,67560.8,592200
85350,95582.5,930650,37870,28962.6,338450,47480,66619.9,592200
85380,97496.6,930650,37580,29944.9,338450,47800,67551.7,592200
85440,101423.8,930650,37310,32608.1,338450,48130,68815.7,592200
85510,101353.1,930650,37000,32013.6,338450,48510,69339.5,592200
85370,103720.3,930650,36360,33862,338450,49010,69858.3,592200
85060,106562.7,930650,35650,35696.1,338450,49410,70866.6,592200
84890,105266.5,930650,35000,34510.1,338450,49890,70756.4,592200
84680,101444.5,930650,34300,31494,338450,50380,69950.5,592200
82990,104510.2,930650,34100,33588.9,338450,48890,70921.3,592200
81330,103793.2,930650,33870,33336,338450,47460,70457.2,592200
79620,102132.1,930650,33650,32205.3,338450,45970,69926.8,592200
77840,104720.9,930650,33430,34422.2,338450,44410,70298.7,592200
76040,103460.2,930650,33310,33810.9,338450,42730,69649.3,592200
74300,102509.3,930650,33190,33441.2,338450,41110,69068.1,592200
72510,102038.6,930650,33090,32985.8,338450,39420,69052.8,592200
70800,106052.3,930650,32990,36271.9,338450,37810,69780.4,592200
67820,108327.5,930650,32430,36682.9,338450,35390,71644.6,592200
64880,110164.2,930650,31900,38776.7,338450,32980,71387.5,592200
61980,115783.3,930650,31380,42252.9,338450,30600,73530.4,592200
59050,116755.6,930650,30830,42637.3,338450,28220,74118.3,592200
58330,120815.8,930650,30800,45260.3,338450,27530,75555.5,592200
57560,129052.8,930650,30750,51816.4,338450,26810,77236.4,592200
56780,123619.2,930650,30710,48476.5,338450,26070,75142.7,592200
56120,123627.8,930650,30700,48961.8,338450,25420,74666,592200
56120,125777,930650,30860,51314.8,338450,25260,74462.2,592200
56190,116966,930650,31020,44558.8,338450,25170,72407.2,592200
56230,115678.9,930650,31190,44294.5,338450,25040,71384.4,592200
56310,111654,930650,31380,40779.2,338450,24930,70874.8,592200
56570,112597.8,930650,31630,41745.9,338450,24940,70851.9,592200
56820,106367.9,930650,31880,37457.3,338450,24940,68910.6,592200
57090,104865.5,930650,32150,36356.4,338450,24940,68509.1,592200
57410,101164.1,930650,32420,33583.1,338450,24990,67581,592200
59500,98388.4,930650,33120,32385.3,338450,26380,66003.1,592200
61570,99630.3,930650,33820,32565.2,338450,27750,67065.1,592200
63660,104252.9,930650,34530,35581.8,338450,29130,68671.1,592200
65790,106490.4,930650,35240,37686.7,338450,30550,68803.7,592200
67600,100252,930650,35860,32667.3,338450,31740,67584.7,592200
69410,99807.3,930650,36500,31831,338450,32910,67976.3,592200
71220,101559.2,930650,37130,31515.5,338450,34090,70043.7,592200
72990,105287.6,930650,37750,33105,338450,35240,72182.6,592200
74390,105883.5,930650,38400,32770.5,338450,35990,73113,592200
75770,116223.1,930650,39040,37749.3,338450,36730,78473.8,592200
77230,120548.4,930650,39680,38747.6,338450,37550,81800.8,592200
78620,116241.4,930650,40320,35648.2,338450,38300,80593.2,592200
83600,122773.5,930650,44070,40347.6,338450,39530,82425.9,592200
88600,129504.7,930650,47830,45136,338450,40770,84368.7,592200
93560,134771.3,930650,51570,47345.7,338450,41990,87425.6,592200
98500,136027.7,930650,55330,47378.4,338450,43170,88649.3,592200
104050,129705.8,930650,59290,44821.4,338450,44760,84884.4,592200
109650,130779.5,930650,63270,45645.3,338450,46380,85134.2,592200
115300,135264,930650,67260,47489.6,338450,48040,87774.4,592200
120920,128473.6,930650,71230,43913.5,338450,49690,84560.1,592200
126420,135515.2,930650,75170,49265.9,338450,51250,86249.3,592200
131980,144683.3,930650,79150,55321.2,338450,52830,89362.1,592200
137540,155501.3,930650,83090,63055.2,338450,54450,92446.1,592200
143090,164138.1,930650,87060,70885.2,338450,56030,93252.9,592200
148470,165274.7,930650,89660,72920.9,338450,58810,92353.8,592200
153800,164655.5,930650,92230,72963.6,338450,61570,91691.9,592200
159080,153561.6,930650,94810,66438.2,338450,64270,87123.4,592200
164490,164875.4,930650,97390,74706.1,338450,67100,90169.3,592200
169760,173244.2,930650,100010,80575.4,338450,69750,92668.8,592200
175040,196093,930650,102600,98624.8,338450,72440,97468.2,592200
180330,197079.3,930650,105210,98877.7,338450,75120,98201.6,592200
185610,169562.3,930650,107820,77757.7,338450,77790,91804.6,592200
190160,189444.8,930650,109820,93716.6,338450,80340,95728.2,592200
194780,188970.8,930650,111830,92636.9,338450,82950,96333.9,592200
199270,200066.9,930650,113830,100328,338450,85440,99738.9,592200
203890,200154.3,930650,115830,99825.7,338450,88060,100328.6,592200
197470,210957.3,930650,110830,106861.8,338450,86640,104095.5,592200
191150,197043.7,930650,105850,94695.8,338450,85300,102347.9,592200
184820,194589.5,930650,100880,91510.6,338450,83940,103078.9,592200
178350,181206.1,930650,95850,80137.2,338450,82500,101068.9,592200
172040,173792.7,930650,90910,80667.3,338450,81130,93125.4,592200
165670,187785.7,930650,85970,81802.9,338450,79700,105982.8,592200
159370,184658.5,930650,81030,81333.8,338450,78340,103324.7,592200
102590,179073.2,930650,65220,81278.3,338450,37370,97794.9,592200
101510,182161.9,930650,63440,77040,338450,38070,105121.9,592200
100490,189088.7,930650,61670,81658.8,338450,38820,107429.9,592200
99450,181108.7,930650,59920,72405.6,338450,39530,108703.1,592200
98360,177360.9,930650,58140,71482.4,338450,40220,105878.5,592200
97300,173213.9,930650,56970,68631,338450,40330,104582.9,592200
96120,161194.1,930650,55790,59088,338450,40330,102106.1,592200
94980,138592.7,930650,54620,44934.9,338450,40360,93657.8,592200
93840,136783.2,930650,53450,43961.7,338450,40390,92821.5,592200
92330,123332,930650,52000,33680,338450,40330,89652,592200
90840,119125,930650,50530,29017.3,338450,40310,90107.7,592200
89350,110639.1,930650,49080,23544.2,338450,40270,87094.9,592200
87870,95334.5,930650,47630,18754.1,338450,40240,76580.4,592200
86290,98658.4,930650,46110,14279.3,338450,40180,84379.1,592200
84710,99657.5,930650,44600,14145.1,338450,40110,85512.4,592200
83130,98905.8,930650,43090,14973.6,338450,40040,83932.2,592200
81500,95248.8,930650,41580,13560.5,338450,39920,81688.3,592200
85110,99801,930650,44210,14647.9,338450,40900,85153.1,592200
88650,106908,930650,46830,18311,338450,41820,88597,592200
92270,111665,930650,49450,24123.5,338450,42820,87541.5,592200
95840,117295.7,930650,52090,23323,338450,43750,93972.7,592200
99700,114964.8,930650,55070,21535.3,338450,44630,93429.5,592200
103710,107418.1,930650,58100,19344.9,338450,45610,88073.2,592200
107630,112947.3,930650,61090,22758.5,338450,46540,90188.8,592200
111520,110380.6,930650,64090,22854,338450,47430,87526.6,592200
116300,124592.7,930650,68010,26542,338450,48290,98050.7,592200
120990,128102.9,930650,71910,27723,338450,49080,100379.9,592200
125710,130448.8,930650,75810,29791.7,338450,49900,100657.1,592200
130430,133380.2,930650,79730,29806.5,338450,50700,103573.7,592200
130640,133173.6,930650,80090,31261.1,338450,50550,101912.5,592200
130790,145576.7,930650,80470,40054.2,338450,50320,105522.5,592200
131040,158026,930650,80850,52735.5,338450,50190,105290.5,592200
131150,180600,930650,81210,76893,338450,49940,103707,592200
133370,207233.6,930650,83800,96031.9,338450,49570,111201.7,592200
135530,171708.6,930650,86400,73208.3,338450,49130,98500.3,592200
137730,148658.2,930650,88990,59230.9,338450,48740,89427.3,592200
139840,158034,930650,91560,68078.5,338450,48280,89955.5,592200
140330,155877.2,930650,91970,66671.6,338450,48360,89205.6,592200
140770,143844.7,930650,92400,59483.1,338450,48370,84361.6,592200
141200,144882.7,930650,92790,63981.8,338450,48410,80900.9,592200
141650,160454.7,930650,93210,73637.3,338450,48440,86817.4,592200
142610,191733,930650,91230,90916.7,338450,51380,100816.3,592200
143470,192366.1,930650,89260,90702.1,338450,54210,101664,592200
144360,207359,930650,87280,100185,338450,57080,107174,592200
145260,192413.3,930650,85310,87950.8,338450,59950,104462.5,592200
148600,199707.6,930650,85680,90754.5,338450,62920,108953.1,592200
151880,191883.8,930650,86060,84151.8,338450,65820,107732,592200
155210,199072.3,930650,86400,88060.8,338450,68810,111011.5,592200
158580,203954.6,930650,86810,97902,338450,71770,106052.6,592200
164670,207498.3,930650,90000,95402.5,338450,74670,112095.8,592200
170720,191194.1,930650,93200,81162.3,338450,77520,110031.8,592200
176780,195562.6,930650,96380,83190.5,338450,80400,112372.1,592200
182880,192737,930650,99590,87453.6,338450,83290,105283.4,592200
187800,173921.9,930650,101700,85909,338450,86100,88012.9,592200
192680,214152.8,930650,103810,102867.5,338450,88870,111285.3,592200
197580,202379.4,930650,105940,85531.3,338450,91640,116848.1,592200
202430,191003.3,930650,108030,79588.5,338450,94400,111414.8,592200
206160,188626.2,930650,108940,67045,338450,97220,121581.2,592200
209880,167802.6,930650,109850,52493.7,338450,100030,115308.9,592200
213540,209893.6,930650,110730,74060.9,338450,102810,135832.7,592200
217320,201233.7,930650,111630,65191.2,338450,105690,136042.5,592200
221560,209421.1,930650,113090,70105.8,338450,108470,139315.3,592200
225850,238286.3,930650,114530,90848.8,338450,111320,147437.5,592200
230100,231761.5,930650,115990,83643.5,338450,114110,148118,592200
234370,229119.5,930650,117420,82552.3,338450,116950,146567.2,592200
237130,260322.8,930650,118760,99844.7,338450,118370,160478.1,592200
239880,285203.9,930650,120110,116643.5,338450,119770,168560.4,592200
242620,268608.4,930650,121440,96941.4,338450,121180,171667,592200
245380,267916.2,930650,122790,99979.8,338450,122590,167936.4,592200
247580,273166.9,930650,124150,100447.3,338450,123430,172719.6,592200
249750,288065.5,930650,125490,124695.7,338450,124260,163369.8,592200
251910,330669.9,930650,126840,134399.3,338450,125070,196270.6,592200
254120,312378.5,930650,128190,127639.9,338450,125930,184738.6,592200
256590,305821.9,930650,129380,133795.9,338450,127210,172026,592200
259050,307820.4,930650,130570,129259.5,338450,128480,178560.9,592200
261530,347255.8,930650,131770,148434.9,338450,129760,198820.9,592200
264010,343226.9,930650,132970,140161.2,338450,131040,203065.7,592200
262090,304731.1,930650,131430,122860.8,338450,130660,181870.3,592200
260200,301115.3,930650,129820,124407.3,338450,130380,176708,592200
258250,290880.7,930650,128220,124061.7,338450,130030,166819,592200
256430,273214.4,930650,126660,109631.3,338450,129770,163583.1,592200
253730,279621.4,930650,125060,115309.4,338450,128670,164312,592200
251080,280898.1,930650,123470,111631.2,338450,127610,169266.9,592200
248440,286515.3,930650,121850,119398.6,338450,126590,167116.7,592200
245790,255362.6,930650,120250,107604.7,338450,125540,147757.9,592200
241880,257726.2,930650,118320,111920.9,338450,123560,145805.3,592200
238080,253378.4,930650,116370,106179.4,338450,121710,147199,592200
234240,252981.3,930650,114430,107254.6,338450,119810,145726.7,592200
230390,249293.9,930650,112510,104543.5,338450,117880,144750.4,592200
223450,280203.3,930650,109460,120439,338450,113990,159764.3,592200
216510,250870.9,930650,106460,107318.3,338450,110050,143552.6,592200
209620,260327.3,930650,103420,115917.2,338450,106200,144410.1,592200
202630,233526.2,930650,100370,98116.3,338450,102260,135409.9,592200
195430,236228.6,930650,96810,99564.9,338450,98620,136663.7,592200
188090,224529.9,930650,93230,92957,338450,94860,131572.9,592200
180950,236636.1,930650,89670,97616.8,338450,91280,139019.3,592200
161020,235979.1,930650,81170,91559,338450,79850,144420.1,592200
151950,229817.1,930650,76710,85414.5,338450,75240,144402.6,592200
142780,196648.2,930650,72210,75520.9,338450,70570,121127.3,592200
133650,220043.6,930650,67720,82350.5,338450,65930,137693.1,592200
124480,226731,930650,63230,84688.8,338450,61250,142042.2,592200
120800,223725.8,930650,61110,84135.2,338450,59690,139590.6,592200
117230,231657.7,930650,59020,87479.6,338450,58210,144178.1,592200
113580,228854.1,930650,56910,86897.1,338450,56670,141957,592200
109940,228933.2,930650,54780,84938.6,338450,55160,143994.6,592200
106670,215624.2,930650,52890,78207.1,338450,53780,137417.1,592200
103460,195318.1,930650,50960,64205.9,338450,52500,131112.2,592200
100120,183479.8,930650,49030,64757.1,338450,51090,118722.7,592200
96900,171548.4,930650,47080,58166.9,338450,49820,113381.5,592200
93460,176216.5,930650,44900,61936.3,338450,48560,114280.2,592200
89950,156328.4,930650,42700,50273.3,338450,47250,106055.1,592200
86490,140381.6,930650,40510,39464.9,338450,45980,100916.7,592200
83060,147065.1,930650,38310,45078.4,338450,44750,101986.7,592200
81830,135311.9,930650,37520,40154.7,338450,44310,95157.2,592200
80670,134843.1,930650,36730,43678.8,338450,43940,91164.3,592200
79430,132013.6,930650,35920,40955.9,338450,43510,91057.7,592200
78240,129651.3,930650,35120,41234.6,338450,43120,88416.7,592200
77210,129592.9,930650,34470,41654.1,338450,42740,87938.8,592200
76190,131374.6,930650,33840,42944.7,338450,42350,88429.9,592200
75140,113000.9,930650,33200,30670.2,338450,41940,82330.7,592200
74080,116520.3,930650,32560,31535.7,338450,41520,84984.6,592200
72980,116235,930650,31840,31832.5,338450,41140,84402.5,592200
71980,104315.9,930650,31170,24639.3,338450,40810,79676.6,592200
70930,112811,930650,30500,30394.9,338450,40430,82416.1,592200
69870,104827.6,930650,29810,26475.9,338450,40060,78351.7,592200
66600,102640.1,930650,28210,24912.9,338450,38390,77727.2,592200
63310,98788.9,930650,26580,24126.6,338450,36730,74662.3,592200
60050,102626.3,930650,24960,28001.3,338450,35090,74625,592200
56810,101878.3,930650,23360,28566.3,338450,33450,73312,592200
53540,86557.3,930650,21920,18922.5,338450,31620,67634.8,592200
50360,83970.4,930650,20460,16972.3,338450,29900,66998.1,592200
47160,82461.3,930650,19010,16429.7,338450,28150,66031.6,592200
43850,80695.4,930650,17560,15254.5,338450,26290,65440.9,592200
40700,74494.1,930650,16020,10389.5,338450,24680,64104.6,592200
37470,80816.5,930650,14490,12754.2,338450,22980,68062.3,592200
34270,79314.6,930650,12980,13082,338450,21290,66232.6,592200
31070,75349,930650,11450,9514.4,338450,19620,65834.6,592200
29760,77479.9,930650,10880,10458.6,338450,18880,67021.3,592200
28440,81621.2,930650,10280,13820.6,338450,18160,67800.6,592200
27100,83325.6,930650,9720,14644.7,338450,17380,68680.9,592200
25800,77343.1,930650,9160,11201.5,338450,16640,66141.6,592200
24420,73056.1,930650,8640,8230.2,338450,15780,64825.9,592200
23070,73996.4,930650,8110,8412.8,338450,14960,65583.6,592200
21740,73417,930650,7600,7720.4,338450,14140,65696.6,592200
20420,78106.1,930650,7070,10050.5,338450,13350,68055.6,592200
19130,78579.9,930650,6560,10362.2,338450,12570,68217.7,592200
17880,76138.4,930650,6040,8049.3,338450,11840,68089.1,592200
16630,74344.4,930650,5520,6878.5,338450,11110,67465.9,592200
15360,78089.5,930650,5010,7971.1,338450,10350,70118.4,592200
16480,78045.6,930650,5380,7571.5,338450,11100,70474.1,592200
17540,76139.5,930650,5760,6297.8,338450,11780,69841.7,592200
18600,74530.8,930650,6120,5402,338450,12480,69128.8,592200
19680,73731.7,930650,6500,5567.1,338450,13180,68164.6,592200
20980,73341.4,930650,6910,5603.4,338450,14070,67738,592200
22210,71067.6,930650,7300,5349.9,338450,14910,65717.7,592200
23510,72739.7,930650,7700,6370.6,338450,15810,66369.1,592200
24740,78169,930650,8070,9846.5,338450,16670,68322.5,592200
26120,79794.1,930650,8610,12282.9,338450,17510,67511.2,592200
27540,83082,930650,9180,13960,338450,18360,69122,592200
28900,81041.7,930650,9710,12351.5,338450,19190,68690.2,592200
30270,81592.3,930650,10290,12894.9,338450,19980,68697.4,592200
31570,83911.1,930650,10740,13566,338450,20830,70345.1,592200
32770,80027.7,930650,11200,10133.3,338450,21570,69894.4,592200
34010,79981.6,930650,11670,11102.2,338450,22340,68879.4,592200
35300,82079.7,930650,12130,11180.1,338450,23170,70899.6,592200
36070,82891.4,930650,12230,9684.9,338450,23840,73206.5,592200
36910,86002.5,930650,12320,12555.6,338450,24590,73446.9,592200
37780,85038.2,930650,12430,10966.2,338450,25350,74072,592200
38640,82686.8,930650,12540,8942.5,338450,26100,73744.3,592200
39680,85557.8,930650,12830,9342.8,338450,26850,76215,592200
40760,87807.3,930650,13150,10713.4,338450,27610,77093.9,592200
41890,91468.1,930650,13480,12783.2,338450,28410,78684.9,592200
42910,94943.6,930650,13780,15040.9,338450,29130,79902.7,592200
43780,97260.2,930650,13710,15932.6,338450,30070,81327.6,592200
44610,96152.1,930650,13690,15174.2,338450,30920,80977.9,592200
45470,94122.1,930650,13630,14175.2,338450,31840,79946.9,592200
46300,87093.1,930650,13560,10997.6,338450,32740,76095.5,592200
47240,85029,930650,13450,10432.4,338450,33790,74596.6,592200
48080,86871.9,930650,13310,13105.1,338450,34770,73766.8,592200
49020,86774.4,930650,13170,14023.9,338450,35850,72750.5,592200
49990,81740.7,930650,13030,11013.5,338450,36960,70727.2,592200
50970,77580.2,930650,13020,9423.9,338450,37950,68156.3,592200
51950,73342.2,930650,13020,6366.2,338450,38930,66976,592200
52940,72853.5,930650,12970,4685,338450,39970,68168.5,592200
53910,71678.6,930650,12960,4745.1,338450,40950,66933.5,592200
52800,70850.4,930650,12710,3996.4,338450,40090,66854,592200
51720,71298.7,930650,12490,4296.2,338450,39230,67002.5,592200
50680,72559.1,930650,12250,4116.5,338450,38430,68442.6,592200
49600,72052.3,930650,12010,4526.5,338450,37590,67525.8,592200
48580,74617.7,930650,11820,4834.3,338450,36760,69783.4,592200
47660,75732.4,930650,11630,4578.1,338450,36030,71154.3,592200
46770,76058.2,930650,11440,4562.6,338450,35330,71495.6,592200
21040,80350.5,930650,4580,7128.6,338450,16460,73221.9,592200
20690,90312.4,930650,4450,13107,338450,16240,77205.4,592200
20320,91993.2,930650,4330,13552.4,338450,15990,78440.8,592200
20020,84922.5,930650,4230,9133.8,338450,15790,75788.7,592200
19700,85517.6,930650,4110,9906,338450,15590,75611.6,592200
19030,86159.7,930650,3970,10083.5,338450,15060,76076.2,592200
18450,81953.6,930650,3870,7895.9,338450,14580,74057.7,592200
17880,79905.8,930650,3760,7462.7,338450,14120,72443.1,592200
17340,80753.7,930650,3630,8572,338450,13710,72181.7,592200
16740,80355.6,930650,3540,7228.8,338450,13200,73126.8,592200
16170,85108.8,930650,3460,9757.1,338450,12710,75351.7,592200
15570,79728.3,930650,3360,7030.8,338450,12210,72697.5,592200
14950,75493.7,930650,3280,5811.6,338450,11670,69682.1,592200
14240,73805.2,930650,3110,5647.8,338450,11130,68157.4,592200
13510,76727.4,930650,2910,7247.2,338450,10600,69480.2,592200
12790,76779.5,930650,2700,7509.5,338450,10090,69270,592200
12110,75811.7,930650,2520,6983.1,338450,9590,68828.6,592200
12280,74892.4,930650,2620,7052.4,338450,9660,67840,592200
12540,74227.2,930650,2720,6592.2,338450,9820,67635,592200
12790,75739.9,930650,2830,6887.1,338450,9960,68852.8,592200
12960,79449,930650,2930,8338.1,338450,10030,71110.9,592200
13210,79568.6,930650,3000,8151.2,338450,10210,71417.4,592200
13430,81303.9,930650,3050,8499.4,338450,10380,72804.5,592200
13670,86973.3,930650,3100,10073.9,338450,10570,76899.4,592200
13880,86253,930650,3170,10175.7,338450,10710,76077.3,592200
14360,84511.9,930650,3390,10128.1,338450,10970,74383.8,592200
14840,82760.5,930650,3630,10511.2,338450,11210,72249.3,592200
15280,82160.5,930650,3860,10034.1,338450,11420,72126.4,592200
15770,82454.1,930650,4080,9588.2,338450,11690,72865.9,592200
15890,85905.7,930650,3960,9465.7,338450,11930,76440,592200
16010,88854.6,930650,3870,9732.9,338450,12140,79121.7,592200
16140,74010.6,930650,3760,9354.7,338450,12380,64655.9,592200
16270,68230,930650,3660,8926.1,338450,12610,59303.9,592200
16530,68867.7,930650,3690,9950.2,338450,12840,58917.5,592200
16760,69760,930650,3740,10712,338450,13020,59048,592200
16980,77245.6,930650,3770,11920,338450,13210,65325.6,592200
17150,84525.7,930650,3790,11592.7,338450,13360,72933,592200
17470,84096.7,930650,3870,10895,338450,13600,73201.7,592200
17760,89333.3,930650,3950,12605.2,338450,13810,76728.1,592200
18050,94331.5,930650,4030,17188.8,338450,14020,77142.7,592200
18360,88767.9,930650,4110,16936.4,338450,14250,71831.5,592200
18770,88918,930650,4440,15957.7,338450,14330,72960.3,592200
19200,92200,930650,4780,15623.5,338450,14420,76576.5,592200
19600,90873.4,930650,5090,17029.4,338450,14510,73844,592200
20050,90363.8,930650,5430,17855.8,338450,14620,72508,592200
20500,98903.9,930650,5820,22235.5,338450,14680,76668.4,592200
20920,105581.8,930650,6200,25472.2,338450,14720,80109.6,592200
21350,101176.9,930650,6580,22757.7,338450,14770,78419.2,592200
21800,102868.4,930650,6960,22907,338450,14840,79961.4,592200
22220,104256.5,930650,7240,22164.8,338450,14980,82091.7,592200
22560,110278.7,930650,7530,23429.5,338450,15030,86849.2,592200
22980,111152.7,930650,7810,26337,338450,15170,84815.7,592200
23330,108051.8,930650,8070,27432.6,338450,15260,80619.2,592200
24340,109659.5,930650,8320,29184.5,338450,16020,80475,592200
25360,108041.1,930650,8590,28529.7,338450,16770,79511.4,592200
26430,112606.1,930650,8840,30158,338450,17590,82448.1,592200
27530,120743.7,930650,9100,32093.3,338450,18430,88650.4,592200
28790,127674.8,930650,9380,33832.9,338450,19410,93841.9,592200
30090,129926.1,930650,9650,37797.8,338450,20440,92128.3,592200
31370,130630.3,930650,9920,37502.2,338450,21450,93128.1,592200
32680,129673.5,930650,10200,34716.2,338450,22480,94957.3,592200
34180,124221.6,930650,10640,31452,338450,23540,92769.6,592200
35670,121707.8,930650,11050,29623.7,338450,24620,92084.1,592200
37190,119779.4,930650,11490,27806.4,338450,25700,91973,592200
38650,118677.8,930650,11920,25040.6,338450,26730,93637.2,592200
44850,118800.7,930650,15280,24522.2,338450,29570,94278.5,592200
51170,118641,930650,18650,26261.1,338450,32520,92379.9,592200
57390,116557.7,930650,22020,25775.6,338450,35370,90782.1,592200
63700,107924.3,930650,25390,22372.4,338450,38310,85551.9,592200
68950,112047.5,930650,27850,23636.6,338450,41100,88410.9,592200
74270,110298.5,930650,30330,24447.1,338450,43940,85851.4,592200
79630,109988.3,930650,32800,26155.5,338450,46830,83832.8,592200
84900,115356.8,930650,35280,29219.8,338450,49620,86137,592200
90750,112338.3,930650,38270,28321.9,338450,52480,84016.4,592200
96610,114612.9,930650,41280,30592.6,338450,55330,84020.3,592200
102460,142455.2,930650,44310,38866.5,338450,58150,103588.7,592200
108260,154550.3,930650,47340,42431.7,338450,60920,112118.6,592200
113710,168593.4,930650,48790,49501,338450,64920,119092.4,592200
119080,181835.7,930650,50260,55463.7,338450,68820,126372,592200
124420,180857.4,930650,51700,58820.2,338450,72720,122037.2,592200
129860,195597.9,930650,53160,63266.8,338450,76700,132331.1,592200
134650,186730.8,930650,54130,56147.3,338450,80520,130583.5,592200
139420,199603.8,930650,55090,61194.6,338450,84330,138409.2,592200
144220,228302.4,930650,56020,72618.9,338450,88200,155683.5,592200
149010,224476.7,930650,56990,74059.6,338450,92020,150417.1,592200
154410,221284.6,930650,58600,75067.3,338450,95810,146217.3,592200
159840,224258.7,930650,60220,74783.2,338450,99620,149475.5,592200
165220,226705.1,930650,61850,74439.9,338450,103370,152265.2,592200
170660,238547.5,930650,63450,76134.8,338450,107210,162412.7,592200
172650,239635.6,930650,63790,83342.1,338450,108860,156293.5,592200
174780,231702.3,930650,64140,85406.3,338450,110640,146296,592200
176770,237982.3,930650,64470,86517.9,338450,112300,151464.4,592200
178900,236416.4,930650,64810,89833.8,338450,114090,146582.6,592200
181240,254836.2,930650,65400,99650,338450,115840,155186.2,592200
183550,266923.4,930650,65990,95351.8,338450,117560,171571.6,592200
185860,274176.1,930650,66570,106532.8,338450,119290,167643.3,592200
194970,283184.1,930650,66200,104755.7,338450,128770,178428.4,592200
196450,289296.3,930650,65850,110291.8,338450,130600,179004.5,592200
197980,305405.1,930650,65490,120062.5,338450,132490,185342.6,592200
199440,297163.2,930650,65150,113559.5,338450,134290,183603.7,592200
200930,273210.7,930650,64810,98534,338450,136120,174676.7,592200
202510,242285.3,930650,65850,78224.5,338450,136660,164060.8,592200
204100,256447.1,930650,66950,85493.5,338450,137150,170953.6,592200
205690,275055.7,930650,68010,98933.5,338450,137680,176122.2,592200
207280,278667.1,930650,69060,97127.5,338450,138220,181539.6,592200
208770,281311.4,930650,70000,100371,338450,138770,180940.4,592200
210210,292024.6,930650,70930,109270.9,338450,139280,182753.7,592200
211700,274448,930650,71860,98995.4,338450,139840,175452.6,592200
213230,288004.4,930650,72790,106520.3,338450,140440,181484.1,592200
215010,301452.6,930650,73940,114479.5,338450,141070,186973.1,592200
216720,305121.9,930650,75080,116135.8,338450,141640,188986.1,592200
218410,306719.2,930650,76210,114284.8,338450,142200,192434.4,592200
220170,303322.5,930650,77350,110578.5,338450,142820,192744,592200
219830,301822.2,930650,77470,108768.3,338450,142360,193053.9,592200
219430,296318.3,930650,77570,108219.1,338450,141860,188099.2,592200
219140,299517.4,930650,77690,108775.9,338450,141450,190741.5,592200
218760,300197.8,930650,77780,109902.2,338450,140980,190295.6,592200
218320,305807.8,930650,77790,110022.7,338450,140530,195785.1,592200
217830,311164.9,930650,77770,106548.7,338450,140060,204616.2,592200
217370,304665.2,930650,77770,102531.4,338450,139600,202133.8,592200
216920,277046.6,930650,77750,91843.8,338450,139170,185202.8,592200
216400,294251.2,930650,77880,97205.4,338450,138520,197045.8,592200
215920,303033.4,930650,77990,99030.7,338450,137930,204002.7,592200
215450,284356.5,930650,78120,90132.3,338450,137330,194224.2,592200
214990,284928.4,930650,78240,88498.1,338450,136750,196430.3,592200
211230,290328.8,930650,77900,84104.5,338450,133330,206224.3,592200
207530,280438.8,930650,77540,78511.5,338450,129990,201927.3,592200
203760,274555.9,930650,77200,71207.5,338450,126560,203348.4,592200
200120,269513.8,930650,76870,69502.2,338450,123250,200011.6,592200
196090,255863.7,930650,75840,65890.4,338450,120250,189973.3,592200
192120,248683.4,930650,74840,66562.3,338450,117280,182121.1,592200
188150,236693.6,930650,73850,63725.5,338450,114300,172968.1,592200
184080,248059.1,930650,72850,58760.3,338450,111230,189298.8,592200
180260,239811.5,930650,72220,52757.4,338450,108040,187054.1,592200
176420,224913.6,930650,71590,44517,338450,104830,180396.6,592200
172590,227373,930650,70950,45375.3,338450,101640,181997.7,592200
168770,216075.9,930650,70350,41621.6,338450,98420,174454.3,592200
165080,197262,930650,67970,36642.5,338450,97110,160619.5,592200
161410,186849.4,930650,65590,34875.6,338450,95820,151973.8,592200
157710,188938.1,930650,63190,39820.9,338450,94520,149117.2,592200
154000,185964.8,930650,60820,41155.1,338450,93180,144809.7,592200
148950,177310.8,930650,58620,35921.2,338450,90330,141389.6,592200
144000,165133.2,930650,56420,34476.2,338450,87580,130657,592200
138980,151981.1,930650,54190,30729.7,338450,84790,121251.4,592200
134040,155769.5,930650,52000,33536.9,338450,82040,122232.6,592200
129200,153081.3,930650,49520,32406.4,338450,79680,120674.9,592200
124410,141739.2,930650,47040,27674.7,338450,77370,114064.5,592200
119580,141517.6,930650,44560,28875.1,338450,75020,112642.5,592200
114740,158581.5,930650,42080,35278.4,338450,72660,123303.1,592200
117440,159229.7,930650,43450,40693.8,338450,73990,118535.9,592200
120230,151491.1,930650,44860,39531.6,338450,75370,111959.5,592200
122960,144530.3,930650,46240,34440.2,338450,76720,110090.1,592200
125660,149112.8,930650,47630,37600.4,338450,78030,111512.4,592200
129170,149354.5,930650,49270,38744.6,338450,79900,110609.9,592200
132590,157714,930650,50930,44164,338450,81660,113550,592200
135980,155361.5,930650,52570,40706.5,338450,83410,114655,592200
139420,153702.7,930650,54240,41285.7,338450,85180,112417,592200
143830,155318.8,930650,56690,43872.2,338450,87140,111446.6,592200
148360,155468.8,930650,59160,41310.7,338450,89200,114158.1,592200
152810,166038.2,930650,61610,46960.1,338450,91200,119078.1,592200
157280,170260.5,930650,64080,48157.4,338450,93200,122103.1,592200
168180,172722,930650,67470,50835.5,338450,100710,121886.5,592200
179100,193721.4,930650,70880,56303.1,338450,108220,137418.3,592200
189990,197296.5,930650,74250,60224.6,338450,115740,137071.9,592200
200930,204061.4,930650,77650,66270.2,338450,123280,137791.2,592200
211290,235194.2,930650,80330,82518.4,338450,130960,152675.8,592200
221570,242350.6,930650,82980,83550.9,338450,138590,158799.7,592200
231850,244879.7,930650,85620,81845,338450,146230,163034.7,592200
242190,278262.2,930650,88310,91918.4,338450,153880,186343.8,592200
253670,281037.1,930650,91780,90232.2,338450,161890,190804.9,592200
265110,275562.9,930650,95240,76103.9,338450,169870,199459,592200
276630,269910.7,930650,98710,67859.7,338450,177920,202051,592200
288150,292619.4,930650,102190,70005.8,338450,185960,222613.6,592200
297410,308207.4,930650,105210,76804.8,338450,192200,231402.6,592200
306750,309685.4,930650,108240,78525,338450,198510,231160.4,592200
316070,313996.9,930650,111260,79800.9,338450,204810,234196,592200
325390,310920.1,930650,114310,86016.1,338450,211080,224904,592200
333970,345154.7,930650,116810,101287,338450,217160,243867.7,592200
342640,380211.7,930650,119340,118818.1,338450,223300,261393.6,592200
351240,434219.9,930650,121850,148687.9,338450,229390,285532,592200
359850,468883.5,930650,124380,169318.1,338450,235470,299565.4,592200
368230,501146.3,930650,127000,182849.6,338450,241230,318296.7,592200
376660,497271.4,930650,129620,175226.7,338450,247040,322044.7,592200
385070,466194.5,930650,132250,154114.2,338450,252820,312080.3,592200
393430,471588.3,930650,134880,152933.6,338450,258550,318654.7,592200
391960,532044.5,930650,133890,179524.4,338450,258070,352520.1,592200
390460,527588.3,930650,132900,180643.9,338450,257560,346944.4,592200
388960,494261.9,930650,131910,160564.8,338450,257050,333697.1,592200
387480,469346.6,930650,130910,145952.8,338450,256570,323393.8,592200
386720,458336.3,930650,130560,139244.8,338450,256160,319091.5,592200
385910,463151,930650,130180,145170.6,338450,255730,317980.4,592200
385280,464818.6,930650,129850,156738.4,338450,255430,308080.2,592200
383420,434694.1,930650,132440,132024.3,338450,250980,302669.8,592200
380770,436774.4,930650,130710,132884.3,338450,250060,303890.1,592200
378210,440160.4,930650,129020,138093.2,338450,249190,302067.2,592200
375590,425044.4,930650,127330,133273.2,338450,248260,291771.2,592200
372980,404984,930650,125630,128704.8,338450,247350,276279.2,592200
372350,374922.5,930650,125590,118420.3,338450,246760,256502.2,592200
371810,344159.8,930650,125530,95990,338450,246280,248169.8,592200
371170,353187.9,930650,125480,92946.5,338450,245690,260241.4,592200
370620,359857.7,930650,125440,104339.6,338450,245180,255518.1,592200
368630,372533.8,930650,125110,117242.9,338450,243520,255290.9,592200
366660,391496.1,930650,124790,125933,338450,241870,265563.1,592200
364690,409620.4,930650,124460,136574.9,338450,240230,273045.5,592200
362780,395967.6,930650,124150,126636.2,338450,238630,269331.4,592200
359100,391462.6,930650,122970,126406.3,338450,236130,265056.3,592200
355460,395792.8,930650,121810,130541,338450,233650,265251.8,592200
351690,392636.4,930650,120650,133710.1,338450,231040,258926.3,592200
348000,388196.4,930650,119460,135928,338450,228540,252268.4,592200
347940,384762.7,930650,120470,135217.4,338450,227470,249545.3,592200
347960,380020.9,930650,121480,139474.9,338450,226480,240546,592200
347950,378187.8,930650,122500,138781.5,338450,225450,239406.3,592200
347900,398677.5,930650,123490,146235,338450,224410,252442.5,592200
348900,406021.6,930650,124290,148666.7,338450,224610,257354.9,592200
349870,400005.3,930650,125050,152871.7,338450,224820,247133.6,592200
350820,386314.3,930650,125810,147704.9,338450,225010,238609.4,592200
351820,400547.3,930650,126580,155831.9,338450,225240,244715.4,592200
353940,439430.3,930650,127580,177139.3,338450,226360,262291,592200
356150,452800.2,930650,128620,191841.5,338450,227530,260958.7,592200
358280,436747.5,930650,129630,188070,338450,228650,248677.5,592200
360480,417744.9,930650,130650,184489.4,338450,229830,233255.5,592200
355790,407664.3,930650,129890,181461,338450,225900,226203.3,592200
351110,414597.6,930650,129110,193582.7,338450,222000,221014.9,592200
346450,413255.9,930650,128330,193451.9,338450,218120,219804,592200
341790,428667.6,930650,127580,208598.5,338450,214210,220069.1,592200
338220,423319.4,930650,128000,211081.5,338450,210220,212237.9,592200
334590,411746.2,930650,128370,206003.2,338450,206220,205743,592200
331100,412068.4,930650,128770,199815.4,338450,202330,212253,592200
327460,412518.1,930650,129190,186378,338450,198270,226140.1,592200
323520,372724,930650,129160,166690.5,338450,194360,206033.5,592200
319530,313903,930650,129110,144947.4,338450,190420,168955.6,592200
315550,266579.5,930650,129060,119558.4,338450,186490,147021.1,592200
311550,242047.8,930650,129040,108938.5,338450,182510,133109.3,592200
304310,222912.5,930650,125720,99175.6,338450,178590,123736.9,592200
297080,208782.1,930650,122380,89152.9,338450,174700,119629.2,592200
289800,207451.4,930650,119050,91222.5,338450,170750,116228.9,592200
282510,200201.6,930650,115710,88444,338450,166800,111757.6,592200
271540,192134.1,930650,111070,85105.9,338450,160470,107028.2,592200
260560,173159.6,930650,106450,72075.5,338450,154110,101084.1,592200
249590,168375.6,930650,101800,63359.3,338450,147790,105016.3,592200
238560,172440.7,930650,97150,63966.3,338450,141410,108474.4,592200
231540,183355.1,930650,93870,65850.2,338450,137670,117504.9,592200
224500,179613.1,930650,90560,64614.8,338450,133940,114998.3,592200
217510,152135.9,930650,87300,61263.2,338450,130210,90872.7,592200
210430,160544.2,930650,84010,63733.7,338450,126420,96810.5,592200
204880,147638.7,930650,80990,58826,338450,123890,88812.7,592200
199290,151967.4,930650,78000,62478.8,338450,121290,89488.6,592200
193740,159641.9,930650,74980,59882.9,338450,118760,99759,592200
188220,176696,930650,71980,56271.4,338450,116240,120424.6,592200
183390,204949.9,930650,68940,69311.7,338450,114450,135638.2,592200
178620,200161.9,930650,65930,66539,338450,112690,133622.9,592200
173810,176853,930650,62910,57936.7,338450,110900,118916.3,592200
169030,145112.7,930650,59870,40473.8,338450,109160,104638.9,592200
165170,127119.9,930650,57260,40561,338450,107910,86558.9,592200
161250,122998,930650,54630,36748.8,338450,106620,86249.2,592200
157410,133609.8,930650,52010,36421.2,338450,105400,97188.6,592200
153510,136432.5,930650,49390,35371.1,338450,104120,101061.4,592200
160640,127505.6,930650,53900,35130.9,338450,106740,92374.7,592200
167730,163430.8,930650,58390,43248.4,338450,109340,120182.4,592200
174850,175289.3,930650,62900,42849.7,338450,111950,132439.6,592200
181920,187308.7,930650,67430,49712,338450,114490,137596.7,592200
186550,188593.1,930650,69200,46657.3,338450,117350,141935.8,592200
191130,189695.8,930650,70960,47440.9,338450,120170,142254.9,592200
195780,188566,930650,72750,47109,338450,123030,141457,592200
200330,172622.4,930650,74530,36646.8,338450,125800,135975.6,592200
206690,176060.4,930650,77400,39869.9,338450,129290,136190.5,592200
213040,197807.8,930650,80320,50976.2,338450,132720,146831.6,592200
219400,182877.3,930650,83210,47882.5,338450,136190,134994.8,592200
225790,178788.1,930650,86130,46214,338450,139660,132574.1,592200
232650,192708.4,930650,89970,53534.9,338450,142680,139173.5,592200
239660,198463.5,930650,93830,52964.4,338450,145830,145499.1,592200
246590,202624,930650,97660,52699.2,338450,148930,149924.8,592200
253580,202359.2,930650,101510,50513.8,338450,152070,151845.4,592200
258950,229572.3,930650,104030,55651.2,338450,154920,173921.1,592200
264240,225399.4,930650,106570,57718.6,338450,157670,167680.8,592200
269530,209742.5,930650,109080,58371.8,338450,160450,151370.7,592200
274910,190535.4,930650,111620,56280.9,338450,163290,134254.5,592200
278210,208077,930650,112880,67893.5,338450,165330,140183.5,592200
281500,222741.3,930650,114140,74055.7,338450,167360,148685.6,592200
284940,236068.8,930650,115410,80903.3,338450,169530,155165.5,592200
288190,240914.3,930650,116670,80028.8,338450,171520,160885.5,592200
282800,223492.4,930650,113890,73725.9,338450,168910,149766.5,592200
277340,203523.4,930650,111090,65220.9,338450,166250,138302.5,592200
271960,195265.9,930650,108290,60749.1,338450,163670,134516.8,592200
266490,207364.6,930650,105500,62360.9,338450,160990,145003.7,592200
262460,214676.4,930650,104000,66761.7,338450,158460,147914.7,592200
258460,223628.7,930650,102500,71845.9,338450,155960,151782.8,592200
254420,223786.5,930650,101020,71505.1,338450,153400,152281.4,592200
185850,220075.5,930650,75590,74530.4,338450,110260,145545.1,592200
180950,224741.3,930650,73340,79366.5,338450,107610,145374.8,592200
176170,248997.6,930650,71100,91407.5,338450,105070,157590.1,592200
171350,271755.7,930650,68850,92987,338450,102500,178768.7,592200
166480,240815,930650,66590,83507,338450,99890,157308,592200
165040,211156.4,930650,65730,70805,338450,99310,140351.4,592200
163700,204282.7,930650,64920,68294.2,338450,98780,135988.5,592200
162240,200615.3,930650,64040,68935.8,338450,98200,131679.5,592200
160800,200135.2,930650,63180,70529.6,338450,97620,129605.6,592200
160620,200195.5,930650,62790,70363.6,338450,97830,129831.9,592200
160480,198592,930650,62410,72400.2,338450,98070,126191.8,592200
160380,192512.2,930650,62030,67653.2,338450,98350,124859,592200
160210,175829.8,930650,61610,59304.3,338450,98600,116525.5,592200
160120,170298.6,930650,61890,59270.1,338450,98230,111028.5,592200
160000,165246.3,930650,62130,56203.6,338450,97870,109042.7,592200
159920,178167.4,930650,62410,65965.1,338450,97510,112202.3,592200
159800,185420.2,930650,62660,68702.6,338450,97140,116717.6,592200
159890,195894.6,930650,62810,67838.9,338450,97080,128055.7,592200
159920,188690.8,930650,62950,58420,338450,96970,130270.8,592200
160040,171740.8,930650,63120,53174.6,338450,96920,118566.2,592200
160170,172737,930650,63260,53168.6,338450,96910,119568.4,592200
161190,163487.5,930650,64170,49587.8,338450,97020,113899.7,592200
162200,147271.7,930650,65080,54292.3,338450,97120,92979.4,592200
163260,143151.2,930650,65990,53689.8,338450,97270,89461.4,592200
164320,145359.5,930650,66920,47724.1,338450,97400,97635.4,592200
164980,141255.7,930650,67390,47324.4,338450,97590,93931.3,592200
165740,153101.3,930650,67900,47569.4,338450,97840,105531.9,592200
166420,154400.5,930650,68390,41558.3,338450,98030,112842.2,592200
167150,153187.7,930650,68880,42755.2,338450,98270,110432.5,592200
162650,172967.8,930650,67460,53797.6,338450,95190,119170.2,592200
158080,176649.4,930650,66060,56287.9,338450,92020,120361.5,592200
153560,172733.7,930650,64660,54043,338450,88900,118690.7,592200
149060,162870.8,930650,63260,46896.2,338450,85800,115974.6,592200
143200,159826.9,930650,61480,41734.4,338450,81720,118092.5,592200
137370,154904.2,930650,59690,41982.9,338450,77680,112921.3,592200
131500,159251.5,930650,57910,50582.5,338450,73590,108669,592200
125660,166588.5,930650,56140,57454.9,338450,69520,109133.6,592200
120260,161325,930650,54810,54666.6,338450,65450,106658.4,592200
114930,153430.3,930650,53450,50959.4,338450,61480,102470.9,592200
109530,133665.8,930650,52100,46651.1,338450,57430,87014.7,592200
104130,128001.4,930650,50740,42934.4,338450,53390,85067,592200
100130,118709.8,930650,49800,39851.4,338450,50330,78858.4,592200
96120,107619,930650,48840,37035.6,338450,47280,70583.4,592200
92030,90946.4,930650,47880,33642.1,338450,44150,57304.3,592200
87970,84696.7,930650,46920,29786.9,338450,41050,54909.8,592200
83320,73619.2,930650,45080,24925.8,338450,38240,48693.4,592200
78610,74992.5,930650,43240,25669.1,338450,35370,49323.4,592200
73920,68952.7,930650,41370,20908,338450,32550,48044.7,592200
69220,65696.3,930650,39520,16356.4,338450,29700,49339.9,592200
63610,60713.8,930650,36370,13191.5,338450,27240,47522.3,592200
57950,58163.9,930650,33190,12116.6,338450,24760,46047.3,592200
52340,53477.1,930650,30030,10873.8,338450,22310,42603.3,592200
46650,48423.4,930650,26850,7497.8,338450,19800,40925.6,592200
45550,48481.4,930650,25730,5911.4,338450,19820,42570,592200
44400,47289.4,930650,24590,5821,338450,19810,41468.4,592200
43320,44562.1,930650,23450,4825.5,338450,19870,39736.6,592200
42140,44156.5,930650,22280,4519.3,338450,19860,39637.2,592200
41270,43627.8,930650,21270,4839.5,338450,20000,38788.3,592200
40370,49104.2,930650,20250,7801,338450,20120,41303.2,592200
39490,50078.5,930650,19250,10119.4,338450,20240,39959.1,592200
38620,51955,930650,18240,11346.4,338450,20380,40608.6,592200
38100,51766.5,930650,17500,11028.8,338450,20600,40737.7,592200
37640,54030.1,930650,16770,10947.6,338450,20870,43082.5,592200
37180,57320,930650,16030,12400.8,338450,21150,44919.2,592200
36670,57660.8,930650,15280,9547.8,338450,21390,48113,592200
41500,59691.9,930650,17170,10320.2,338450,24330,49371.7,592200
46140,61246.8,930650,19020,9427.2,338450,27120,51819.6,592200
50910,69638.1,930650,20890,10643.7,338450,30020,58994.4,592200
55660,65880.1,930650,22750,10175.6,338450,32910,55704.5,592200
60410,65029.1,930650,24910,9206.8,338450,35500,55822.3,592200
65170,71582.1,930650,27090,10699.9,338450,38080,60882.2,592200
69860,83759,930650,29240,11247.1,338450,40620,72511.9,592200
74600,96452,930650,31360,15128.9,338450,43240,81323.1,592200
78940,108416.1,930650,33490,18580.5,338450,45450,89835.6,592200
83250,122539.7,930650,35580,22731.8,338450,47670,99807.9,592200
87580,122362.3,930650,37680,20776.3,338450,49900,101586,592200
91880,133015.8,930650,39810,25641.8,338450,52070,107374,592200
92550,135399.3,930650,40380,26219,338450,52170,109180.3,592200
93230,140457.8,930650,40960,24217.4,338450,52270,116240.4,592200
93990,142411.2,930650,41570,26552.1,338450,52420,115859.1,592200
94650,141771.7,930650,42180,31008.5,338450,52470,110763.2,592200
95160,122500,930650,42550,31494.5,338450,52610,91005.5,592200
95630,119474.9,930650,42890,30808.5,338450,52740,88666.4,592200
96170,122970.2,930650,43280,34719.6,338450,52890,88250.6,592200
96680,133112.7,930650,43640,41237,338450,53040,91875.7,592200
97230,138228.6,930650,44030,40566.9,338450,53200,97661.7,592200
97800,137759.2,930650,44380,42028.9,338450,53420,95730.3,592200
98330,136108.4,930650,44780,40930.2,338450,53550,95178.2,592200
98840,150356.8,930650,45170,48990.7,338450,53670,101366.1,592200
96750,155214,930650,43800,52165.4,338450,52950,103048.6,592200
94690,153039.4,930650,42420,53706.4,338450,52270,99333,592200
92620,160668.1,930650,41050,59801.4,338450,51570,100866.7,592200
90490,164410.4,930650,39660,63666.5,338450,50830,100743.9,592200
88530,159586.7,930650,38210,63436.9,338450,50320,96149.8,592200
86700,157060.9,930650,36780,61229.1,338450,49920,95831.8,592200
84720,172867.1,930650,35340,70518.7,338450,49380,102348.4,592200
93950,177503.7,930650,42100,71966.6,338450,51850,105537.1,592200
90560,158025.5,930650,40850,59626.2,338450,49710,98399.3,592200
87110,143019.6,930650,39590,47836.6,338450,47520,95183,592200
83760,130810.9,930650,38350,43109.2,338450,45410,87701.7,592200
80270,136748.7,930650,37090,49665.4,338450,43180,87083.3,592200
78870,131952.4,930650,36380,53705.8,338450,42490,78246.6,592200
77430,129454.3,930650,35650,58659.9,338450,41780,70794.4,592200
75970,127172.5,930650,34900,62914.9,338450,41070,64257.6,592200
74510,148287.3,930650,34180,71570,338450,40330,76717.3,592200
73020,150167,930650,33690,79191.8,338450,39330,70975.2,592200
71420,143920.7,930650,33200,81115.8,338450,38220,62804.9,592200
69890,172911.8,930650,32700,77435.3,338450,37190,95476.5,592200
68400,172485.3,930650,32220,75038.6,338450,36180,97446.7,592200
67140,182797.9,930650,32270,74652.2,338450,34870,108145.7,592200
65870,195426.3,930650,32330,83433.1,338450,33540,111993.2,592200
64680,223027.9,930650,32380,92231.3,338450,32300,130796.6,592200
63410,239936.6,930650,32440,104474.7,338450,30970,135461.9,592200
63590,289131.8,930650,33040,143843.5,338450,30550,145288.3,592200
63640,236247.9,930650,33590,110401.2,338450,30050,125846.7,592200
63730,201026.1,930650,34180,90918.1,338450,29550,110108,592200
63840,165881.2,930650,34760,73226.7,338450,29080,92654.5,592200
64000,159425.4,930650,35170,70266,338450,28830,89159.4,592200
64090,197458,930650,35580,111328.1,338450,28510,86129.9,592200
64180,175341.9,930650,35960,88992.5,338450,28220,86349.4,592200
64320,155368.8,930650,36390,76487.2,338450,27930,78881.6,592200
64210,131615.2,930650,36660,67301,338450,27550,64314.2,592200
64160,143491.3,930650,36940,62714.4,338450,27220,80776.9,592200
64130,147640.6,930650,37220,64716.4,338450,26910,82924.2,592200
64010,160586,930650,37500,75667.4,338450,26510,84918.6,592200
62990,129438.1,930650,37020,53522.8,338450,25970,75915.3,592200
62030,118135.4,930650,36580,41371.7,338450,25450,76763.7,592200
60970,98002.7,930650,36090,27111.1,338450,24880,70891.6,592200
59940,78061.8,930650,35640,14882,338450,24300,63179.8,592200
59530,88774,930650,35340,17315.3,338450,24190,71458.7,592200
59150,92771.6,930650,35100,24919,338450,24050,67852.6,592200
58730,92300.2,930650,34850,27783.3,338450,23880,64516.9,592200
58360,91444.5,930650,34570,24254.4,338450,23790,67190.1,592200
57310,86762.4,930650,34480,19570.2,338450,22830,67192.2,592200
56340,90742.5,930650,34400,24343.2,338450,21940,66399.3,592200
55320,76767.4,930650,34310,16209.6,338450,21010,60557.8,592200
54350,67123.5,930650,34250,11805.5,338450,20100,55318,592200
51900,61918.1,930650,32830,10978.2,338450,19070,50939.9,592200
49550,58450.1,930650,31440,9198.9,338450,18110,49251.2,592200
47150,68776.1,930650,30060,11367.9,338450,17090,57408.2,592200
44750,76185.1,930650,28660,12532.6,338450,16090,63652.5,592200
42860,72100,930650,27300,9407.4,338450,15560,62692.6,592200
40960,107517.8,930650,25950,29472.3,338450,15010,78045.5,592200
39090,158350,930650,24600,69047.5,338450,14490,89302.5,592200
37210,159304.7,930650,23260,70313.6,338450,13950,88991.1,592200
35830,108955.1,930650,22360,33033,338450,13470,75922.1,592200
34420,94636.5,930650,21480,24284.6,338450,12940,70351.9,592200
32960,78288.8,930650,20570,13923.4,338450,12390,64365.4,592200
31620,80686.6,930650,19690,12899.3,338450,11930,67787.3,592200
33270,76317.7,930650,19960,10053,338450,13310,66264.7,592200
34850,72861.6,930650,20250,8371.6,338450,14600,64490,592200
36450,76826.3,930650,20530,12234.4,338450,15920,64591.9,592200
38090,79585.8,930650,20820,12212.1,338450,17270,67373.7,592200
39730,81709.7,930650,21190,12004.9,338450,18540,69704.8,592200
41330,81596,930650,21550,13567.5,338450,19780,68028.5,592200
42970,95065,930650,21920,16930.2,338450,21050,78134.8,592200
44620,106461.9,930650,22290,21559.5,338450,22330,84902.4,592200
45960,108960.1,930650,22390,19803.7,338450,23570,89156.4,592200
47320,114756.6,930650,22510,25935.7,338450,24810,88820.9,592200
48660,110434,930650,22620,26469.2,338450,26040,83964.8,592200
49970,100114.1,930650,22700,22376.5,338450,27270,77737.6,592200
52910,110358.1,930650,24160,23236.3,338450,28750,87121.8,592200
55920,105734.1,930650,25640,19940.1,338450,30280,85794,592200
58890,106720.1,930650,27110,19308.1,338450,31780,87412,592200
61830,109108.6,930650,28580,19153.2,338450,33250,89955.4,592200
65010,109596,930650,30160,21381.6,338450,34850,88214.4,592200
68230,113089.3,930650,31760,23224.8,338450,36470,89864.5,592200
71480,133757.7,930650,33380,30417.5,338450,38100,103340.2,592200
74700,141510.5,930650,34960,35055.8,338450,39740,106454.7,592200
77620,144484.3,930650,36240,40816.2,338450,41380,103668.1,592200
80520,144607.6,930650,37500,39033.9,338450,43020,105573.7,592200
83380,152080,930650,38770,42322.2,338450,44610,109757.8,592200
86250,159100.7,930650,40020,45548.6,338450,46230,113552.1,592200
87950,164059.4,930650,40570,49597.9,338450,47380,114461.5,592200
89550,168729.5,930650,41070,55342.4,338450,48480,113387.1,592200
91290,191178.4,930650,41590,74452.2,338450,49700,116726.2,592200
92940,200616.7,930650,42110,82031.5,338450,50830,118585.2,592200
94700,219602.7,930650,42740,88276.5,338450,51960,131326.2,592200
96510,211081.7,930650,43390,81047.9,338450,53120,130033.8,592200
98220,214739.8,930650,44030,81337.2,338450,54190,133402.6,592200
100030,222513.8,930650,44670,90320.2,338450,55360,132193.6,592200
102080,226071.6,930650,45620,94372.7,338450,56460,131698.9,592200
104220,231821.6,930650,46560,95582.7,338450,57660,136238.9,592200
106300,255311.5,930650,47510,110681.7,338450,58790,144629.8,592200
108370,238964.4,930650,48440,100272.4,338450,59930,138692,592200
105440,233836.6,930650,46640,97517,338450,58800,136319.6,592200
102560,219690.7,930650,44810,87428.7,338450,57750,132262,592200
99530,197534.9,930650,42970,76150.4,338450,56560,121384.5,592200
96690,188908.7,930650,41160,67192.6,338450,55530,121716.1,592200
93710,168718,930650,39300,50288.2,338450,54410,118429.8,592200
90710,158875.9,930650,37440,41972.4,338450,53270,116903.5,592200
87740,151486.7,930650,35570,39167.4,338450,52170,112319.3,592200
93870,146167.3,930650,35230,37613.7,338450,58640,108553.6,592200
92120,143568.6,930650,34060,34925.3,338450,58060,108643.3,592200
90460,142205.2,930650,32880,34169.6,338450,57580,108035.6,592200
88770,128559,930650,31700,29393.8,338450,57070,99165.2,592200
87100,125246.9,930650,30530,29477.7,338450,56570,95769.2,592200
86770,128600.8,930650,29880,33081.1,338450,56890,95519.7,592200
86410,129698.7,930650,29200,32023.5,338450,57210,97675.2,592200
86110,128624.2,930650,28560,30388.6,338450,57550,98235.6,592200
85810,132719.8,930650,27900,31324.8,338450,57910,101395,592200
85740,128882.5,930650,27340,27930.9,338450,58400,100951.6,592200
85670,119269.5,930650,26760,22938.9,338450,58910,96330.6,592200
85520,116691.9,930650,26210,18815.7,338450,59310,97876.2,592200
85490,113642.9,930650,25650,17033.4,338450,59840,96609.5,592200
85400,112791.7,930650,25050,16576.3,338450,60350,96215.4,592200
85350,107658.7,930650,24430,15634,338450,60920,92024.7,592200
85310,116354.6,930650,23840,20165,338450,61470,96189.6,592200
85280,120782.9,930650,23250,19453.7,338450,62030,101329.2,592200
88200,116798.8,930650,24650,15334.5,338450,63550,101464.3,592200
91180,118298,930650,26060,17163.3,338450,65120,101134.7,592200
94090,119180.7,930650,27490,19444.7,338450,66600,99736,592200
97050,114479.1,930650,28910,15923.6,338450,68140,98555.5,592200
99740,123312.8,930650,30360,20614.9,338450,69380,102697.9,592200
102380,128688.5,930650,31810,21844.6,338450,70570,106843.9,592200
105140,148729.9,930650,33270,30228.1,338450,71870,118501.8,592200
107860,158209.6,930650,34740,34595.3,338450,73120,123614.3,592200
110420,160479.8,930650,36110,36403.3,338450,74310,124076.5,592200
112960,151640.4,930650,37490,33742.5,338450,75470,117897.9,592200
115580,146874.9,930650,38870,27042,338450,76710,119832.9,592200
118090,158093.3,930650,40230,30628.7,338450,77860,127464.6,592200
117240,152867,930650,40620,25202.1,338450,76620,127664.9,592200
116330,161141.2,930650,41010,25984.6,338450,75320,135156.6,592200
115490,189582.3,930650,41420,41574.4,338450,74070,148007.9,592200
114620,193263.4,930650,41820,43319.2,338450,72800,149944.2,592200
114120,204045.3,930650,42380,48046.3,338450,71740,155999,592200
113660,193449.8,930650,42920,46743.6,338450,70740,146706.2,592200
113180,196279.1,930650,43490,50143.1,338450,69690,146136,592200
112690,188328.4,930650,44040,51379.1,338450,68650,136949.3,592200
112210,174494.4,930650,44660,48290.7,338450,67550,126203.7,592200
111740,153153.8,930650,45270,39689.7,338450,66470,113464.1,592200
111320,149081.4,930650,45900,40923.6,338450,65420,108157.8,592200
110840,143832.3,930650,46540,43699.7,338450,64300,100132.6,592200
108960,140238.8,930650,45060,48880.7,338450,63900,91358.1,592200
107100,130969.2,930650,43580,41208.1,338450,63520,89761.1,592200
105180,130121.2,930650,42090,38006.9,338450,63090,92114.3,592200
103370,127313.4,930650,40640,35973.4,338450,62730,91340,592200
101940,125396.7,930650,39270,37177.4,338450,62670,88219.3,592200
100440,127024.6,930650,37910,36989.3,338450,62530,90035.3,592200
99080,126480.6,930650,36570,33250.2,338450,62510,93230.4,592200
97580,129216.1,930650,35200,32906.2,338450,62380,96309.9,592200
96290,134698,930650,33980,34504.4,338450,62310,100193.6,592200
95010,125225.7,930650,32750,30364.8,338450,62260,94860.9,592200
93730,141153.9,930650,31510,35464.7,338450,62220,105689.2,592200
92450,128432,930650,30290,33029.4,338450,62160,95402.6,592200
90220,120031.7,930650,29690,30906.4,338450,60530,89125.3,592200
87960,88681.5,930650,29060,30593.2,338450,58900,58088.3,592200
85790,66970.4,930650,28460,31220.9,338450,57330,35749.5,592200
83570,77212.1,930650,27880,35225.4,338450,55690,41986.7,592200
81300,86513.1,930650,27360,40268.6,338450,53940,46244.5,592200
79030,98893.3,930650,26860,42634.5,338450,52170,56258.8,592200
76730,118557,930650,26360,51113.1,338450,50370,67443.9,592200
74420,121845.1,930650,25850,53595.1,338450,48570,68250,592200
72460,101893.5,930650,25780,48458.6,338450,46680,53434.9,592200
70390,114819.9,930650,25670,53559.7,338450,44720,61260.2,592200
68430,139998.2,930650,25590,54767.7,338450,42840,85230.5,592200
66450,137265.7,930650,25490,52092.1,338450,40960,85173.6,592200
67010,132894,930650,26460,54052.7,338450,40550,78841.3,592200
67660,130481.7,930650,27420,54104.4,338450,40240,76377.3,592200
68250,127927.3,930650,28390,50178.6,338450,39860,77748.7,592200
68800,138748,930650,29330,54498.1,338450,39470,84249.9,592200
69820,140961.8,930650,30330,57682.2,338450,39490,83279.6,592200
70840,139636.9,930650,31340,57732.8,338450,39500,81904.1,592200
71900,143487.6,930650,32370,58000.6,338450,39530,85487,592200
72900,145339.6,930650,33370,59844.4,338450,39530,85495.2,592200
73790,155383.8,930650,34270,64723.2,338450,39520,90660.6,592200
74720,155580,930650,35190,65804.5,338450,39530,89775.5,592200
75710,156695.1,930650,36130,67651.9,338450,39580,89043.2,592200
76660,168523.4,930650,37060,76554,338450,39600,91969.4,592200
78520,177053.6,930650,38870,80278,338450,39650,96775.6,592200
80410,171324.2,930650,40700,74514.2,338450,39710,96810,592200
82270,180983.9,930650,42530,78442.8,338450,39740,102541.1,592200
84180,205324.5,930650,44350,90522.1,338450,39830,114802.4,592200
85810,210119.7,930650,46020,91488.6,338450,39790,118631.1,592200
87540,159994,930650,47690,61006.5,338450,39850,98987.5,592200
89250,142464.2,930650,49380,50886.2,338450,39870,91578,592200
91020,139602.7,930650,51050,47864.7,338450,39970,91738,592200
92050,132742.5,930650,52330,40131.8,338450,39720,92610.7,592200
93170,128427.8,930650,53630,37978.1,338450,39540,90449.7,592200
94280,153135.9,930650,54910,50739,338450,39370,102396.9,592200
95360,189977.1,930650,56210,67807.7,338450,39150,122169.4,592200
96170,193058.3,930650,56390,69816.7,338450,39780,123241.6,592200
96900,212016,930650,56570,77824.7,338450,40330,134191.3,592200
97760,223489.9,930650,56740,83326.2,338450,41020,140163.7,592200
98540,239433.5,930650,56930,92538.4,338450,41610,146895.1,592200
99680,241052.6,930650,57500,91524.4,338450,42180,149528.2,592200
100790,239786,930650,58020,85069.6,338450,42770,154716.4,592200
101980,249527.7,930650,58560,78780.8,338450,43420,170746.9,592200
145060,269111.1,930650,54140,77998.4,338450,90920,191112.7,592200
149320,289846.1,930650,54500,85555.1,338450,94820,204291,592200
153570,288775.7,930650,54860,84541.7,338450,98710,204234,592200
157810,306233.6,930650,55220,88252.3,338450,102590,217981.3,592200
162050,321752.9,930650,55580,89196.4,338450,106470,232556.5,592200
168100,335359.2,930650,57130,97308.2,338450,110970,238051,592200
174060,351629.6,930650,58630,104645.6,338450,115430,246984,592200
180060,372594.6,930650,60160,107109.3,338450,119900,265485.3,592200
186160,383808.6,930650,61700,108270.2,338450,124460,275538.4,592200
192250,394960.2,930650,63310,103902.7,338450,128940,291057.5,592200
198290,397373.8,930650,64910,98702.2,338450,133380,298671.6,592200
204350,408886.8,930650,66540,105984.7,338450,137810,302902.1,592200
210470,421484.7,930650,68160,106698.6,338450,142310,314786.1,592200
217950,451447.1,930650,70050,115136.4,338450,147900,336310.7,592200
225420,476690.5,930650,71920,131219.1,338450,153500,345471.4,592200
232890,486375.6,930650,73800,142332.7,338450,159090,344042.9,592200
240470,484021.6,930650,75670,142578.4,338450,164800,341443.2,592200
242560,469330.6,930650,76640,139957,338450,165920,329373.6,592200
244680,487439,930650,77600,153827.4,338450,167080,333611.6,592200
246870,481728.2,930650,78550,148276.5,338450,168320,333451.7,592200
249020,496242.6,930650,79520,147922.7,338450,169500,348319.9,592200
250510,515626.4,930650,80540,152703.9,338450,169970,362922.5,592200
251980,507086.7,930650,81550,146293.2,338450,170430,360793.5,592200
253430,479265.3,930650,82550,139588.3,338450,170880,339677,592200
254960,465617.4,930650,83560,136629.9,338450,171400,328987.5,592200
255860,439094.7,930650,84530,125283.6,338450,171330,313811.1,592200
256620,422331.1,930650,85480,108514.8,338450,171140,313816.3,592200
257420,407975.6,930650,86450,103719.8,338450,170970,304255.8,592200
258310,387746.4,930650,87370,100167.8,338450,170940,287578.6,592200
260910,368200.1,930650,87330,89954,338450,173580,278246.1,592200
263500,351838.1,930650,87250,85408.3,338450,176250,266429.8,592200
266110,350172,930650,87210,81943.4,338450,178900,268228.6,592200
268740,360003.3,930650,87140,84140.1,338450,181600,275863.2,592200
270900,352528.5,930650,86930,79179.6,338450,183970,273348.9,592200
273140,348246.2,930650,86720,79672.7,338450,186420,268573.5,592200
275320,366775.2,930650,86500,97185.3,338450,188820,269589.9,592200
277520,370507.7,930650,86300,103505.9,338450,191220,267001.8,592200
279420,363132.2,930650,86310,101725.7,338450,193110,261406.5,592200
281290,375627.1,930650,86320,107480,338450,194970,268147.1,592200
283200,389716.9,930650,86310,114431,338450,196890,275285.9,592200
285030,389595.7,930650,86290,117610.7,338450,198740,271985,592200
285800,375838.6,930650,85680,114710.4,338450,200120,261128.2,592200
286440,373934.2,930650,85020,115243.1,338450,201420,258691.1,592200
287270,365830.1,930650,84420,120332.9,338450,202850,245497.2,592200
287940,376453.8,930650,83750,127759.4,338450,204190,248694.4,592200
288580,379502.8,930650,83210,132547.2,338450,205370,246955.6,592200
289220,358605.2,930650,82670,128922.4,338450,206550,229682.8,592200
289810,350947.9,930650,82110,134755.5,338450,207700,216192.4,592200
290430,363328.3,930650,81580,138850.3,338450,208850,224478,592200
290710,346937.6,930650,80450,131827,338450,210260,215110.6,592200
290950,337807.2,930650,79300,128414.5,338450,211650,209392.7,592200
291180,347801.1,930650,78150,134675.2,338450,213030,213125.9,592200
291480,345856.2,930650,77040,137402.7,338450,214440,208453.5,592200
284660,344767.1,930650,75770,135129,338450,208890,209638.1,592200
277840,349959.7,930650,74490,134568.2,338450,203350,215391.5,592200
271020,350271.7,930650,73220,135649.2,338450,197800,214622.5,592200
264250,352087.2,930650,71940,137687.8,338450,192310,214399.4,592200
257320,340722.9,930650,71050,130938.5,338450,186270,209784.4,592200
250280,323264.6,930650,70130,118026.5,338450,180150,205238.1,592200
243380,352597.2,930650,69240,133159.2,338450,174140,219438,592200
236410,343333.5,930650,68320,140386.8,338450,168090,202946.7,592200
229530,346782.8,930650,67380,139302.1,338450,162150,207480.7,592200
222650,331784,930650,66410,121073,338450,156240,210711,592200
215720,319640,930650,65460,120101.7,338450,150260,199538.3,592200
208830,312406.4,930650,64500,122333.4,338450,144330,190073,592200
203330,305756.5,930650,63950,116358,338450,139380,189398.5,592200
197760,273035.5,930650,63390,98102.5,338450,134370,174933,592200
192320,258576.4,930650,62840,86385.4,338450,129480,172191,592200
186730,263542.4,930650,62300,85838.6,338450,124430,177703.8,592200
181830,255327.3,930650,61930,88911.3,338450,119900,166416,592200
176860,243971.8,930650,61580,86111,338450,115280,157860.8,592200
171840,235327.9,930650,61220,87775.4,338450,110620,147552.5,592200
166840,246380.8,930650,60860,91199.9,338450,105980,155180.9,592200
160970,231716.4,930650,60140,85880.8,338450,100830,145835.6,592200
155000,244405,930650,59400,94340.2,338450,95600,150064.8,592200
149030,266797.5,930650,58660,98311.5,338450,90370,168486,592200
143130,241880.6,930650,57930,92980.8,338450,85200,148899.8,592200
141240,231596.8,930650,57400,91360.9,338450,83840,140235.9,592200
139270,264663,930650,56780,110483.3,338450,82490,154179.7,592200
137390,275498.1,930650,56230,118248.3,338450,81160,157249.8,592200
135490,287116.7,930650,55650,113265.1,338450,79840,173851.6,592200
134470,274233.3,930650,55270,100521.4,338450,79200,173711.9,592200
133380,266960.1,930650,54880,94616.1,338450,78500,172344,592200
132310,262959,930650,54450,93362.3,338450,77860,169596.7,592200
131270,243494.8,930650,54060,82351.9,338450,77210,161142.9,592200
130390,247495.4,930650,53680,84406.1,338450,76710,163089.3,592200
129540,237839.9,930650,53300,86832.8,338450,76240,151007.1,592200
128640,224684.7,930650,52910,82318.7,338450,75730,142366,592200
127810,230389,930650,52540,89422.9,338450,75270,140966.1,592200
130980,247257.8,930650,53870,107177.8,338450,77110,140080,592200
134140,261015,930650,55210,114975.6,338450,78930,146039.4,592200
137280,254433.4,930650,56560,107173.7,338450,80720,147259.7,592200
140460,252658.9,930650,57920,105423.6,338450,82540,147235.3,592200
143670,258737.3,930650,59440,105102.9,338450,84230,153634.4,592200
146920,271542.3,930650,60960,105371,338450,85960,166171.3,592200
150160,257690.1,930650,62510,95756.6,338450,87650,161933.5,592200
165000,245832.6,930650,67280,92484,338450,97720,153348.6,592200
167070,238177.4,930650,67410,88704.4,338450,99660,149473,592200
169120,230198.5,930650,67530,85824.5,338450,101590,144374,592200
171170,237027.3,930650,67660,87647.8,338450,103510,149379.5,592200
173290,251686.2,930650,67810,90582.9,338450,105480,161103.3,592200
174070,251887,930650,68200,83298.1,338450,105870,168588.9,592200
174810,262386.5,930650,68570,80329.7,338450,106240,182056.8,592200
175540,227957.5,930650,68970,70248.8,338450,106570,157708.7,592200
176220,214754.1,930650,69370,67190.1,338450,106850,147564,592200
177270,213039.1,930650,69500,66032.9,338450,107770,147006.2,592200
178310,231939.1,930650,69610,68122,338450,108700,163817.1,592200
179360,239997.8,930650,69710,84443.3,338450,109650,155554.5,592200
180390,246279.4,930650,69840,83201.5,338450,110550,163077.9,592200
182080,254802.8,930650,70860,86715,338450,111220,168087.8,592200
183780,261662.4,930650,71880,80542,338450,111900,181120.4,592200
185480,236993.2,930650,72880,71761.3,338450,112600,165231.9,592200
187270,259205.7,930650,73930,88961.8,338450,113340,170243.9,592200
185260,302452.3,930650,74640,108290.2,338450,110620,194162.1,592200
183270,299395.1,930650,75350,109310.8,338450,107920,190084.3,592200
181330,306654.7,930650,76100,121735.8,338450,105230,184918.9,592200
179390,316769.6,930650,76790,128804.8,338450,102600,187964.8,592200
177700,341998,930650,77440,140184,338450,100260,201814,592200
175980,366885.7,930650,78090,159960.5,338450,97890,206925.2,592200
174250,369896.9,930650,78710,162170,338450,95540,207726.9,592200
172550,370812,930650,79340,164534.5,338450,93210,206277.5,592200
171130,367878.6,930650,80520,168463.4,338450,90610,199415.2,592200
169680,375020.3,930650,81690,173229.3,338450,87990,201791,592200
168290,393383,930650,82860,180130.7,338450,85430,213252.3,592200
166930,404013.4,930650,84040,187686.5,338450,82890,216326.9,592200
167190,400213.2,930650,86230,193849.5,338450,80960,206363.7,592200
167480,385643,930650,88440,196155.1,338450,79040,189487.9,592200
167790,368481.4,930650,90620,194259.5,338450,77170,174221.9,592200
168110,362677.4,930650,92820,192970.5,338450,75290,169706.9,592200
168270,372808.2,930650,94890,193371.2,338450,73380,179437,592200
168540,365911.4,930650,96990,194446,338450,71550,171465.4,592200
168660,349884.5,930650,99070,201977.9,338450,69590,147906.6,592200
168840,327713.6,930650,101130,197286.8,338450,67710,130426.8,592200
168690,318370.9,930650,102900,193906.6,338450,65790,124464.3,592200
168580,315854.4,930650,104650,195264.5,338450,63930,120589.9,592200
168390,304946.7,930650,106390,196469.6,338450,62000,108477.1,592200
168260,280805.6,930650,108150,192273,338450,60110,88532.6,592200
169190,278093,930650,110260,186769.7,338450,58930,91323.3,592200
170160,294413.3,930650,112360,197419.3,338450,57800,96994,592200
171110,301616.1,930650,114490,195315.9,338450,56620,106300.2,592200
172030,306527.7,930650,116580,197799.1,338450,55450,108728.6,592200
173110,307772.4,930650,118670,199833.3,338450,54440,107939.1,592200
174290,296235.9,930650,120770,199951.9,338450,53520,96284,592200
175330,292985.5,930650,122880,191172.1,338450,52450,101813.4,592200
176400,294746.8,930650,124980,195190.9,338450,51420,99555.9,592200
177560,300861.5,930650,126910,201774.4,338450,50650,99087.1,592200
178700,297795.7,930650,128850,201736.1,338450,49850,96059.6,592200
179880,282184.9,930650,130800,200778.8,338450,49080,81406.1,592200
180980,287909.4,930650,132710,198478.3,338450,48270,89431.1,592200
186030,289379,930650,135550,192987.4,338450,50480,96391.6,592200
191010,261763.9,930650,138330,189048,338450,52680,72715.9,592200
196060,265251.5,930650,141150,190851.6,338450,54910,74399.9,592200
201100,272915.5,930650,143940,189337.9,338450,57160,83577.6,592200
205500,286699.6,930650,145890,198026.8,338450,59610,88672.8,592200
209990,291114.1,930650,147840,200850.3,338450,62150,90263.8,592200
214380,282783.2,930650,149800,200779.5,338450,64580,82003.7,592200
218830,300172.8,930650,151740,201174,338450,67090,98998.8,592200
223830,271498.1,930650,154270,197146.9,338450,69560,74351.2,592200
228770,268963.7,930650,156770,195506,338450,72000,73457.7,592200
233750,275107.7,930650,159290,191704.2,338450,74460,83403.5,592200
238770,278700.4,930650,161810,187283.5,338450,76960,91416.9,592200
242990,244368.7,930650,163320,173321.8,338450,79670,71046.9,592200
247270,227307,930650,164860,161205.2,338450,82410,66101.8,592200
251500,239732.9,930650,166380,163841.9,338450,85120,75891,592200
255730,279149.9,930650,167920,181241.6,338450,87810,97908.3,592200
260310,305700.8,930650,169710,189274.8,338450,90600,116426,592200
264950,303431.4,930650,171520,186168.4,338450,93430,117263,592200
269490,285362.8,930650,173300,192125.6,338450,96190,93237.2,592200
274090,307077.9,930650,175100,202708.2,338450,98990,104369.7,592200
278540,316801.5,930650,176650,208760.2,338450,101890,108041.3,592200
282980,325033.8,930650,178190,208033.5,338450,104790,117000.3,592200
287400,317336.6,930650,179700,206747.8,338450,107700,110588.8,592200
291910,308535.8,930650,181260,197203.4,338450,110650,111332.4,592200
294320,333618.2,930650,182190,199723.6,338450,112130,133894.6,592200
296810,364428.3,930650,183130,214438.7,338450,113680,149989.6,592200
299240,354262.9,930650,184070,219833.8,338450,115170,134429.1,592200
301720,344966.8,930650,185020,213212.3,338450,116700,131754.5,592200
304010,341204.9,930650,185860,212469.4,338450,118150,128735.5,592200
306220,345847.3,930650,186680,213113.6,338450,119540,132733.7,592200
308520,339032.1,930650,187510,211914.4,338450,121010,127117.7,592200
310790,359989.8,930650,188370,219007.6,338450,122420,140982.2,592200
313350,332073.2,930650,188920,208719.4,338450,124430,123353.8,592200
316040,333399.6,930650,189490,200912.6,338450,126550,132487,592200
318620,313137.9,930650,190040,194558.1,338450,128580,118579.8,592200
321290,319661.8,930650,190610,198204.6,338450,130680,121457.2,592200
331280,306869.6,930650,193830,195427.4,338450,137450,111442.2,592200
341280,287671.4,930650,197060,186609.8,338450,144220,101061.6,592200
351300,296709.2,930650,200270,188410.2,338450,151030,108299,592200
361340,274871.1,930650,203520,174500.7,338450,157820,100370.4,592200
370910,282247.1,930650,206700,175195.5,338450,164210,107051.6,592200
380550,278432.5,930650,209890,167814.8,338450,170660,110617.7,592200
390170,266088.1,930650,213120,156377.2,338450,177050,109710.9,592200
333000,260381.5,930650,186380,157075.6,338450,146620,103305.9,592200
340940,247105.4,930650,189360,154929.7,338450,151580,92175.7,592200
348950,263762.7,930650,192390,159612.7,338450,156560,104150,592200
356990,275301,930650,195370,171822.8,338450,161620,103478.2,592200
364990,277104.7,930650,198370,170256.4,338450,166620,106848.3,592200
371800,286095,930650,201230,178176.4,338450,170570,107918.6,592200
378560,294512,930650,204080,179648,338450,174480,114864,592200
385380,291676.3,930650,206940,180659.9,338450,178440,111016.4,592200
392190,298014.5,930650,209800,177644.3,338450,182390,120370.2,592200
399020,297717.6,930650,212470,177394.7,338450,186550,120322.9,592200
405920,312172.6,930650,215100,183077.2,338450,190820,129095.4,592200
412850,313856.6,930650,217770,184278.6,338450,195080,129578,592200
419750,348025.5,930650,220420,209741.5,338450,199330,138284,592200
427070,361776.4,930650,223340,221527.3,338450,203730,140249.1,592200
434420,365205.9,930650,226270,225093.7,338450,208150,140112.2,592200
441780,355955.4,930650,229170,217593.2,338450,212610,138362.2,592200
449080,360088.5,930650,232100,212975,338450,216980,147113.5,592200
455000,374892.7,930650,233520,220220.7,338450,221480,154672,592200
460830,390649.3,930650,234950,231358,338450,225880,159291.3,592200
466760,410739.3,930650,236370,235886.3,338450,230390,174853,592200
472630,403808.4,930650,237800,232024.1,338450,234830,171784.3,592200
478440,409218.9,930650,239250,234414.6,338450,239190,174804.3,592200
484380,420222,930650,240740,238955.2,338450,243640,181266.8,592200
490180,440425.7,930650,242190,247630.9,338450,247990,192794.8,592200
496080,451295.4,930650,243650,249434,338450,252430,201861.4,592200
501400,451663.1,930650,244920,246926.3,338450,256480,204736.8,592200
506650,462534.2,930650,246190,259009.4,338450,260460,203524.8,592200
512010,469051.2,930650,247460,260914.7,338450,264550,208136.5,592200
517270,469062,930650,248710,257277.1,338450,268560,211784.9,592200
518420,474042.7,930650,248610,259288.7,338450,269810,214754,592200
519490,475117,930650,248480,262226.6,338450,271010,212890.4,592200
520610,479264,930650,248350,265642.3,338450,272260,213621.7,592200
521690,479888.7,930650,248250,264007.8,338450,273440,215880.9,592200
523480,490064.8,930650,248500,269038,338450,274980,221026.8,592200
525380,499833.4,930650,248790,277905,338450,276590,221928.4,592200
527130,522969.5,930650,249050,288968.7,338450,278080,234000.8,592200
529010,521668.3,930650,249350,282944.8,338450,279660,238723.5,592200
530990,537552.8,930650,249480,285902.8,338450,281510,251650,592200
532980,521633.5,930650,249600,271411.3,338450,283380,250222.2,592200
534900,529543.3,930650,249730,271480.5,338450,285170,258062.8,592200
536920,545852.2,930650,249860,279273,338450,287060,266579.2,592200
537250,549265.4,930650,249890,274346,338450,287360,274919.4,592200
537530,551354.7,930650,249890,272737.4,338450,287640,278617.3,592200
537810,545436.9,930650,249890,272230.3,338450,287920,273206.6,592200
538010,525801.6,930650,249900,268124.6,338450,288110,257677,592200
537430,510676.2,930650,249660,256956.7,338450,287770,253719.5,592200
536870,490581.9,930650,249430,242475.2,338450,287440,248106.7,592200
536310,484000.4,930650,249200,246013.8,338450,287110,237986.6,592200
535720,471624.9,930650,248940,247353.6,338450,286780,224271.3,592200
535920,476025.2,930650,249120,252005.7,338450,286800,224019.5,592200
536200,480022.1,930650,249320,254991.3,338450,286880,225030.8,592200
536410,487839.7,930650,249480,259515.5,338450,286930,228324.2,592200
536670,495987.8,930650,249700,265051.9,338450,286970,230935.9,592200
542090,492563.1,930650,250460,259815.6,338450,291630,232747.5,592200
547480,512081.5,930650,251240,264839.3,338450,296240,247242.2,592200
552900,510685.4,930650,252020,259631,338450,300880,251054.4,592200
558290,525022.3,930650,252790,266331.7,338450,305500,258690.6,592200
562840,537944.5,930650,253360,266953.8,338450,309480,270990.7,592200
567390,544730.3,930650,253930,267939.5,338450,313460,276790.8,592200
571940,593601.2,930650,254520,283462.1,338450,317420,310139.1,592200
576550,598079,930650,255090,283232.3,338450,321460,314846.7,592200
581510,596869.8,930650,255800,274830.5,338450,325710,322039.3,592200
586520,610922.7,930650,256520,278907.3,338450,330000,332015.4,592200
591530,633706.8,930650,257210,293343,338450,334320,340363.8,592200
596530,615739.5,930650,257920,281250.9,338450,338610,334488.6,592200
601540,624059.4,930650,259640,284979.5,338450,341900,339079.9,592200
606600,631221.1,930650,261370,287570.7,338450,345230,343650.4,592200
611660,637333.4,930650,263110,289579.7,338450,348550,347753.7,592200
616710,637539.2,930650,264860,281636.7,338450,351850,355902.5,592200
621840,644670.8,930650,266560,293320.8,338450,355280,351350,592200
626870,660231.8,930650,268230,295289.5,338450,358640,364942.3,592200
631990,634912.7,930650,269940,275989.9,338450,362050,358922.8,592200
637070,646986.9,930650,271630,277973.1,338450,365440,369013.8,592200
641690,675020.8,930650,273230,303120.2,338450,368460,371900.6,592200
646360,641211.9,930650,274840,282741.7,338450,371520,358470.2,592200
651010,665915.8,930650,276460,299053,338450,374550,366862.8,592200
655610,693388,930650,278060,316891.7,338450,377550,376496.3,592200
659380,696600.4,930650,278800,315492.3,338450,380580,381108.1,592200
663110,694047.5,930650,279510,313626.4,338450,383600,380421.1,592200
666850,677744.9,930650,280250,316343.6,338450,386600,361401.3,592200
670560,686063,930650,280980,313590.6,338450,389580,372472.4,592200
674520,688733.2,930650,281730,309774.7,338450,392790,378958.5,592200
678460,718331.2,930650,282490,312715.4,338450,395970,405615.8,592200
682450,734791.6,930650,283260,315946.3,338450,399190,418845.3,592200
686410,730939.2,930650,284010,316646.1,338450,402400,414293.1,592200
689550,708723,930650,284530,311633.2,338450,405020,397089.8,592200
692790,722641.6,930650,285080,310366.6,338450,407710,412275,592200
695990,726257,930650,285620,315357.5,338450,410370,410899.5,592200
699160,721867.7,930650,286140,313497.7,338450,413020,408370,592200
701820,730085.6,930650,286480,319211.4,338450,415340,410874.2,592200
704350,724823.7,930650,286770,315825.4,338450,417580,408998.3,592200
707060,730422.6,930650,287110,314652.6,338450,419950,415770,592200
709650,715902.4,930650,287420,305852.3,338450,422230,410050.1,592200
707560,713646,930650,282810,304792.1,338450,424750,408853.9,592200
705400,709323.1,930650,278190,302275.4,338450,427210,407047.7,592200
703290,733783.9,930650,273600,313297.4,338450,429690,420486.5,592200
740740,730777,930650,300120,315829.4,338450,440620,414947.6,592200
744070,739570.1,930650,300820,314964.2,338450,443250,424605.9,592200
747360,717267.6,930650,301530,310278.4,338450,445830,406989.2,592200
750670,741595.7,930650,302230,314297.4,338450,448440,427298.3,592200
753990,740848.5,930650,302910,312078.3,338450,451080,428770.2,592200
756740,742205.9,930650,303830,308841.9,338450,452910,433364,592200
759450,748011.8,930650,304720,307863.4,338450,454730,440148.4,592200
762160,761116.8,930650,305610,311082.5,338450,456550,450034.3,592200
764960,767828.9,930650,306500,319032.4,338450,458460,448796.5,592200
767630,766508.4,930650,307230,326185.6,338450,460400,440322.8,592200
770410,750816.7,930650,307980,322974.5,338450,462430,427842.2,592200
773200,747006.1,930650,308750,321887.5,338450,464450,425118.6,592200
775920,765578.4,930650,309490,327282.3,338450,466430,438296.1,592200
778120,741220.3,930650,310120,322307.6,338450,468000,418912.7,592200
780330,726045.3,930650,310780,319980.1,338450,469550,406065.2,592200
782450,721469.6,930650,311420,312790.1,338450,471030,408679.5,592200
784590,721504.5,930650,312060,313421.1,338450,472530,408083.4,592200
784850,723267.1,930650,311940,316220.5,338450,472910,407046.6,592200
785040,733799.5,930650,311830,318230.6,338450,473210,415568.9,592200
785310,744129.1,930650,311740,316726.8,338450,473570,427402.3,592200
785530,743836.1,930650,311620,315002.9,338450,473910,428833.2,592200
785770,735595.7,930650,311510,311585.5,338450,474260,424010.2,592200
785990,733346.9,930650,311390,307647.4,338450,474600,425699.5,592200
786310,722082.1,930650,311290,304284.3,338450,475020,417797.8,592200
786500,729698.2,930650,311190,305458.2,338450,475310,424240,592200
786580,730088.2,930650,311040,306724.7,338450,475540,423363.5,592200
786730,735779.9,930650,310910,309441.8,338450,475820,426338.1,592200
786830,731215.2,930650,310800,308500.6,338450,476030,422714.6,592200
786940,732772.4,930650,310660,314823.5,338450,476280,417948.9,592200
786930,729424.6,930650,310490,314296.9,338450,476440,415127.7,592200
786860,723136,930650,310310,310945.5,338450,476550,412190.5,592200
786900,712479.5,930650,310140,311379.9,338450,476760,401099.6,592200
786890,726328,930650,309980,314885.8,338450,476910,411442.2,592200
786890,728992.5,930650,309830,315903.6,338450,477060,413088.9,592200
786920,749484.9,930650,309700,319818.2,338450,477220,429666.7,592200
786930,752059.5,930650,309560,321015.9,338450,477370,431043.6,592200
786940,753816.6,930650,309420,318795.4,338450,477520,435021.2,592200
787070,750885.7,930650,309300,315981.4,338450,477770,434904.3,592200
787120,720793.5,930650,309170,313568.1,338450,477950,407225.4,592200
787160,721977.5,930650,309060,311580.5,338450,478100,410397,592200
787250,715373.6,930650,308930,308229.3,338450,478320,407144.3,592200
785790,700358.7,930650,308320,301410.8,338450,477470,398947.9,592200
784280,709760.8,930650,307700,302620.7,338450,476580,407140.1,592200
782740,727250.9,930650,307080,307483.7,338450,475660,419767.2,592200
781280,731966.4,930650,306500,306920.6,338450,474780,425045.8,592200
779640,748491.9,930650,305780,314781.2,338450,473860,433710.7,592200
778010,738188.3,930650,305090,310359.8,338450,472920,427828.5,592200
776340,732638.9,930650,304390,312762.1,338450,471950,419876.8,592200
774720,732127.6,930650,303700,310970.2,338450,471020,421157.4,592200
773230,731647,930650,303040,310060.2,338450,470190,421586.8,592200
771650,727143,930650,302380,307304.2,338450,469270,419838.8,592200
770130,739690.5,930650,301730,307680.4,338450,468400,432010.1,592200
768630,733918.3,930650,301100,303062.4,338450,467530,430855.9,592200
765190,739537.7,930650,300150,306221.2,338450,465040,433316.5,592200
761700,741170.8,930650,299170,307109.2,338450,462530,434061.6,592200
758190,734949.5,930650,298190,307616.7,338450,460000,427332.8,592200
754720,738123.3,930650,297220,309955,338450,457500,428168.3,592200
750930,732712.8,930650,296110,308387.2,338450,454820,424325.6,592200
747130,720992.4,930650,294960,303979.2,338450,452170,417013.2,592200
743430,719397.5,930650,293830,304536.9,338450,449600,414860.6,592200
739580,703749,930650,292710,302075.6,338450,446870,401673.4,592200
735040,686942.3,930650,291070,293783.9,338450,443970,393158.4,592200
730540,680989.5,930650,289460,295294.5,338450,441080,385695,592200
726070,672096.5,930650,287840,284060.7,338450,438230,388035.8,592200
721600,674071.2,930650,286210,289248.6,338450,435390,384822.6,592200
713450,674610.7,930650,283860,291583.1,338450,429590,383027.6,592200
705390,656069.2,930650,281510,277208.1,338450,423880,378861.1,592200
697340,646750.3,930650,279180,268667.2,338450,418160,378083.1,592200
689200,643205.8,930650,276830,265512.5,338450,412370,377693.3,592200
680640,615323.5,930650,274390,255065.4,338450,406250,360258.1,592200
672060,600728.8,930650,271960,248374.6,338450,400100,352354.2,592200
663460,588308.2,930650,269520,256305.3,338450,393940,332002.9,592200
654770,585338.7,930650,267100,258036.9,338450,387670,327301.8,592200
645890,566501.5,930650,264460,251815.3,338450,381430,314686.2,592200
636900,561232.8,930650,261820,245721.4,338450,375080,315511.4,592200
628030,540987.1,930650,259180,241719,338450,368850,299268.1,592200
619070,505759,930650,256540,228222.1,338450,362530,277536.9,592200
605080,506505.5,930650,249730,234930.6,338450,355350,271574.9,592200
591140,515483.7,930650,242920,238590.6,338450,348220,276893.1,592200
577120,520465.9,930650,236110,239280.9,338450,341010,281185,592200
563210,510419.5,930650,229330,233936.6,338450,333880,276482.9,592200
548890,480488.7,930650,222420,219956.9,338450,326470,260531.8,592200
534730,451706,930650,215570,207113.4,338450,319160,244592.6,592200
520470,445811,930650,208700,201736.7,338450,311770,244074.3,592200
506210,411492.4,930650,201840,179778.9,338450,304370,231713.5,592200
492340,380224.1,930650,195370,159273,338450,296970,220951.1,592200
478440,392215.4,930650,188930,163308.6,338450,289510,228906.8,592200
464490,388979.8,930650,182480,150764.2,338450,282010,238215.6,592200
450630,374054.2,930650,176050,139869.5,338450,274580,234184.7,592200
433060,341704.5,930650,167170,121927.8,338450,265890,219776.7,592200
415550,317392.6,930650,158300,104633.8,338450,257250,212758.8,592200
398140,299259.2,930650,149480,94686.9,338450,248660,204572.3,592200
380610,293745.6,930650,140610,91629.2,338450,240000,202116.4,592200
363800,287714.4,930650,132050,86639.7,338450,231750,201074.7,592200
346880,264164.7,930650,123460,73312.8,338450,223420,190851.9,592200
330040,235258.9,930650,114860,57084.8,338450,215180,178174.1,592200
218420,223760.7,930650,63620,49937.6,338450,154800,173823.1,592200
201480,203124.1,930650,55760,40262.8,338450,145720,162861.3,592200
184570,184063.9,930650,47880,33573,338450,136690,150490.9,592200
167590,166070.4,930650,40010,28125.8,338450,127580,137944.6,592200
150540,163052.4,930650,32120,28270.1,338450,118420,134782.3,592200
143440,162212.5,930650,30640,30363.1,338450,112800,131849.4,592200
136350,150993.7,930650,29200,28102.3,338450,107150,122891.4,592200
129250,141802.8,930650,27720,22524.5,338450,101530,119278.3,592200
122090,133284.8,930650,26260,17332.4,338450,95830,115952.4,592200
114850,126609,930650,24800,13076.4,338450,90050,113532.6,592200
107660,120761,930650,23350,11170.4,338450,84310,109590.6,592200
100460,115853.5,930650,21900,11705.5,338450,78560,104148,592200
93220,111353.2,930650,20420,9998.7,338450,72800,101354.5,592200
86210,104774.6,930650,19100,9051,338450,67110,95723.6,592200
79150,100083.6,930650,17770,8352.5,338450,61380,91731.1,592200
72130,93867.1,930650,16440,7763.6,338450,55690,86103.5,592200
65100,91949.9,930650,15120,8233.8,338450,49980,83716.1,592200
65730,90628.1,930650,18360,8129.6,338450,47370,82498.5,592200
66370,92748.1,930650,21590,8960.4,338450,44780,83787.7,592200
67090,93303.4,930650,24800,9035.1,338450,42290,84268.3,592200
67730,94158.3,930650,28020,8743.7,338450,39710,85414.6,592200
68650,94801.4,930650,31220,8865.6,338450,37430,85935.8,592200
69600,89773,930650,34420,9172,338450,35180,80601,592200
70580,83091.7,930650,37620,9580.6,338450,32960,73511.1,592200
71510,79384.7,930650,40810,9375.5,338450,30700,70009.2,592200
71790,92044.7,930650,43320,19262.1,338450,28470,72782.6,592200
72140,115781,930650,45820,37225.9,338450,26320,78555.1,592200
72510,106516.7,930650,48340,34047.4,338450,24170,72469.3,592200
72850,103663.2,930650,50840,33668.8,338450,22010,69994.4,592200
72870,149296.4,930650,51530,66484.6,338450,21340,82811.8,592200
72890,118049.9,930650,52210,43836.1,338450,20680,74213.8,592200
72930,95336.2,930650,52870,28534.2,338450,20060,66802,592200
72980,113659.5,930650,53530,44050,338450,19450,69609.5,592200
73170,130773.8,930650,54420,58760.8,338450,18750,72013,592200
73270,116593.4,930650,55270,49201.7,338450,18000,67391.7,592200
73420,121716.8,930650,56130,54590.9,338450,17290,67125.9,592200
73570,131252.1,930650,57000,60854.3,338450,16570,70397.8,592200
73690,186267.1,930650,58040,102101.6,338450,15650,84165.5,592200
73790,212097.7,930650,59040,121009.9,338450,14750,91087.8,592200
73920,105006.2,930650,60100,44958.9,338450,13820,60047.3,592200
74080,78203.7,930650,61110,26917.2,338450,12970,51286.5,592200
72480,167469.6,930650,59340,90931.5,338450,13140,76538.1,592200
70940,190938.6,930650,57560,108198.5,338450,13380,82740.1,592200
69340,104708.7,930650,55750,47459.4,338450,13590,57249.3,592200
67750,84607.7,930650,53970,32400.5,338450,13780,52207.2,592200
66080,115821.3,930650,51880,53531.3,338450,14200,62290,592200
64430,135073.9,930650,49780,66323.9,338450,14650,68750,592200
62770,146745.9,930650,47710,72081,338450,15060,74664.9,592200
61080,120564.1,930650,45610,52079.3,338450,15470,68484.8,592200
59720,95549.7,930650,43820,35477.4,338450,15900,60072.3,592200
58370,68450.4,930650,42030,14974.3,338450,16340,53476.1,592200
57060,82913.6,930650,40250,22282.5,338450,16810,60631.1,592200
55740,120855.1,930650,38480,49933.5,338450,17260,70921.6,592200
57370,127575.2,930650,38690,54107.5,338450,18680,73467.7,592200
59030,137188.9,930650,38980,57620.6,338450,20050,79568.3,592200
60660,155478.5,930650,39190,69614.7,338450,21470,85863.8,592200
62330,130371.3,930650,39450,50870.8,338450,22880,79500.5,592200
63280,112290.4,930650,38930,37419.9,338450,24350,74870.5,592200
64190,101325.7,930650,38380,29810.3,338450,25810,71515.4,592200
65070,84611.4,930650,37850,15442.2,338450,27220,69169.2,592200
66000,87338.9,930650,37310,15763.6,338450,28690,71575.3,592200
69210,107948,930650,38970,28756.2,338450,30240,79191.8,592200
72420,115487.9,930650,40620,36462.6,338450,31800,79025.3,592200
75650,120699.6,930650,42280,39416,338450,33370,81283.6,592200
78890,116486.5,930650,43940,35828.1,338450,34950,80658.4,592200
83290,116091.4,930650,47250,35531.1,338450,36040,80560.3,592200
87800,119400.2,930650,50580,38382.2,338450,37220,81018,592200
92230,137260.7,930650,53890,52763.2,338450,38340,84497.5,592200
96620,126992.9,930650,57220,48930.9,338450,39400,78062,592200
102960,107247,930650,61920,35800.9,338450,41040,71446.1,592200
109230,93450.1,930650,66570,25773.8,338450,42660,67676.3,592200
115580,85182.4,930650,71240,18277.5,338450,44340,66904.9,592200
121800,82411.6,930650,75910,17154.7,338450,45890,65256.9,592200
125400,95765.6,930650,78020,28620.9,338450,47380,67144.7,592200
129010,108103.9,930650,80130,36403.7,338450,48880,71700.2,592200
132620,109892.2,930650,82270,38491.9,338450,50350,71400.3,592200
136270,119223.9,930650,84390,45724.2,338450,51880,73499.7,592200
138980,121426.4,930650,85330,45813.6,338450,53650,75612.8,592200
141550,117878.7,930650,86270,43715.7,338450,55280,74163,592200
144240,107094.2,930650,87200,36966.4,338450,57040,70127.8,592200
146850,95310.8,930650,88140,29350.8,338450,58710,65960,592200
147760,102580.9,930650,87760,35054.6,338450,60000,67526.3,592200
148740,109399.6,930650,87410,37970.9,338450,61330,71428.7,592200
149720,137674.1,930650,87030,54887.8,338450,62690,82786.3,592200
150650,166562,930650,86680,72032.2,338450,63970,94529.8,592200
158010,187749,930650,92040,87652,338450,65970,100097,592200
165320,166883.2,930650,97410,76145.4,338450,67910,90737.8,592200
172640,139433.1,930650,102780,57856.3,338450,69860,81576.8,592200
179950,104626.8,930650,108130,31235.4,338450,71820,73391.4,592200
183920,105539,930650,110830,30382.6,338450,73090,75156.4,592200
187930,116856.7,930650,113570,39350,338450,74360,77506.7,592200
191970,135208.1,930650,116290,53557.5,338450,75680,81650.6,592200
195970,182634.7,930650,119010,86294.4,338450,76960,96340.3,592200
198760,212540.9,930650,120210,105613.2,338450,78550,106927.7,592200
201510,106115,930650,121420,26588,338450,80090,79527,592200
204230,131345.2,930650,122610,45843.6,338450,81620,85501.6,592200
127050,147964.6,930650,79480,56803.6,338450,47570,91161,592200
127270,159889.8,930650,78500,69470.9,338450,48770,90418.9,592200
127560,141826.2,930650,77530,57106.2,338450,50030,84720,592200
127730,148530.8,930650,76530,71869.7,338450,51200,76661.1,592200
127940,199554.8,930650,75550,104459,338450,52390,95095.8,592200
134600,174394.5,930650,81480,103083.6,338450,53120,71310.9,592200
141220,215621.3,930650,87410,116835,338450,53810,98786.3,592200
147870,265812.8,930650,93330,151766.9,338450,54540,114045.9,592200
154520,278603.3,930650,99230,163573.7,338450,55290,115029.6,592200
159670,280008.9,930650,103510,164497.1,338450,56160,115511.8,592200
164810,298806.4,930650,107720,177145.5,338450,57090,121660.9,592200
169980,302265.4,930650,111980,178821,338450,58000,123444.4,592200
175130,302443.9,930650,116210,180905.8,338450,58920,121538.1,592200
180100,286479.1,930650,120300,176978.8,338450,59800,109500.3,592200
185030,283315.9,930650,124390,176282.3,338450,60640,107033.6,592200
189990,289000.8,930650,128470,173851.3,338450,61520,115149.5,592200
194930,295772.9,930650,132550,178152.7,338450,62380,117620.2,592200
198970,285094.3,930650,133590,183283,338450,65380,101811.3,592200
203030,203626,930650,134630,127075.3,338450,68400,76550.7,592200
207110,304436.9,930650,135690,180540.8,338450,71420,123896.1,592200
211150,192305.3,930650,136740,107383.8,338450,74410,84921.5,592200
215710,297170.2,930650,137870,165180.1,338450,77840,131990.1,592200
220200,265083.9,930650,139000,137729.4,338450,81200,127354.5,592200
224720,233890.5,930650,140130,129641.6,338450,84590,104248.9,592200
229170,179238.9,930650,141260,103343.2,338450,87910,75895.7,592200
233380,176242,930650,142360,98984.9,338450,91020,77257.1,592200
237590,175099.9,930650,143480,93271.2,338450,94110,81828.7,592200
241840,272508.7,930650,144590,154440.2,338450,97250,118068.5,592200
246030,208039.6,930650,145700,105358.7,338450,100330,102680.9,592200
242170,196516.2,930650,142810,98215.1,338450,99360,98301.1,592200
238400,264401.5,930650,139960,145359.2,338450,98440,119042.3,592200
234550,207575.5,930650,137080,115711.6,338450,97470,91863.9,592200
230670,250075.9,930650,134200,143842.9,338450,96470,106233,592200
227080,256142.5,930650,131410,145196.8,338450,95670,110945.7,592200
223460,146657.5,930650,128620,55858.2,338450,94840,90799.3,592200
219810,164105.2,930650,125840,66804.8,338450,93970,97300.4,592200
216180,172561.9,930650,123060,69507.7,338450,93120,103054.2,592200
212020,201471.8,930650,119300,92755.3,338450,92720,108716.5,592200
207880,153524.6,930650,115520,58139.1,338450,92360,95385.5,592200
203630,121923.6,930650,111750,34016.5,338450,91880,87907.1,592200
199550,131121.9,930650,108000,38337.1,338450,91550,92784.8,592200
196610,158303.5,930650,103810,53893.8,338450,92800,104409.7,592200
193700,222362.7,930650,99590,95282.2,338450,94110,127080.5,592200
190850,266639.6,930650,95400,122921.2,338450,95450,143718.4,592200
187900,224130.8,930650,91180,91001,338450,96720,133129.8,592200
185610,175772,930650,87850,52087.7,338450,97760,123684.3,592200
183300,163949.3,930650,84500,39440.8,338450,98800,124508.5,592200
180970,150842.3,930650,81160,35480.6,338450,99810,115361.7,592200
178670,151892.4,930650,77820,35407.1,338450,100850,116485.3,592200
176870,149927.5,930650,75150,35098,338450,101720,114829.5,592200
175050,158407.5,930650,72480,39086.3,338450,102570,119321.2,592200
173280,171275.1,930650,69830,45294.5,338450,103450,125980.6,592200
171430,188268.8,930650,67180,55310.9,338450,104250,132957.9,592200
173220,180322.6,930650,66370,52536.8,338450,106850,127785.8,592200
174960,169184.2,930650,65560,47873.1,338450,109400,121311.1,592200
176810,175953.8,930650,64770,53778.2,338450,112040,122175.6,592200
178530,172944,930650,63970,50425.3,338450,114560,122518.7,592200
179550,173134.2,930650,63030,48347,338450,116520,124787.2,592200
180600,182808,930650,62100,48502.9,338450,118500,134305.1,592200
181640,172769.8,930650,61170,40496.8,338450,120470,132273,592200
182700,173060.7,930650,60270,38651.9,338450,122430,134408.8,592200
183750,166600.2,930650,59460,33526,338450,124290,133074.2,592200
184740,159628.1,930650,58660,27644.1,338450,126080,131984,592200
185730,149946,930650,57860,24763.8,338450,127870,125182.2,592200
186760,136718.2,930650,57060,22107.2,338450,129700,114611,592200
181600,152211.7,930650,55000,21599.6,338450,126600,130612.1,592200
176450,138654.8,930650,52970,29723.5,338450,123480,108931.3,592200
171200,149946.6,930650,50920,26266.3,338450,120280,123680.3,592200
166100,146823.3,930650,48910,18881,338450,117190,127942.3,592200
161180,148686.6,930650,46910,25395.4,338450,114270,123291.2,592200
156290,149986.6,930650,44910,16057.8,338450,111380,133928.8,592200
151420,149674.8,930650,42920,21283.3,338450,108500,128391.5,592200
146480,123053.8,930650,40930,14853,338450,105550,108200.8,592200
141520,110353.6,930650,38960,14857.9,338450,102560,95495.7,592200
136500,101203.1,930650,36980,11961.1,338450,99520,89242,592200
131530,100242,930650,35030,10228.3,338450,96500,90013.7,592200
126510,98830.4,930650,33040,8387.6,338450,93470,90442.8,592200
121210,93841.2,930650,31280,7634.1,338450,89930,86207.1,592200
115950,85981.6,930650,29520,7608.2,338450,86430,78373.4,592200
110680,83404.9,930650,27780,7194.8,338450,82900,76210.1,592200
105300,81877.1,930650,26010,5777.4,338450,79290,76099.7,592200
100460,82964.1,930650,24390,5304.3,338450,76070,77659.8,592200
95600,83452,930650,22820,5114.7,338450,72780,78337.3,592200
90730,80321.3,930650,21210,4686.5,338450,69520,75634.8,592200
85870,76713.3,930650,19610,4289.9,338450,66260,72423.4,592200
81470,75849.6,930650,18490,4878.5,338450,62980,70971.1,592200
77120,79856.2,930650,17350,7219.9,338450,59770,72636.3,592200
72750,81329.6,930650,16200,9398.3,338450,56550,71931.3,592200
68330,85512.9,930650,15060,11693.2,338450,53270,73819.7,592200
66570,91486,930650,15900,17468.4,338450,50670,74017.6,592200
64810,99272.3,930650,16760,24699.9,338450,48050,74572.4,592200
63090,99551.9,930650,17600,26393.3,338450,45490,73158.6,592200
61310,103834,930650,18430,29485.7,338450,42880,74348.3,592200
59620,109571.1,930650,19170,34770.2,338450,40450,74800.9,592200
57840,115229.5,930650,19900,39132.8,338450,37940,76096.7,592200
56230,121011.3,930650,20640,42523.9,338450,35590,78487.4,592200
59090,122057.1,930650,37120,49075.4,338450,21970,72981.7,592200
61070,127156.3,930650,39910,55011.4,338450,21160,72144.9,592200
63080,136166.7,930650,42690,61314.9,338450,20390,74851.8,592200
65030,133172,930650,45480,59448.6,338450,19550,73723.4,592200
67100,130245.3,930650,48270,58579.4,338450,18830,71665.9,592200
76570,126506.5,930650,53920,57087.3,338450,22650,69419.2,592200
86000,136241.3,930650,59590,63536.1,338450,26410,72705.2,592200
95460,151674.6,930650,65270,74282.2,338450,30190,77392.4,592200
104930,169974.4,930650,70950,86759.1,338450,33980,83215.3,592200
114360,176363.1,930650,76350,90086.4,338450,38010,86276.7,592200
123740,177280.9,930650,81730,89188.4,338450,42010,88092.5,592200
133200,174049.6,930650,87150,85036.1,338450,46050,89013.5,592200
142600,166390.4,930650,92540,80330.3,338450,50060,86060.1,592200
152030,177116.5,930650,97850,86078.8,338450,54180,91037.7,592200
161510,206413.3,930650,103210,105597.3,338450,58300,100816,592200
170930,196016.6,930650,108490,105977.6,338450,62440,90039,592200
180360,193706.2,930650,113820,112154.7,338450,66540,81551.5,592200
192220,191527.8,930650,118940,107785.7,338450,73280,83742.1,592200
204140,201150.2,930650,124050,111586.9,338450,80090,89563.3,592200
215940,213197.9,930650,129130,116973.3,338450,86810,96224.6,592200
227810,224383.2,930650,134250,121807.7,338450,93560,102575.5,592200
239090,234077.2,930650,138800,127376,338450,100290,106701.2,592200
250370,244971.8,930650,143360,132038.8,338450,107010,112933,592200
261630,272193.3,930650,147940,148272,338450,113690,123921.3,592200
272900,281663.9,930650,152490,149516.3,338450,120410,132147.6,592200
284590,289216.1,930650,157250,149162.5,338450,127340,140053.6,592200
296310,285990.8,930650,162000,140583.2,338450,134310,145407.6,592200
307980,296035.2,930650,166780,141348.1,338450,141200,154687.1,592200
319640,299469.2,930650,171560,142375.7,338450,148080,157093.5,592200
323910,296945,930650,172770,141350.8,338450,151140,155594.2,592200
328080,312463.2,930650,174020,153394.9,338450,154060,159068.3,592200
332270,304992,930650,175200,145620.1,338450,157070,159371.9,592200
336520,366499.2,930650,176450,182537.9,338450,160070,183961.3,592200
337460,423191.1,930650,175720,215059.9,338450,161740,208131.2,592200
338350,408491.4,930650,174970,208000.3,338450,163380,200491.1,592200
339290,400649.1,930650,174210,210578.2,338450,165080,190070.9,592200
340210,385682.7,930650,173480,198371,338450,166730,187311.7,592200
343530,372157.5,930650,175010,192089.9,338450,168520,180067.6,592200
346910,350767.2,930650,176560,178955.8,338450,170350,171811.4,592200
350210,392468.5,930650,178090,206667.5,338450,172120,185801,592200
353520,418423,930650,179610,229174,338450,173910,189249,592200
364120,389651.6,930650,182650,209630.3,338450,181470,180021.3,592200
374830,402817.5,930650,185710,219753.1,338450,189120,183064.4,592200
385500,434674.8,930650,188760,236429.7,338450,196740,198245.1,592200
396190,432902.5,930650,191820,230611.1,338450,204370,202291.4,592200
407800,423033.6,930650,195560,210672.3,338450,212240,212361.3,592200
419370,398859.4,930650,199270,195776.1,338450,220100,203083.3,592200
431010,397919.9,930650,202990,196377.6,338450,228020,201542.3,592200
442580,437349.8,930650,206720,220616.4,338450,235860,216733.4,592200
452060,449526.6,930650,209240,230381.2,338450,242820,219145.4,592200
461560,455010.8,930650,211810,230486.4,338450,249750,224524.4,592200
471120,459875.2,930650,214360,229351,338450,256760,230524.2,592200
480620,492255.4,930650,216900,250455.8,338450,263720,241799.6,592200
487300,489547.6,930650,219360,250525.2,338450,267940,239022.4,592200
493940,499874.6,930650,221830,254939.4,338450,272110,244935.2,592200
500560,515272.6,930650,224300,253485.1,338450,276260,261787.5,592200
507230,508341.1,930650,226780,247444.8,338450,280450,260896.3,592200
513700,518890.1,930650,229290,248122.6,338450,284410,270767.5,592200
520230,510949.3,930650,231800,240854.2,338450,288430,270095.1,592200
526720,507959,930650,234290,230516,338450,292430,277443,592200
533220,518436,930650,236790,243443.3,338450,296430,274992.7,592200
540350,531895.7,930650,240310,249612,338450,300040,282283.7,592200
547500,520735.9,930650,243900,242037.8,338450,303600,278698.1,592200
554610,522881.8,930650,247430,243856.6,338450,307180,279025.2,592200
561710,524810.2,930650,250950,242743.3,338450,310760,282066.9,592200
564700,530436.4,930650,251630,249832.4,338450,313070,280604,592200
567600,529147.6,930650,252270,252415.7,338450,315330,276731.9,592200
570500,533917,930650,252930,255694.1,338450,317570,278222.9,592200
573430,531486.9,930650,253600,247431.1,338450,319830,284055.8,592200
576780,528720.9,930650,254410,247328.8,338450,322370,281392.1,592200
580020,545121,930650,255190,257576.3,338450,324830,287544.7,592200
583310,534032.3,930650,256010,258080.5,338450,327300,275951.8,592200
586570,557630.4,930650,256800,267203.9,338450,329770,290426.5,592200
590350,580712.3,930650,257710,261889.8,338450,332640,318822.5,592200
594020,589037.4,930650,258600,264981.3,338450,335420,324056.1,592200
597780,596314.8,930650,259500,273447.5,338450,338280,322867.3,592200
601540,602342.8,930650,260410,277877.4,338450,341130,324465.4,592200
609230,633085,930650,262320,291384.8,338450,346910,341700.2,592200
617000,639105.4,930650,264250,289741.8,338450,352750,349363.6,592200
624730,637095.4,930650,266180,284334.5,338450,358550,352760.9,592200
632490,663835,930650,268110,292412.7,338450,364380,371422.3,592200
639940,677544.8,930650,269930,298763,338450,370010,378781.8,592200
647400,686080.5,930650,271740,300528.1,338450,375660,385552.4,592200
654910,690533.3,930650,273590,305081.3,338450,381320,385452,592200
662280,704198.2,930650,275380,308599.8,338450,386900,395598.4,592200
669690,706658.4,930650,277260,304962.2,338450,392430,401696.2,592200
677100,712303.9,930650,279130,307854,338450,397970,404449.9,592200
684490,719698.4,930650,281000,310884.3,338450,403490,408814.1,592200
691900,740368,930650,282860,312648.1,338450,409040,427719.9,592200
695000,750258,930650,283700,312684.4,338450,411300,437573.6,592200
698120,759777.9,930650,284540,310156.6,338450,413580,449621.3,592200
701220,764729.2,930650,285350,307549.4,338450,415870,457179.8,592200
704310,774712.6,930650,286190,305291.9,338450,418120,469420.7,592200
707320,767130,930650,287080,304749.7,338450,420240,462380.3,592200
710280,779601.6,930650,287930,313501.3,338450,422350,466100.3,592200
713330,773486,930650,288820,314200.4,338450,424510,459285.6,592200
722020,761477,930650,295440,315566.2,338450,426580,445910.8,592200
725170,769376.4,930650,296010,313522.8,338450,429160,455853.6,592200
728320,778615.9,930650,296580,315749.9,338450,431740,462866,592200
731470,794959.8,930650,297160,314880.5,338450,434310,480079.3,592200
734580,781732.1,930650,297730,313819.2,338450,436850,467912.9,592200
736220,775759.3,930650,297920,312928.6,338450,438300,462830.7,592200
737820,781970.8,930650,298140,314278.1,338450,439680,467692.7,592200
739430,793515.7,930650,298360,316664.6,338450,441070,476851.1,592200
740970,787183.2,930650,298550,316951.6,338450,442420,470231.6,592200
742490,785697.7,930650,298780,315629.3,338450,443710,470068.4,592200
743970,782504.8,930650,298990,314835,338450,444980,467669.8,592200
745460,769659.8,930650,299250,313598.1,338450,446210,456061.7,592200
746920,761711.6,930650,299480,312261.7,338450,447440,449449.9,592200
748360,764993.6,930650,299770,313903.8,338450,448590,451089.8,592200
749920,767900.5,930650,300080,312948.4,338450,449840,454952.1,592200
751400,755382.6,930650,300390,309784.6,338450,451010,445598,592200
752920,748763.6,930650,300690,307081,338450,452230,441682.6,592200
753400,751753.1,930650,300840,307241.4,338450,452560,444511.7,592200
753930,745791.3,930650,300990,302590.6,338450,452940,443200.7,592200
754410,742963.5,930650,301150,300468.9,338450,453260,442494.6,592200
754890,743002.9,930650,301290,303485.6,338450,453600,439517.3,592200
755370,739907.8,930650,301320,306089.9,338450,454050,433817.9,592200
755770,741520.7,930650,301360,307839,338450,454410,433681.7,592200
756250,757594.8,930650,301400,307841,338450,454850,449753.8,592200
756720,768027.6,930650,301420,308008.4,338450,455300,460019.2,592200
757360,764644.7,930650,301520,302428.7,338450,455840,462216,592200
758010,768863.4,930650,301640,301525.2,338450,456370,467338.2,592200
758670,773901.1,930650,301740,301856,338450,456930,472045.1,592200
759290,762030.9,930650,301820,296010.6,338450,457470,466020.3,592200
758980,752512.8,930650,301500,296937.7,338450,457480,455575.1,592200
758700,775202.6,930650,301200,304797.4,338450,457500,470405.2,592200
758430,786182.2,930650,300880,309690.9,338450,457550,476491.3,592200
758140,795912.1,930650,300570,312213.4,338450,457570,483698.7,592200
757710,795340.6,930650,300270,310097.7,338450,457440,485242.9,592200
757270,788218.5,930650,300000,313550.9,338450,457270,474667.6,592200
756860,765586,930650,299700,310747.4,338450,457160,454838.6,592200
756510,743465.2,930650,299430,307319.7,338450,457080,436145.5,592200
755290,745899.2,930650,299220,304235,338450,456070,441664.2,592200
754180,743944.4,930650,299030,299026.7,338450,455150,444917.7,592200
753070,742058.4,930650,298840,298752.9,338450,454230,443305.5,592200
751890,740296.5,930650,298630,300466.4,338450,453260,439830.1,592200
753020,734229.4,930650,298850,295759.4,338450,454170,438470,592200
754010,730995.1,930650,299010,298691.8,338450,455000,432303.3,592200
755010,710709.7,930650,299210,292358,338450,455800,418351.7,592200
756070,693291.1,930650,299410,290206.4,338450,456660,403084.7,592200
757880,702528.1,930650,299460,295027.2,338450,458420,407500.9,592200
759620,680209.2,930650,299460,287319.6,338450,460160,392889.6,592200
761460,675270.1,930650,299530,281576,338450,461930,393694.1,592200
763200,677959.2,930650,299580,274624.4,338450,463620,403334.8,592200
764780,650581.6,930650,299650,263120.1,338450,465130,387461.5,592200
766330,645308.7,930650,299720,259557.5,338450,466610,385751.2,592200
767880,654144.4,930650,299780,260015.7,338450,468100,394128.7,592200
769470,653372.6,930650,299860,265561.8,338450,469610,387810.8,592200
768120,651704,930650,299400,272036.9,338450,468720,379667.1,592200
766700,676801.7,930650,298920,280125.5,338450,467780,396676.2,592200
765270,669056.8,930650,298430,271929,338450,466840,397127.8,592200
763910,682893.1,930650,297960,278596.4,338450,465950,404296.7,592200
762060,701701.9,930650,297290,284480.8,338450,464770,417221.1,592200
760270,698651.8,930650,296620,288695.5,338450,463650,409956.3,592200
758450,694744.8,930650,295950,292213.5,338450,462500,402531.3,592200
756600,695002.7,930650,295290,291546.2,338450,461310,403456.5,592200
755210,712086.9,930650,294720,291153.6,338450,460490,420933.3,592200
753780,721751.1,930650,294170,296808.2,338450,459610,424942.9,592200
752330,731600.5,930650,293590,294281.5,338450,458740,437319,592200
750930,704974.4,930650,293000,278620.9,338450,457930,426353.5,592200
750480,700748.6,930650,293150,276183.1,338450,457330,424565.5,592200
750110,699576.7,930650,293300,272831.6,338450,456810,426745.1,592200
749760,686131.4,930650,293450,260366.1,338450,456310,425765.3,592200
749340,714615.9,930650,293580,280915.2,338450,455760,433700.7,592200
749350,722696.6,930650,293860,287863.6,338450,455490,434833,592200
749290,726318.2,930650,294130,289709.8,338450,455160,436608.4,592200
749300,735658.2,930650,294410,297084.3,338450,454890,438573.9,592200
749300,744764.9,930650,294680,299387.9,338450,454620,445377,592200
749140,752099.5,930650,294860,302006.3,338450,454280,450093.2,592200
748980,769926.2,930650,295070,306448.5,338450,453910,463477.7,592200
748910,777504.6,930650,295250,315277.4,338450,453660,462227.2,592200
748730,775235.9,930650,295430,314237.8,338450,453300,460998.1,592200
745290,774398.4,930650,293300,313920.5,338450,451990,460477.9,592200
741810,751515,930650,291170,304161.2,338450,450640,447353.8,592200
738350,751945.2,930650,289050,302538.2,338450,449300,449407,592200
734890,757052.9,930650,286910,290152.1,338450,447980,466900.8,592200
730610,788018.6,930650,284190,303247.4,338450,446420,484771.2,592200
726270,781804.2,930650,281470,303474.4,338450,444800,478329.8,592200
722000,748897.4,930650,278740,278695.9,338450,443260,470201.5,592200
717680,739212.2,930650,276010,265725.1,338450,441670,473487.1,592200
714270,719816.2,930650,273640,273029.8,338450,440630,446786.4,592200
710910,744786.8,930650,271260,302959.8,338450,439650,441827,592200
707530,760672.5,930650,268900,310954.2,338450,438630,449718.3,592200
704180,760443.3,930650,266540,299835.2,338450,437640,460608.1,592200
694520,740564.5,930650,263850,275930.7,338450,430670,464633.8,592200
684850,739085.8,930650,261170,285584.9,338450,423680,453500.9,592200
675240,765095,930650,258510,303566.5,338450,416730,461528.5,592200
665640,716943.7,930650,255820,282758.4,338450,409820,434185.3,592200
656420,664302.4,930650,253120,267235.9,338450,403300,397066.5,592200
647130,623270.3,930650,250460,246555.7,338450,396670,376714.6,592200
638000,564645.2,930650,247800,221493.3,338450,390200,343151.9,592200
586730,559557,930650,222370,224155.8,338450,364360,335401.2,592200
576230,589954.3,930650,219690,228132.1,338450,356540,361822.2,592200
565630,614494.9,930650,217000,233367.8,338450,348630,381127.1,592200
555010,606094.6,930650,214300,233365.4,338450,340710,372729.2,592200
544430,581802,930650,211640,233310.5,338450,332790,348491.5,592200
534850,563875.5,930650,208100,228434.3,338450,326750,335441.2,592200
525140,554803.7,930650,204530,230246.6,338450,320610,324557.1,592200
515480,528624,930650,200960,225256.7,338450,314520,303367.3,592200
505880,497293.8,930650,197430,212960.8,338450,308450,284333,592200
495030,493046.3,930650,193140,208640.2,338450,301890,284406.1,592200
484140,489275.3,930650,188830,210072.1,338450,295310,279203.2,592200
473270,458826.5,930650,184540,195248.1,338450,288730,263578.4,592200
462450,444214.2,930650,180230,185350,338450,282220,258864.2,592200
454410,450219.1,930650,177980,202063.7,338450,276430,248155.4,592200
446300,430978,930650,175700,194730.5,338450,270600,236247.5,592200
438190,416204.5,930650,173430,185310.5,338450,264760,230894,592200
430090,419011.6,930650,171170,192857.8,338450,258920,226153.8,592200
426310,409423.9,930650,170620,194694.3,338450,255690,214729.6,592200
422630,414507.4,930650,170130,192563.4,338450,252500,221944,592200
418860,407155.7,930650,169580,187306.6,338450,249280,219849.1,592200
415100,373404.3,930650,169060,174579.2,338450,246040,198825.1,592200
410080,361549.5,930650,167080,165663.8,338450,243000,195885.7,592200
405140,339281.7,930650,165120,153262.6,338450,240020,186019.1,592200
400080,333239.9,930650,163120,138773.6,338450,236960,194466.3,592200
395100,310869.8,930650,161130,132925.7,338450,233970,177944.1,592200
390430,324727.1,930650,159680,143076.8,338450,230750,181650.3,592200
385740,327564.7,930650,158230,145545.1,338450,227510,182019.6,592200
381000,324559.7,930650,156780,144464.4,338450,224220,180095.3,592200
376320,335140.1,930650,155310,139324.4,338450,221010,195815.7,592200
383440,341419,930650,157070,142889.9,338450,226370,198529.1,592200
390470,332001.3,930650,158820,142157.9,338450,231650,189843.4,592200
397570,317115.3,930650,160570,137964.6,338450,237000,179150.7,592200
404660,326460.4,930650,162320,139207.9,338450,242340,187252.5,592200
410430,321574.7,930650,162440,133855.9,338450,247990,187718.8,592200
416270,345241.3,930650,162580,140656.2,338450,253690,204585.1,592200
422050,368865.6,930650,162690,157140,338450,259360,211725.6,592200
427840,346740.4,930650,162820,159948.5,338450,265020,186791.9,592200
435220,349531.5,930650,164530,158849.5,338450,270690,190682,592200
442530,338014.9,930650,166280,151695.9,338450,276250,186319,592200
449830,340414.9,930650,168000,146553.5,338450,281830,193861.4,592200
457210,343895.3,930650,169730,149302.9,338450,287480,194592.4,592200
458300,350370.4,930650,167970,161641.8,338450,290330,188728.6,592200
459480,388263.5,930650,166190,179941.1,338450,293290,208322.4,592200
460620,394920.7,930650,164420,165763.2,338450,296200,229157.5,592200
461760,371402.7,930650,162630,155805.6,338450,299130,215597.1,592200
463860,367178.1,930650,161790,163501.5,338450,302070,203676.6,592200
465860,342668.1,930650,160900,139478.1,338450,304960,203190,592200
467910,323874.6,930650,160030,116060.1,338450,307880,207814.5,592200
469950,314642.9,930650,159170,104344.9,338450,310780,210298,592200
470250,370054.9,930650,157080,123015.9,338450,313170,247039,592200
470490,398964.9,930650,154980,142214.5,338450,315510,256750.4,592200
470800,417284.8,930650,152900,150199.5,338450,317900,267085.3,592200
471040,368231.7,930650,150820,135446,338450,320220,232785.7,592200
470290,375185.6,930650,151460,131016.5,338450,318830,244169.1,592200
469490,335629.9,930650,152090,120759.8,338450,317400,214870.1,592200
468750,304236.9,930650,152740,108736.7,338450,316010,195500.2,592200
467980,294670,930650,153360,103332.7,338450,314620,191337.3,592200
466360,323079.6,930650,153930,113264.6,338450,312430,209815,592200
464780,334448.9,930650,154480,116824.9,338450,310300,217624,592200
463210,293642.9,930650,155040,92125.9,338450,308170,201517,592200
461570,280205.1,930650,155580,90474.3,338450,305990,189730.8,592200
460530,286997.6,930650,157180,97052.6,338450,303350,189945,592200
459500,356525.3,930650,158790,146308.2,338450,300710,210217.1,592200
458430,329417.2,930650,160350,122053.8,338450,298080,207363.4,592200
457380,344190.3,930650,161960,126901.4,338450,295420,217288.9,592200
455490,396502.7,930650,161000,141912.6,338450,294490,254590.1,592200
453530,377609.1,930650,160040,118891.7,338450,293490,258717.4,592200
451630,394475.1,930650,159080,140290.8,338450,292550,254184.3,592200
449800,381715.5,930650,158140,142366.3,338450,291660,239349.2,592200
447550,396911.6,930650,157590,153508.5,338450,289960,243403.1,592200
445420,402099.2,930650,157080,156506.7,338450,288340,245592.5,592200
443180,400209,930650,156540,151172.4,338450,286640,249036.6,592200
440890,431156.2,930650,156010,165993.1,338450,284880,265163.1,592200
439890,422588,930650,154570,141813.6,338450,285320,280774.4,592200
438830,413109.8,930650,153140,143245.3,338450,285690,269864.5,592200
437830,440631.8,930650,151690,161895.5,338450,286140,278736.3,592200
436750,522012.2,930650,150250,216762.5,338450,286500,305249.7,592200
434570,502159.7,930650,150690,196534,338450,283880,305625.7,592200
432470,416978.4,930650,151130,141833.3,338450,281340,275145.1,592200
430280,329167.2,930650,151580,88563,338450,278700,240604.2,592200
428130,378082.3,930650,152010,118197.6,338450,276120,259884.7,592200
425800,365094.9,930650,152610,107036.8,338450,273190,258058.1,592200
423490,322831.9,930650,153250,93757.5,338450,270240,229074.4,592200
421140,341261.1,930650,153810,101901.9,338450,267330,239359.2,592200
418830,337618,930650,154410,95281.4,338450,264420,242336.6,592200
415990,361607.9,930650,154470,107298.2,338450,261520,254309.7,592200
413090,378475.4,930650,154490,120441.1,338450,258600,258034.3,592200
410240,434704.5,930650,154550,147925.1,338450,255690,286779.4,592200
407360,505170.6,930650,154590,202373.4,338450,252770,302797.2,592200
402900,452256,930650,153160,181981.9,338450,249740,270274.1,592200
398330,447216.4,930650,151700,184813.9,338450,246630,262402.5,592200
393890,477622.3,930650,150260,201201.7,338450,243630,276420.6,592200
389410,494832.1,930650,148840,203558.4,338450,240570,291273.7,592200
383030,545736.5,930650,146400,224241,338450,236630,321495.5,592200
376790,542287.8,930650,144010,214323.8,338450,232780,327964,592200
370480,515071,930650,141580,191525.8,338450,228900,323545.2,592200
525340,503454.4,930650,223510,185952.1,338450,301830,317502.3,592200
520210,504679.9,930650,222010,185769.3,338450,298200,318910.6,592200
514950,466942.5,930650,220450,168273.6,338450,294500,298668.9,592200
509720,436332.5,930650,218940,150525.1,338450,290780,285807.4,592200
504520,404327.5,930650,217390,135721.3,338450,287130,268606.2,592200
493970,386033.4,930650,213810,132651.5,338450,280160,253381.9,592200
483460,396432.2,930650,210220,138224,338450,273240,258208.2,592200
472880,389769.1,930650,206620,142525.6,338450,266260,247243.5,592200
462360,408020.1,930650,203030,153109.1,338450,259330,254911,592200
452980,417145.3,930650,199920,152955.2,338450,253060,264190.1,592200
443610,437974.1,930650,196830,170989.6,338450,246780,266984.5,592200
434250,436362.8,930650,193720,165461.4,338450,240530,270901.4,592200
424940,433993.2,930650,190630,174767.1,338450,234310,259226.1,592200
417020,484571.7,930650,188560,217363.3,338450,228460,267208.4,592200
409070,540068.5,930650,186460,261486.5,338450,222610,278582,592200
401160,528778.7,930650,184350,254008,338450,216810,274770.7,592200
393260,503990.8,930650,182260,241530.8,338450,211000,262460,592200
386990,470427.9,930650,179250,213715.1,338450,207740,256712.8,592200
380730,491669.1,930650,176250,229121.3,338450,204480,262547.8,592200
374410,500711.3,930650,173230,232091.9,338450,201180,268619.4,592200
368190,468666,930650,170240,210192.6,338450,197950,258473.4,592200
361100,413901.2,930650,166560,184362.1,338450,194540,229539.1,592200
354040,377245,930650,162870,164229.3,338450,191170,213015.7,592200
346910,327381.5,930650,159170,131279.5,338450,187740,196102,592200
339820,311922.8,930650,155470,126529.6,338450,184350,185393.2,592200
333530,302938.9,930650,152430,125368.2,338450,181100,177570.7,592200
327330,314296.9,930650,149390,134336.6,338450,177940,179960.3,592200
321080,351292.2,930650,146370,153780.9,338450,174710,197511.3,592200
314820,327945.9,930650,143330,133424.3,338450,171490,194521.6,592200
305810,325995.8,930650,140090,122538.5,338450,165720,203457.3,592200
296900,328984.2,930650,136840,109606.9,338450,160060,219377.3,592200
287880,300063,930650,133580,89618.2,338450,154300,210444.8,592200
278980,261389.8,930650,130350,80691.2,338450,148630,180698.6,592200
270300,262483.1,930650,127510,81695,338450,142790,180788.1,592200
261600,262736.1,930650,124640,77884.6,338450,136960,184851.5,592200
252930,267811.4,930650,121790,84530.5,338450,131140,183280.9,592200
244280,242094,930650,118930,82053.8,338450,125350,160040.2,592200
235900,205470.4,930650,115890,67522.6,338450,120010,137947.8,592200
227370,184223.5,930650,112800,56292.3,338450,114570,127931.2,592200
218860,198728,930650,109730,61852.6,338450,109130,136875.4,592200
210380,205565.2,930650,106660,63647.6,338450,103720,141917.6,592200
202170,199163.2,930650,102120,56083,338450,100050,143080.2,592200
193860,223473.3,930650,97510,61883.2,338450,96350,161590.1,592200
185630,242052.2,930650,92940,66126,338450,92690,175926.2,592200
177350,248090.4,930650,88360,67790,338450,88990,180300.4,592200
169370,215295,930650,83680,63815.6,338450,85690,151479.4,592200
161340,198218.2,930650,79030,58550.1,338450,82310,139668.1,592200
153290,206626.7,930650,74350,61738.6,338450,78940,144888.1,592200
145270,200517.2,930650,69680,55407.7,338450,75590,145109.5,592200
137380,185133.6,930650,65150,47302.2,338450,72230,137831.4,592200
129540,181475.9,930650,60620,49931.6,338450,68920,131544.3,592200
121700,178416.4,930650,56090,47903.1,338450,65610,130513.3,592200
113840,170052.7,930650,51570,39565.9,338450,62270,130486.8,592200
108490,157941.8,930650,48100,36581.6,338450,60390,121360.2,592200
103030,162111.3,930650,44610,36037.6,338450,58420,126073.7,592200
97620,143248.4,930650,41140,31546.9,338450,56480,111701.5,592200
92170,147851.7,930650,37650,33089.5,338450,54520,114762.2,592200
86760,142407.8,930650,34200,27288.3,338450,52560,115119.5,592200
81370,133033.1,930650,30750,24411.4,338450,50620,108621.7,592200
75920,127358.4,930650,27280,21181.5,338450,48640,106176.9,592200
70490,126513.4,930650,23820,19666,338450,46670,106847.4,592200
65140,128856.2,930650,20370,22637.3,338450,44770,106218.9,592200
59760,137189.6,930650,16930,26930,338450,42830,110259.6,592200
54380,113501.9,930650,13490,15719.6,338450,40890,97782.3,592200
49020,111223.1,930650,10040,16543.2,338450,38980,94679.9,592200
49700,112055.5,930650,11020,20493.9,338450,38680,91561.6,592200
50330,116676,930650,11980,20817.5,338450,38350,95858.5,592200
51100,110844.4,930650,12990,16784.5,338450,38110,94059.9,592200
51810,105922.2,930650,13960,15200.5,338450,37850,90721.7,592200
52700,95431.4,930650,15110,11780.7,338450,37590,83650.7,592200
53520,93066.1,930650,16290,13192.9,338450,37230,79873.2,592200
54390,90287.2,930650,17460,9501.9,338450,36930,80785.3,592200
55220,90576.4,930650,18630,7555.6,338450,36590,83020.8,592200
55520,89157.5,930650,19330,8115.8,338450,36190,81041.7,592200
55940,97450.4,930650,20060,12114.6,338450,35880,85335.8,592200
56300,106479.8,930650,20780,14402.1,338450,35520,92077.7,592200
56650,110459.1,930650,21500,13928.4,338450,35150,96530.7,592200
57580,114262.1,930650,21850,13099.7,338450,35730,101162.4,592200
58440,127607.6,930650,22180,18350.1,338450,36260,109257.5,592200
59340,147377.3,930650,22520,29331.8,338450,36820,118045.5,592200
60260,195222.8,930650,22870,57592.5,338450,37390,137630.3,592200
61800,218164.9,930650,23730,73472.2,338450,38070,144692.7,592200
63160,184537.1,930650,24540,47438.2,338450,38620,137098.9,592200
64550,164573,930650,25350,28094.1,338450,39200,136478.9,592200
66000,158177.1,930650,26180,24737.8,338450,39820,133439.3,592200
67590,158580.6,930650,27080,20899.6,338450,40510,137681,592200
69200,180586.9,930650,27980,32859.8,338450,41220,147727.1,592200
70740,175371.5,930650,28880,31637.2,338450,41860,143734.3,592200
72370,152465.1,930650,29790,20581.2,338450,42580,131883.9,592200
71740,157153.7,930650,29080,21684.2,338450,42660,135469.5,592200
71140,158565.6,930650,28370,25956.9,338450,42770,132608.7,592200
70560,163545.9,930650,27680,28998.2,338450,42880,134547.7,592200
69940,161704.4,930650,26970,25812.5,338450,42970,135891.9,592200
69150,154617.1,930650,26230,23314.2,338450,42920,131302.9,592200
68390,170884.7,930650,25510,32043.5,338450,42880,138841.2,592200
67600,164624.7,930650,24800,30448.9,338450,42800,134175.8,592200
80720,165214.3,930650,26470,30181.8,338450,54250,135032.5,592200
79510,171705.9,930650,25740,34925.2,338450,53770,136780.7,592200
78390,163976,930650,25000,35443.1,338450,53390,128532.9,592200
77140,168322.3,930650,24240,36875,338450,52900,131447.3,592200
75970,179819.6,930650,23500,44411.4,338450,52470,135408.2,592200
76520,179287.7,930650,23680,45919.7,338450,52840,133368,592200
77110,176792.7,930650,23860,43481.5,338450,53250,133311.2,592200
77700,188391.7,930650,24040,45310.9,338450,53660,143080.8,592200
78270,188755.8,930650,24210,46675.6,338450,54060,142080.2,592200
78920,204302.8,930650,24320,51024,338450,54600,153278.8,592200
79530,229111.7,930650,24400,64606.5,338450,55130,164505.2,592200
80180,252523.4,930650,24490,80853.3,338450,55690,171670.1,592200
80820,268497.5,930650,24580,91596.2,338450,56240,176901.3,592200
82170,273190.2,930650,25070,95805.7,338450,57100,177384.5,592200
83520,273382.5,930650,25560,96352.5,338450,57960,177030,592200
84910,276976.2,930650,26050,92061.5,338450,58860,184914.7,592200
86210,290547.7,930650,26550,96936.2,338450,59660,193611.5,592200
87100,279863.6,930650,26540,90460.9,338450,60560,189402.7,592200
88040,260105.5,930650,26550,78638.3,338450,61490,181467.2,592200
89010,263372.7,930650,26560,77283,338450,62450,186089.7,592200
89970,259694.1,930650,26570,75391.5,338450,63400,184302.6,592200
89600,255081.4,930650,25790,76307.2,338450,63810,178774.2,592200
89290,245763.1,930650,25030,74415.6,338450,64260,171347.5,592200
89020,232959.6,930650,24270,67959.3,338450,64750,165000.3,592200
88680,232399.3,930650,23510,63961.4,338450,65170,168437.9,592200
88970,239329.4,930650,23310,59916.6,338450,65660,179412.8,592200
89210,257362.8,930650,23130,61241.4,338450,66080,196121.4,592200
89500,254962.2,930650,22930,58266.6,338450,66570,196695.6,592200
89830,251932.5,930650,22750,55868.7,338450,67080,196063.8,592200
96260,249998.1,930650,25310,58714.9,338450,70950,191283.2,592200
102730,236158.3,930650,27840,53259.9,338450,74890,182898.4,592200
109150,223393,930650,30370,48758.8,338450,78780,174634.2,592200
115540,215753,930650,32920,48310,338450,82620,167443,592200
121890,220793.2,930650,35340,48980.7,338450,86550,171812.5,592200
128230,221900,930650,37770,44604,338450,90460,177296,592200
134580,192806.5,930650,40160,31587.2,338450,94420,161219.3,592200
140930,178552.6,930650,42600,28234.1,338450,98330,150318.5,592200
146980,186939,930650,45140,27296.5,338450,101840,159642.5,592200
153070,184167.3,930650,47710,27207.4,338450,105360,156959.9,592200
159120,172392.7,930650,50260,28036.8,338450,108860,144355.9,592200
165090,171546.3,930650,52790,33757.8,338450,112300,137788.5,592200
163940,187629.6,930650,51400,49463.5,338450,112540,138166.1,592200
162790,186555.2,930650,50030,46373.9,338450,112760,140181.3,592200
161510,194090.6,930650,48630,46560.2,338450,112880,147530.4,592200
160370,194090.6,930650,47250,46560.2,338450,113120,147530.4,592200
159840,180643.8,930650,45810,39344,338450,114030,141299.8,592200
159300,182416.1,930650,44370,39478.5,338450,114930,142937.6,592200
158720,179083.3,930650,42890,38903.5,338450,115830,140179.8,592200
158170,161056.8,930650,41460,34747.5,338450,116710,126309.3,592200
159010,160630.7,930650,40540,27999.6,338450,118470,132631.1,592200
159830,166102.4,930650,39640,23133.7,338450,120190,142968.7,592200
160590,162972.1,930650,38730,21737.5,338450,121860,141234.6,592200
161410,163899.1,930650,37800,24233.9,338450,123610,139665.2,592200
157370,155606.5,930650,36200,23133.3,338450,121170,132473.2,592200
153290,132102.8,930650,34630,13985,338450,118660,118117.8,592200
149240,151134.4,930650,33020,19112.7,338450,116220,132021.7,592200
145160,135570.5,930650,31420,19988.7,338450,113740,115581.8,592200
139680,112659.9,930650,29670,17126.9,338450,110010,95533,592200
134180,115570,930650,27850,14782.7,338450,106330,100787.3,592200
128600,155218.5,930650,26050,28829.2,338450,102550,126389.3,592200
123120,147752.4,930650,24250,39136.3,338450,98870,108616.1,592200
115890,177122.1,930650,22210,48240.8,338450,93680,128881.3,592200
108730,207454.7,930650,20150,71271.5,338450,88580,136183.2,592200
101570,218597,930650,18130,64204.1,338450,83440,154392.9,592200
94360,167036.2,930650,16060,51727.7,338450,78300,115308.5,592200
90240,166392.7,930650,15570,47127.6,338450,74670,119265.1,592200
86230,158273.1,930650,15090,47961.3,338450,71140,110311.8,592200
82220,133945.3,930650,14610,42191.2,338450,67610,91754.1,592200
78120,72498,930650,14090,29217.7,338450,64030,43280.3,592200
74520,52680.1,930650,14000,24459.2,338450,60520,28220.9,592200
70950,41920.6,930650,13880,18152.7,338450,57070,23767.9,592200
67410,30890.4,930650,13770,13051.4,338450,53640,17839,592200
63760,24129.7,930650,13650,11169.5,338450,50110,12960.2,592200
60120,24213.6,930650,13580,10262.9,338450,46540,13950.7,592200
56510,23375.9,930650,13500,8264,338450,43010,15111.9,592200
52880,21801,930650,13380,7883.1,338450,39500,13917.9,592200
49260,31219,930650,13290,7549.7,338450,35970,23669.3,592200
52390,45121.9,930650,15880,6284.3,338450,36510,38837.6,592200
55630,49998.8,930650,18470,5882.5,338450,37160,44116.3,592200
58780,71786.6,930650,21050,5436.5,338450,37730,66350.1,592200
61980,72635.4,930650,23630,5317.1,338450,38350,67318.3,592200
65980,75581,930650,26200,6135.1,338450,39780,69445.9,592200
70030,79806,930650,28780,7214,338450,41250,72592,592200
74020,85204.8,930650,31320,8338.7,338450,42700,76866.1,592200
77990,87635,930650,33880,9941.1,338450,44110,77693.9,592200
81690,92554.9,930650,35930,12454.5,338450,45760,80100.4,592200
85280,101727.1,930650,37940,13641.7,338450,47340,88085.4,592200
88960,104634.8,930650,40000,14337,338450,48960,90297.8,592200
92570,111874.6,930650,42020,16929.6,338450,50550,94945,592200
96590,117928.2,930650,43970,18709.2,338450,52620,99219,592200
100610,116082.2,930650,45940,18462.9,338450,54670,97619.3,592200
104680,116124.2,930650,47900,18462.1,338450,56780,97662.1,592200
108710,119057.2,930650,49850,19552.3,338450,58860,99504.9,592200
112200,121424.2,930650,51210,20066.8,338450,60990,101357.4,592200
115810,120495.1,930650,52570,19390.5,338450,63240,101104.6,592200
119320,121923.6,930650,53930,19308.3,338450,65390,102615.3,592200
86700,127224.7,930650,25680,17280.7,338450,61020,109944,592200
91530,129932.2,930650,27920,18474.1,338450,63610,111458.1,592200
96510,103278.8,930650,30170,16130.3,338450,66340,87148.5,592200
101340,97717.7,930650,32430,14202.3,338450,68910,83515.4,592200
106330,105900.2,930650,34710,18195.3,338450,71620,87704.9,592200
107990,103625.7,930650,36870,17513.2,338450,71120,86112.5,592200
109650,109817.4,930650,39020,23768.3,338450,70630,86049.1,592200
111370,117214,930650,41180,28435.8,338450,70190,88778.2,592200
113070,113301.3,930650,43350,24879.5,338450,69720,88421.8,592200
114910,99613.2,930650,45530,18074.5,338450,69380,81538.7,592200
116700,129983.9,930650,47730,25692.4,338450,68970,104291.5,592200
118520,140615.3,930650,49910,32813.9,338450,68610,107801.4,592200
120410,144770,930650,52150,35132,338450,68260,109638,592200
121960,150351.3,930650,54270,37060.1,338450,67690,113291.2,592200
123540,145123.3,930650,56380,36378,338450,67160,108745.3,592200
125160,149228.4,930650,58520,43331.7,338450,66640,105896.7,592200
126700,148020.2,930650,60660,46521.8,338450,66040,101498.4,592200
127790,158399.5,930650,62280,57718.2,338450,65510,100681.3,592200
128900,183001.7,930650,63920,77586.3,338450,64980,105415.4,592200
129940,209913.4,930650,65520,97531.8,338450,64420,112381.6,592200
131010,225266.9,930650,67140,110061.5,338450,63870,115205.4,592200
132420,236778.4,930650,68600,118252.3,338450,63820,118526.1,592200
133790,253063.5,930650,70100,131839.8,338450,63690,121223.7,592200
135070,244618.3,930650,71560,126248.4,338450,63510,118369.9,592200
136470,230601.6,930650,73050,117631.9,338450,63420,112969.7,592200
137310,241427.5,930650,74380,125431.1,338450,62930,115996.4,592200
138150,225710.5,930650,75720,114710.1,338450,62430,111000.4,592200
139110,219341.3,930650,77070,110086.3,338450,62040,109255,592200
139990,227168,930650,78420,114787.1,338450,61570,112380.9,592200
144420,222982.7,930650,81330,111899.5,338450,63090,111083.2,592200
148810,219200.9,930650,84260,109015,338450,64550,110185.9,592200
153220,207430.7,930650,87170,100735,338450,66050,106695.7,592200
157700,212853.2,930650,90120,103809.4,338450,67580,109043.8,592200
159430,203660.1,930650,91590,98481,338450,67840,105179.1,592200
161150,204559.1,930650,93040,103688.7,338450,68110,100870.4,592200
162760,205839.2,930650,94510,105520.5,338450,68250,100318.7,592200
164520,203463.1,930650,95990,101774.4,338450,68530,101688.7,592200
165170,186306.5,930650,95930,89178.1,338450,69240,97128.4,592200
165940,176662.6,930650,95860,82608.3,338450,70080,94054.3,592200
166680,180932.1,930650,95810,83205.1,338450,70870,97727,592200
167370,175048.2,930650,95750,76247.8,338450,71620,98800.4,592200
169620,175422.2,930650,95390,76995.9,338450,74230,98426.3,592200
171790,179402.2,930650,95040,78498.6,338450,76750,100903.6,592200
173980,178050,930650,94680,75334.2,338450,79300,102715.8,592200
176180,172900.7,930650,94330,68641.9,338450,81850,104258.8,592200
177840,172775.7,930650,93440,68003.2,338450,84400,104772.5,592200
179490,173116.3,930650,92560,68792.3,338450,86930,104324,592200
181120,181715.3,930650,91660,76089.3,338450,89460,105626,592200
182770,185601.5,930650,90790,75916.4,338450,91980,109685.1,592200
185420,194045.2,930650,90390,79355.7,338450,95030,114689.5,592200
188020,205795.3,930650,89960,82035.4,338450,98060,123759.9,592200
190600,200407.1,930650,89550,78303.2,338450,101050,122103.9,592200
193250,183901.7,930650,89140,76420.7,338450,104110,107481,592200
197880,164968.1,930650,89300,63995.8,338450,108580,100972.3,592200
202500,165148.3,930650,89460,60521.2,338450,113040,104627.1,592200
207240,171925.3,930650,89640,61960.1,338450,117600,109965.2,592200
211870,172661.5,930650,89810,65924.2,338450,122060,106737.3,592200
216010,196349.4,930650,89610,75268.7,338450,126400,121080.7,592200
220180,216042.9,930650,89430,74647.9,338450,130750,141395,592200
224330,223187.9,930650,89250,80176,338450,135080,143011.9,592200
228440,195397.7,930650,89060,75609.6,338450,139380,119788.1,592200
233310,169687.7,930650,89800,62255.7,338450,143510,107432,592200
238190,178104.4,930650,90520,65141.7,338450,147670,112962.7,592200
243110,189483.3,930650,91260,71316.2,338450,151850,118167.1,592200
247940,194228.6,930650,91990,68356.7,338450,155950,125871.9,592200
239490,195325.2,930650,88110,66093,338450,151380,129232.2,592200
230960,195352.2,930650,84210,61022.1,338450,146750,134330.1,592200
222480,200166.9,930650,80290,58723.2,338450,142190,141443.7,592200
213940,187379.5,930650,76410,50665.1,338450,137530,136714.4,592200
204210,179739.5,930650,71780,44671.3,338450,132430,135068.2,592200
194490,176374.7,930650,67160,43199.1,338450,127330,133175.6,592200
184780,174320.7,930650,62520,37566.8,338450,122260,136753.9,592200
175040,173479.3,930650,57900,33217.7,338450,117140,140261.6,592200
166300,170738.3,930650,54020,31327.4,338450,112280,139410.9,592200
157520,172510.2,930650,50120,39401.8,338450,107400,133108.4,592200
148750,178134.4,930650,46200,54336.1,338450,102550,123798.3,592200
140000,188007.9,930650,42330,66229.9,338450,97670,121778,592200
133660,193197,930650,40040,71027.9,338450,93620,122169.1,592200
127290,183286.6,930650,37750,67925.8,338450,89540,115360.8,592200
120910,136382.1,930650,35450,34223.4,338450,85460,102158.7,592200
114480,115917.6,930650,33150,27577.1,338450,81330,88340.5,592200
107970,116641.7,930650,30840,24267.5,338450,77130,92374.2,592200
101530,115041.8,930650,28530,21575,338450,73000,93466.8,592200
95080,117661.6,930650,26220,24413,338450,68860,93248.6,592200
88540,117019.6,930650,23900,25916.7,338450,64640,91102.9,592200
82930,108126.5,930650,22410,20327.2,338450,60520,87799.3,592200
77280,97938.9,930650,20870,14535.4,338450,56410,83403.5,592200
71650,95380.2,930650,19360,10322.7,338450,52290,85057.5,592200
66010,92127.9,930650,17860,8134.7,338450,48150,83993.2,592200
63170,92019.7,930650,17660,11118.1,338450,45510,80901.6,592200
60270,94751.4,930650,17450,13790.5,338450,42820,80960.9,592200
57460,89138.7,930650,17260,9830,338450,40200,79308.7,592200
54560,94974.8,930650,17050,9679.1,338450,37510,85295.7,592200
50980,89574.2,930650,16180,11189.6,338450,34800,78384.6,592200
47480,107247.6,930650,15280,20974.2,338450,32200,86273.4,592200
43950,87557.9,930650,14400,17784.8,338450,29550,69773.1,592200
61030,85457.5,930650,19040,16561.7,338450,41990,68895.8,592200
57870,107926.4,930650,17560,20521.2,338450,40310,87405.2,592200
54660,91700.5,930650,16100,11853,338450,38560,79847.5,592200
51450,92514.6,930650,14620,11953.2,338450,36830,80561.4,592200
48290,99643.9,930650,13130,12997.8,338450,35160,86646.1,592200
46410,112999.6,930650,12340,22464.1,338450,34070,90535.5,592200
44460,117651.6,930650,11510,27091.9,338450,32950,90559.7,592200
42570,119126.1,930650,10700,26626.4,338450,31870,92499.7,592200
40750,115273.5,930650,9870,23564,338450,30880,91709.5,592200
39030,108584.9,930650,9280,18785,338450,29750,89799.9,592200
37330,104328.1,930650,8730,17832.5,338450,28600,86495.6,592200
35690,101847.9,930650,8140,14255.6,338450,27550,87592.3,592200
33890,96077.1,930650,7540,9052.9,338450,26350,87024.2,592200
32080,96772.1,930650,6920,9765.2,338450,25160,87006.9,592200
30180,95465.2,930650,6220,8841.4,338450,23960,86623.8,592200
28320,97133.6,930650,5590,8891.1,338450,22730,88242.5,592200
26400,101090.5,930650,4930,11449.6,338450,21470,89640.9,592200
24630,108328.4,930650,4480,16755.6,338450,20150,91572.8,592200
22790,102303,930650,3990,17032.6,338450,18800,85270.4,592200
21040,100360.3,930650,3550,18938.5,338450,17490,81421.8,592200
19230,100223.5,930650,3080,20962.5,338450,16150,79261,592200
17720,84567.1,930650,2880,13686.4,338450,14840,70880.7,592200
16190,73681.3,930650,2660,7607.1,338450,13530,66074.2,592200
14630,69180,930650,2440,5987.4,338450,12190,63192.6,592200
13170,67856.6,930650,2240,5194.5,338450,10930,62662.1,592200
11560,66727.8,930650,1960,5090.9,338450,9600,61636.9,592200
10090,67128.7,930650,1710,5070.5,338450,8380,62058.2,592200
8540,67522.4,930650,1450,5161.4,338450,7090,62361,592200
7010,66305,930650,1210,4923,338450,5800,61382,592200
6400,65802.7,930650,1100,4801,338450,5300,61001.7,592200
5810,65683.4,930650,1000,4801,338450,4810,60882.4,592200
5170,66083.8,930650,900,4913.5,338450,4270,61170.3,592200
4610,65774.9,930650,810,4901,338450,3800,60873.9,592200
4120,65534.3,930650,720,4901,338450,3400,60633.3,592200
3600,65882.6,930650,640,4926,338450,2960,60956.6,592200
3090,65570.4,930650,530,4901,338450,2560,60669.4,592200
2650,65085.8,930650,460,4901,338450,2190,60184.8,592200
2540,65379.6,930650,630,4926,338450,1910,60453.6,592200
2480,64973.8,930650,820,4901,338450,1660,60072.8,592200
2360,65676.7,930650,1000,5637.5,338450,1360,60039.2,592200
2360,65816.5,930650,1200,5809.5,338450,1160,60007,592200
2140,65793.9,930650,1100,5450.5,338450,1040,60343.4,592200
1910,64957.5,930650,980,5120.5,338450,930,59837,592200
1680,64991.8,930650,880,5137.2,338450,800,59854.6,592200
1520,65165.5,930650,770,5191.8,338450,750,59973.7,592200
2470,64801,930650,1570,5053.2,338450,900,59747.8,592200
3430,64998,930650,2380,5088.5,338450,1050,59909.5,592200
4370,65908.2,930650,3190,5201,338450,1180,60707.2,592200
5350,65474.8,930650,3970,5201,338450,1380,60273.8,592200
5900,65364.9,930650,4300,5201,338450,1600,60163.9,592200
6450,65025.8,930650,4620,5188.5,338450,1830,59837.3,592200
6970,64904.2,930650,4950,5101,338450,2020,59803.2,592200
7580,65552.6,930650,5280,5101,338450,2300,60451.6,592200
7570,65654.9,930650,5290,5115.2,338450,2280,60539.7,592200
7540,65417.9,930650,5290,5138.5,338450,2250,60279.4,592200
7520,65857.1,930650,5300,5258.1,338450,2220,60599,592200
7520,66520.9,930650,5300,5338.5,338450,2220,61182.4,592200
8140,67105.5,930650,5940,5514.8,338450,2200,61590.7,592200
8830,67795.2,930650,6620,5882.6,338450,2210,61912.6,592200
9490,68976.3,930650,7290,6331.9,338450,2200,62644.4,592200
10110,69460.8,930650,7930,6549.7,338450,2180,62911.1,592200
11140,71258.4,930650,8820,6845.8,338450,2320,64412.6,592200
12070,72241.2,930650,9680,6950.3,338450,2390,65290.9,592200
13050,75399.9,930650,10540,8572.5,338450,2510,66827.4,592200
14040,80746.6,930650,11410,12118.7,338450,2630,68627.9,592200
21930,86433.4,930650,16260,15663.9,338450,5670,70769.5,592200
29860,91404.6,930650,21100,18683.6,338450,8760,72721,592200
37830,96866.8,930650,25920,23115.9,338450,11910,73750.9,592200
45730,111992.3,930650,30760,33158.9,338450,14970,78833.4,592200
55060,130217,930650,36570,43806.2,338450,18490,86410.8,592200
64470,149239,930650,42370,54830.8,338450,22100,94408.2,592200
73790,163153.1,930650,48160,62038.5,338450,25630,101114.6,592200
83180,183538.7,930650,53940,70899.8,338450,29240,112638.9,592200
94040,203288,930650,60340,86210.1,338450,33700,117077.9,592200
104950,233631.9,930650,66690,94166.5,338450,38260,139465.4,592200
115860,253645.6,930650,73090,110631.4,338450,42770,143014.2,592200
126760,274000.4,930650,79460,122802.7,338450,47300,151197.7,592200
138150,292005.7,930650,83880,131654.4,338450,54270,160351.3,592200
149490,307653.9,930650,88300,141196.4,338450,61190,166457.5,592200
160830,321831.3,930650,92720,145300.9,338450,68110,176530.4,592200
172180,318282.6,930650,97160,138202.5,338450,75020,180080.1,592200
183390,321676.3,930650,101620,137949.6,338450,81770,183726.7,592200
194580,322798.5,930650,106150,137731.2,338450,88430,185067.3,592200
205770,332609.1,930650,110650,142194.5,338450,95120,190414.6,592200
217040,334811.6,930650,115150,147067.6,338450,101890,187744,592200
228410,311190,930650,119810,141456.7,338450,108600,169733.3,592200
239760,310818.9,930650,124480,142528.2,338450,115280,168290.7,592200
251200,313044.4,930650,129150,145663.1,338450,122050,167381.3,592200
262580,319155.3,930650,133820,151781,338450,128760,167374.3,592200
266490,322836.8,930650,135290,157111.3,338450,131200,165725.5,592200
270460,321770.3,930650,136770,156962.2,338450,133690,164808.1,592200
274440,327516,930650,138260,162152.9,338450,136180,165363.1,592200
278380,323475.2,930650,139760,158829.6,338450,138620,164645.6,592200
281790,330416,930650,140690,166005.6,338450,141100,164410.4,592200
285330,346179.1,930650,141650,174531.7,338450,143680,171647.4,592200
288820,353935.2,930650,142590,175840.9,338450,146230,178094.3,592200
325040,345105,930650,160660,172203.9,338450,164380,172901.1,592200
328740,349489.1,930650,162870,173574.6,338450,165870,175914.5,592200
332540,357644,930650,165080,172880.6,338450,167460,184763.4,592200
336280,363172.8,930650,167280,170733.6,338450,169000,192439.2,592200
340080,330758.2,930650,169500,155695.3,338450,170580,175062.9,592200
341810,320764,930650,170250,149149.3,338450,171560,171614.7,592200
343430,344460.1,930650,171020,163379.4,338450,172410,181080.7,592200
345200,347489.1,930650,171810,163604.9,338450,173390,183884.2,592200
346840,350363.3,930650,172570,162932.7,338450,174270,187430.6,592200
352270,362338.3,930650,176270,173031.6,338450,176000,189306.7,592200
357620,359079.7,930650,179950,171758.9,338450,177670,187320.8,592200
362990,357522.5,930650,183620,167967.3,338450,179370,189555.2,592200
368350,363957.9,930650,187330,168954.8,338450,181020,195003.1,592200
372440,375360.6,930650,189730,178784.3,338450,182710,196576.3,592200
376510,402138,930650,192130,194400.5,338450,184380,207737.5,592200
380560,421170.9,930650,194530,202439.8,338450,186030,218731.1,592200
384650,422496.6,930650,196930,202143.6,338450,187720,220353,592200
388770,441663.8,930650,198700,211530.1,338450,190070,230133.7,592200
392880,457189.1,930650,200480,221192.2,338450,192400,235996.9,592200
396940,467782.5,930650,202250,228336.3,338450,194690,239446.2,592200
401110,470986.5,930650,204020,232480.3,338450,197090,238506.2,592200
406340,459645.8,930650,206700,228779.9,338450,199640,230865.9,592200
411530,457599.9,930650,209380,229156.8,338450,202150,228443.1,592200
416680,463417.7,930650,212020,235030.4,338450,204660,228387.3,592200
421920,469102,930650,214710,238724.3,338450,207210,230377.7,592200
427170,478547.5,930650,216840,241840.7,338450,210330,236706.8,592200
432410,482257.7,930650,219010,242861.6,338450,213400,239396.1,592200
437590,486325.9,930650,221140,241182.7,338450,216450,245143.2,592200
442840,495824.4,930650,223310,245491.9,338450,219530,250332.5,592200
443220,493200,930650,223600,243640.3,338450,219620,249559.7,592200
443580,478928.2,930650,223890,240196.6,338450,219690,238731.6,592200
443950,475206.8,930650,224200,242924.8,338450,219750,232282,592200
444290,469394.8,930650,224500,241014.7,338450,219790,228380.1,592200
443730,457371.5,930650,224700,235756.7,338450,219030,221614.8,592200
443170,447947.7,930650,224900,234900.1,338450,218270,213047.6,592200
442640,447051.4,930650,225100,235215.4,338450,217540,211836,592200
442030,448949.1,930650,225310,235653.7,338450,216720,213295.4,592200
443530,442014.4,930650,226010,235298.7,338450,217520,206715.7,592200
444970,432121.7,930650,226700,232524.5,338450,218270,199597.2,592200
446480,431886.1,930650,227400,229676.5,338450,219080,202209.6,592200
447940,437132.3,930650,228080,228969.8,338450,219860,208162.5,592200
451770,429446.3,930650,228420,226598.4,338450,223350,202847.9,592200
455500,440814,930650,228750,235872.1,338450,226750,204941.9,592200
459300,447401.8,930650,229060,235713.1,338450,230240,211688.7,592200
463060,442249.2,930650,229390,232743.5,338450,233670,209505.7,592200
467660,433376.4,930650,229940,233912.5,338450,237720,199463.9,592200
472200,449847.6,930650,230480,240009.5,338450,241720,209838.1,592200
476790,466602.7,930650,231020,241198.6,338450,245770,225404.1,592200
481390,481742.5,930650,231570,247441.1,338450,249820,234301.4,592200
485570,483254.1,930650,231980,246827.5,338450,253590,236426.6,592200
489930,486599,930650,232450,243679.8,338450,257480,242919.2,592200
494160,507436.6,930650,232860,245697.8,338450,261300,261738.8,592200
498450,518788.9,930650,233310,247696.5,338450,265140,271092.4,592200
504160,518747.2,930650,234280,243998.6,338450,269880,274748.6,592200
509860,531754.5,930650,235260,249257.3,338450,274600,282497.2,592200
515500,533224,930650,236240,248154.1,338450,279260,285069.9,592200
521230,521408.5,930650,237230,248230.4,338450,284000,273178.1,592200
527200,527950.4,930650,238390,246447.3,338450,288810,281503.1,592200
533180,553501.3,930650,239560,254867.6,338450,293620,298633.7,592200
539120,553058.4,930650,240720,254361.9,338450,298400,298696.5,592200
545110,546296.3,930650,241890,249016.1,338450,303220,297280.2,592200
550750,538684,930650,242850,247270.1,338450,307900,291413.9,592200
556320,565556.2,930650,243790,263032.2,338450,312530,302524,592200
561910,589389.4,930650,244720,270262.2,338450,317190,319127.2,592200
567600,614517.7,930650,245710,281225.7,338450,321890,333292,592200
576430,622322.4,930650,247670,279660,338450,328760,342662.4,592200
585270,636439.6,930650,249660,278859.6,338450,335610,357580,592200
594150,649127.6,930650,251630,278404.9,338450,342520,370722.7,592200
603040,637119.9,930650,253610,274830.7,338450,349430,362289.2,592200
611980,645325.7,930650,255530,279215.2,338450,356450,366110.5,592200
620870,658147.1,930650,257440,288280.1,338450,363430,369867,592200
629790,657822,930650,259320,287225,338450,370470,370597,592200
638690,660242.6,930650,261240,274668.2,338450,377450,385574.4,592200
647480,684761.6,930650,263080,285446.3,338450,384400,399315.3,592200
656260,689102.6,930650,264930,288413.2,338450,391330,400689.4,592200
665000,707760.6,930650,266770,298181.8,338450,398230,409578.8,592200
673730,737387.4,930650,268620,312162.9,338450,405110,425224.5,592200
676000,762459.9,930650,269050,313271.3,338450,406950,449188.6,592200
678210,764100,930650,269490,304894.9,338450,408720,459205.1,592200
680440,756906.6,930650,269920,302605.4,338450,410520,454301.2,592200
682740,759973.1,930650,270370,306631,338450,412370,453342.1,592200
684640,782085.7,930650,270830,315401.4,338450,413810,466684.3,592200
686650,761070.3,930650,271290,300946.1,338450,415360,460124.2,592200
688600,727129.8,930650,271750,282372,338450,416850,444757.8,592200
690540,729124.6,930650,272190,281702.2,338450,418350,447422.4,592200
692480,736791.2,930650,272460,292196.3,338450,420020,444594.9,592200
694410,741151.7,930650,272710,296316,338450,421700,444835.7,592200
696300,724979.7,930650,272990,289035.4,338450,423310,435944.3,592200
698210,729190.4,930650,273230,293529.1,338450,424980,435661.3,592200
697210,719248.3,930650,273080,289106.6,338450,424130,430141.7,592200
696310,711998.6,930650,272940,282388.5,338450,423370,429610.1,592200
695350,701043.6,930650,272810,276073.9,338450,422540,424969.7,592200
694420,692877.1,930650,272680,276468.2,338450,421740,416408.9,592200
693060,674179.4,930650,272410,275497.7,338450,420650,398681.7,592200
691750,655390.3,930650,272130,271146.7,338450,419620,384243.6,592200
690360,640834.1,930650,271870,267587.5,338450,418490,373246.6,592200
673290,641586.4,930650,269520,271642.2,338450,403770,369944.2,592200
671050,659361.3,930650,268940,283215,338450,402110,376146.3,592200
668750,663877.4,930650,268410,285335.5,338450,400340,378541.9,592200
666450,690898,930650,267840,292207,338450,398610,398691,592200
664150,707219.8,930650,267290,289031.4,338450,396860,418188.4,592200
663400,695923.3,930650,267000,277069.6,338450,396400,418853.7,592200
662640,682694.9,930650,266730,269443.5,338450,395910,413251.4,592200
661870,692692.4,930650,266450,270617.4,338450,395420,422075,592200
661130,684728.6,930650,266160,271977.7,338450,394970,412750.9,592200
660410,691573.6,930650,265660,279030.4,338450,394750,412543.2,592200
659580,672015.6,930650,265230,273853.6,338450,394350,398162,592200
658870,668055.3,930650,264740,270497,338450,394130,397558.3,592200
658210,658075.3,930650,264290,262321.4,338450,393920,395753.9,592200
657630,650384.1,930650,263940,270063.2,338450,393690,380320.9,592200
657110,651911.7,930650,263610,281081.4,338450,393500,370830.3,592200
656570,676300.8,930650,263280,293202.2,338450,393290,383098.6,592200
656020,681806.8,930650,262940,301923.9,338450,393080,379882.9,592200
656140,689880,930650,262770,300677.8,338450,393370,389202.2,592200
656260,691439.5,930650,262600,300601,338450,393660,390838.5,592200
656380,698572.1,930650,262450,303084.6,338450,393930,395487.5,592200
656440,693680.1,930650,262260,297615,338450,394180,396065.1,592200
656660,669295.6,930650,262140,282489.3,338450,394520,386806.3,592200
656820,663166.9,930650,262010,277007.6,338450,394810,386159.3,592200
656950,656091.7,930650,261850,276831.8,338450,395100,379259.9,592200
657120,656949,930650,261710,274938.2,338450,395410,382010.8,592200
657480,647444.2,930650,261560,276077.3,338450,395920,371366.9,592200
657800,645971.9,930650,261400,273890.1,338450,396400,372081.8,592200
658090,640824.9,930650,261260,272692.7,338450,396830,368132.2,592200
658390,641780.9,930650,261120,273609,338450,397270,368171.9,592200
657130,652252.7,930650,260700,278489.8,338450,396430,373762.9,592200
655780,652225.6,930650,260270,281678.8,338450,395510,370546.8,592200
654560,655739.8,930650,259870,280054.1,338450,394690,375685.7,592200
653220,638761.1,930650,259460,272534.5,338450,393760,366226.6,592200
651490,629214,930650,259010,267799,338450,392480,361415,592200
649830,626737,930650,258580,265280.2,338450,391250,361456.8,592200
648150,595191.9,930650,258170,253058.7,338450,389980,342133.2,592200
646410,576930.3,930650,257720,245509.4,338450,388690,331420.9,592200
644090,573920.3,930650,257280,245946.1,338450,386810,327974.2,592200
641890,566660.6,930650,256860,252677,338450,385030,313983.6,592200
639540,578500.4,930650,256430,260658,338450,383110,317842.4,592200
637360,579970.4,930650,256010,259168.5,338450,381350,320801.9,592200
633480,566218.9,930650,255270,251660.7,338450,378210,314558.2,592200
629550,568967.5,930650,254570,247081.3,338450,374980,321886.2,592200
625630,584132.3,930650,253840,250718.8,338450,371790,333413.5,592200
621800,586136.6,930650,253140,255616.6,338450,368660,330520,592200
617810,580089.6,930650,252420,256978.2,338450,365390,323111.4,592200
613880,583570.9,930650,251700,259334.9,338450,362180,324236,592200
609870,581943.2,930650,250950,261789.7,338450,358920,320153.5,592200
605940,568814.1,930650,250220,256194.2,338450,355720,312619.9,592200
601970,560316.7,930650,249470,253049.2,338450,352500,307267.5,592200
597960,566689.5,930650,248710,255830.3,338450,349250,310859.2,592200
594030,565934.5,930650,247970,252427.2,338450,346060,313507.3,592200
590110,558258.6,930650,247210,252381.1,338450,342900,305877.5,592200
589050,558710.3,930650,247150,252335.6,338450,341900,306374.7,592200
588050,572682,930650,247100,255636.6,338450,340950,317045.4,592200
587020,583542.5,930650,247060,255206.6,338450,339960,328335.9,592200
586000,576686.5,930650,247000,252365.5,338450,339000,324321,592200
584880,585105.8,930650,246880,254511.3,338450,338000,330594.5,592200
583790,579362.5,930650,246800,254263,338450,336990,325099.5,592200
582660,577264.2,930650,246680,256012.3,338450,335980,321251.9,592200
581530,566406.8,930650,246540,251288.8,338450,334990,315118,592200
580500,555970.7,930650,246500,246402.8,338450,334000,309567.9,592200
579450,561859.8,930650,246460,246197.8,338450,332990,315662,592200
578400,563957.4,930650,246430,247073.4,338450,331970,316884,592200
577390,564191.6,930650,246400,245538.3,338450,330990,318653.3,592200
580520,550704.5,930650,247050,245071.3,338450,333470,305633.2,592200
583750,550876,930650,247720,248576.7,338450,336030,302299.3,592200
586970,563669,930650,248400,252295,338450,338570,311374,592200
590230,567209.7,930650,249090,255577.1,338450,341140,311632.6,592200
593800,559470.8,930650,249820,258221.6,338450,343980,301249.2,592200
597400,554117.6,930650,250560,260287.5,338450,346840,293830.1,592200
600950,548255.5,930650,251290,258892,338450,349660,289363.5,592200
604540,558664.8,930650,252020,259882.1,338450,352520,298782.7,592200
607970,547413.3,930650,252680,250388.5,338450,355290,297024.8,592200
611410,537000.4,930650,253360,245775.3,338450,358050,291225.1,592200
614880,531252,930650,254040,241432.6,338450,360840,289819.4,592200
618260,527083.1,930650,254680,241300.9,338450,363580,285782.2,592200
618150,524958.6,930650,254730,244995.3,338450,363420,279963.3,592200
617980,532864.8,930650,254770,248111.7,338450,363210,284753.1,592200
617830,518364.1,930650,254810,242320.5,338450,363020,276043.6,592200
617710,504168.1,930650,254850,229352,338450,362860,274816.1,592200
618020,492909,930650,255050,226599.4,338450,362970,266309.6,592200
618340,496969,930650,255240,232353.6,338450,363100,264615.4,592200
618700,494145.4,930650,255450,232896.6,338450,363250,261248.8,592200
619050,506118.6,930650,255630,235763,338450,363420,270355.6,592200
619250,506247.5,930650,255740,238587.3,338450,363510,267660.2,592200
619480,492839,930650,255840,229566.2,338450,363640,263272.8,592200
619640,497105.8,930650,255930,233413.7,338450,363710,263692.1,592200
619880,497837.3,930650,256030,236076.3,338450,363850,261761,592200
619340,508078.6,930650,255890,244492.6,338450,363450,263586,592200
618830,493237.7,930650,255750,242188.8,338450,363080,251048.9,592200
618260,487755,930650,255600,241413.6,338450,362660,246341.4,592200
617810,490249.1,930650,255490,242219.4,338450,362320,248029.7,592200
617430,504510.1,930650,255570,248510.1,338450,361860,256000,592200
617160,516176,930650,255670,252224.1,338450,361490,263951.9,592200
616790,524059.7,930650,255750,256571,338450,361040,267488.7,592200
633310,536361.4,930650,257660,257644.7,338450,375650,278716.7,592200
632590,546110.6,930650,257680,260595.7,338450,374910,285514.9,592200
631990,558556.3,930650,257710,261230,338450,374280,297326.3,592200
631330,556253.6,930650,257750,258575.5,338450,373580,297678.1,592200
630690,559407.3,930650,257790,258773.7,338450,372900,300633.6,592200
631000,552539.9,930650,257740,254597.5,338450,373260,297942.4,592200
631360,553590.9,930650,257700,255924.6,338450,373660,297666.3,592200
631660,560650.8,930650,257650,260693.4,338450,374010,299957.4,592200
631970,557605.8,930650,257610,259714.7,338450,374360,297891.1,592200
631820,562685.5,930650,257470,264535.8,338450,374350,298149.7,592200
631710,559065.3,930650,257340,263337.4,338450,374370,295727.9,592200
631620,555383.7,930650,257200,260819,338450,374420,294564.7,592200
631500,558240.6,930650,257060,261719.7,338450,374440,296520.9,592200
631270,562958.1,930650,256920,261299.3,338450,374350,301658.8,592200
631000,547625.7,930650,256800,258385.1,338450,374200,289240.6,592200
630680,543163.4,930650,256660,258452,338450,374020,284711.4,592200
630360,540160.2,930650,256510,257455.9,338450,373850,282704.3,592200
630130,545116.8,930650,256530,261898.6,338450,373600,283218.2,592200
629820,544126.8,930650,256550,262718.4,338450,373270,281408.4,592200
629540,548224.7,930650,256540,263899,338450,373000,284325.7,592200
629220,558500.3,930650,256560,269484,338450,372660,289016.3,592200
629370,563490.3,930650,256630,272777.6,338450,372740,290712.7,592200
629520,569630.8,930650,256710,274077.8,338450,372810,295553,592200
629670,568365.8,930650,256800,270822.6,338450,372870,297543.2,592200
629790,561665.5,930650,256890,270636.5,338450,372900,291029,592200
629990,545982,930650,256940,268948.6,338450,373050,277033.4,592200
630170,550089.7,930650,256980,267979.3,338450,373190,282110.4,592200
630300,542761.8,930650,257000,262918.2,338450,373300,279843.6,592200
630550,532779.4,930650,257060,253697.2,338450,373490,279082.2,592200
629870,526939.5,930650,257040,250074.1,338450,372830,276865.4,592200
629140,535603.7,930650,256990,257145.5,338450,372150,278458.2,592200
628480,551288.1,930650,256960,265953.8,338450,371520,285334.3,592200
627750,564085.1,930650,256910,265650.8,338450,370840,298434.3,592200
627030,574322.6,930650,256900,269675.1,338450,370130,304647.5,592200
626350,573514.8,930650,256890,269160.6,338450,369460,304354.2,592200
625580,576447.5,930650,256890,272516.3,338450,368690,303931.2,592200
624910,564663.1,930650,256880,272179.9,338450,368030,292483.2,592200
624200,542109.1,930650,256730,268630.1,338450,367470,273479,592200
623460,540370.2,930650,256570,266512.9,338450,366890,273857.3,592200
622730,539334.8,930650,256400,269148.1,338450,366330,270186.7,592200
622040,537030.6,930650,256260,269088.7,338450,365780,267941.9,592200
623290,526839.6,930650,256550,262318.1,338450,366740,264521.5,592200
624490,531428.4,930650,256850,260538.8,338450,367640,270889.6,592200
625650,541100.5,930650,257140,262593.8,338450,368510,278506.7,592200
626870,535287.2,930650,257460,260334.2,338450,369410,274953,592200
627910,534417.1,930650,257590,256871,338450,370320,277546.1,592200
628900,530486.8,930650,257750,258265.1,338450,371150,272221.7,592200
629910,522681.8,930650,257890,259685.6,338450,372020,262996.2,592200
630900,527799.5,930650,258030,261165.4,338450,372870,266634.1,592200
632310,519911.9,930650,258430,258065.7,338450,373880,261846.2,592200
633760,508301.1,930650,258820,253358,338450,374940,254943.1,592200
635100,506348,930650,259200,251822.3,338450,375900,254525.7,592200
636560,524508.2,930650,259590,259659.7,338450,376970,264848.5,592200
637200,529698.5,930650,259780,259561.6,338450,377420,270136.9,592200
637910,534801.3,930650,259980,258339.2,338450,377930,276462.1,592200
638550,523042.5,930650,260200,249449.9,338450,378350,273592.6,592200
639200,532737.4,930650,260390,253372.5,338450,378810,279364.9,592200
641100,550404.3,930650,260770,263506,338450,380330,286898.3,592200
642920,559708.2,930650,261170,266228.7,338450,381750,293479.5,592200
644770,559276.9,930650,261550,268795.5,338450,383220,290481.4,592200
646620,535385.1,930650,261950,258521.7,338450,384670,276863.4,592200
647660,533070.7,930650,262190,256880.5,338450,385470,276190.2,592200
648680,536498.7,930650,262460,261353,338450,386220,275145.7,592200
649750,530283.5,930650,262710,255887.2,338450,387040,274396.3,592200
650790,542620,930650,262970,263576.3,338450,387820,279043.7,592200
651390,529665.2,930650,263040,255147.8,338450,388350,274517.4,592200
652000,535608.3,930650,263150,257786.1,338450,388850,277822.2,592200
652610,547978.1,930650,263280,257349.7,338450,389330,290628.4,592200
653250,555405.8,930650,263370,256081.4,338450,389880,299324.4,592200
653160,534051.8,930650,263230,250684.2,338450,389930,283367.6,592200
653180,526911.5,930650,263090,256850.4,338450,390090,270061.1,592200
653160,528994.7,930650,262960,261932.3,338450,390200,267062.4,592200
653150,537145.7,930650,262840,263296.8,338450,390310,273848.9,592200
653530,544538,930650,262880,271184,338450,390650,273354,592200
653910,537014.1,930650,262920,268833.4,338450,390990,268180.7,592200
654420,530244.4,930650,262980,264074.2,338450,391440,266170.2,592200
654740,537430,930650,263020,266255.9,338450,391720,271174.1,592200
656330,530742.6,930650,263340,260865.2,338450,392990,269877.4,592200
657990,514121.5,930650,263660,250746.4,338450,394330,263375.1,592200
659550,507648.2,930650,263960,244916.7,338450,395590,262731.5,592200
661160,515393.4,930650,264300,245865.8,338450,396860,269527.6,592200
662570,509496,930650,264550,242904.5,338450,398020,266591.5,592200
663930,519692.5,930650,264830,242093.6,338450,399100,277598.9,592200
665270,521661.4,930650,265100,243042.4,338450,400170,278619,592200
666670,532159,930650,265370,246021.5,338450,401300,286137.5,592200
667680,546164.4,930650,265740,249348.6,338450,401940,296815.8,592200
668630,561495.3,930650,266120,257870.9,338450,402510,303624.4,592200
669660,566945.1,930650,266480,263435.9,338450,403180,303509.2,592200
670650,569117.8,930650,266840,266973.3,338450,403810,302144.5,592200
666980,580840.6,930650,266190,270687.4,338450,400790,310153.2,592200
663300,589058.9,930650,265530,271442.1,338450,397770,317616.8,592200
659630,575974.5,930650,264850,267956.4,338450,394780,308018.1,592200
655880,579463.8,930650,264210,271010.2,338450,391670,308453.6,592200
652090,582826.8,930650,263590,275011.7,338450,388500,307815.1,592200
648160,592875.5,930650,262970,280336.2,338450,385190,312539.3,592200
644290,576688.1,930650,262370,277913.9,338450,381920,298774.2,592200
608300,569000.1,930650,255850,276650,338450,352450,292350.1,592200
605220,567437.6,930650,255360,278941.9,338450,349860,288495.7,592200
602080,569302.7,930650,254880,280579.9,338450,347200,288722.8,592200
599000,554459.7,930650,254410,277063.4,338450,344590,277396.3,592200
595950,550040.3,930650,253930,271089.7,338450,342020,278950.6,592200
593930,546738.5,930650,253480,270953.7,338450,340450,275784.8,592200
591890,550501.3,930650,253060,272638.1,338450,338830,277863.2,592200
589900,533962.8,930650,252670,268477.2,338450,337230,265485.6,592200
587860,521459.5,930650,252230,265726.3,338450,335630,255733.2,592200
585930,530736.9,930650,251940,263622.4,338450,333990,267114.5,592200
583970,528083.5,930650,251610,263837.3,338450,332360,264246.2,592200
582080,517507.1,930650,251320,259504.7,338450,330760,258002.4,592200
580110,501817.1,930650,251020,252816.3,338450,329090,249000.8,592200
577970,492247.8,930650,250680,249257.9,338450,327290,242989.9,592200
575930,487978.2,930650,250350,249148.8,338450,325580,238829.4,592200
573820,486067.2,930650,250020,248786.8,338450,323800,237280.4,592200
571730,492654.4,930650,249680,250436.9,338450,322050,242217.5,592200
569260,491684.7,930650,249200,247970.7,338450,320060,243714,592200
566780,492623.8,930650,248740,247276.2,338450,318040,245347.6,592200
564310,499851.7,930650,248260,249478.5,338450,316050,250373.2,592200
561740,493691,930650,247780,250499.7,338450,313960,243191.3,592200
559070,490939.2,930650,247210,251496.5,338450,311860,239442.7,592200
556400,488883.2,930650,246650,249277.9,338450,309750,239605.3,592200
553750,479532.2,930650,246080,247776.1,338450,307670,231756.1,592200
551010,467911.5,930650,245520,247597.1,338450,305490,220314.4,592200
548540,460479.2,930650,245120,242568.7,338450,303420,217910.5,592200
546120,463136.9,930650,244690,242271.6,338450,301430,220865.3,592200
543650,468405.9,930650,244280,240826,338450,299370,227579.9,592200
541210,458623.2,930650,243880,237732.8,338450,297330,220890.4,592200
541620,456564.6,930650,243920,235466.5,338450,297700,221098.1,592200
542100,462422.8,930650,243950,237158.3,338450,298150,225264.5,592200
542510,465998.1,930650,243980,239557.2,338450,298530,226440.9,592200
542930,461042.5,930650,244020,238095.3,338450,298910,222947.2,592200
543310,468312.5,930650,244030,242462,338450,299280,225850.5,592200
543700,478579.5,930650,244060,248321.7,338450,299640,230257.8,592200
544060,488367.9,930650,244060,252174,338450,300000,236193.9,592200
544320,485138,930650,244040,252865.3,338450,300280,232272.7,592200
544670,477535.6,930650,243980,247593.3,338450,300690,229942.3,592200
544980,482704.7,930650,243920,251783,338450,301060,230921.7,592200
545320,479525.7,930650,243850,250389.5,338450,301470,229136.2,592200
545620,479589.4,930650,243770,247886,338450,301850,231703.4,592200
546150,472175.6,930650,243680,249808.1,338450,302470,222367.5,592200
546630,468313.5,930650,243570,246383.9,338450,303060,221929.6,592200
547240,468694.1,930650,243490,244174.4,338450,303750,224519.7,592200
547800,486262.6,930650,243410,246701.4,338450,304390,239561.2,592200
547900,500887.3,930650,243250,248344.3,338450,304650,252543,592200
547980,502393.2,930650,243090,245519.2,338450,304890,256874,592200
548050,510691,930650,242900,251746.7,338450,305150,258944.3,592200
548230,521905.8,930650,242750,257488.2,338450,305480,264417.6,592200
548590,496671.7,930650,242700,252126.2,338450,305890,244545.5,592200
549020,490798.7,930650,242650,245508.6,338450,306370,245290.1,592200
549440,539840.9,930650,242620,252605.5,338450,306820,287235.4,592200
549820,543482.3,930650,242540,255655.1,338450,307280,287827.2,592200
551300,537394.8,930650,242750,254786,338450,308550,282608.8,592200
552830,542150.4,930650,242990,257179.8,338450,309840,284970.6,592200
554340,536075.5,930650,243200,256566.4,338450,311140,279509.1,592200
555860,522859.1,930650,243420,250220.5,338450,312440,272638.6,592200
557200,524784.1,930650,243590,256126.3,338450,313610,268657.8,592200
558530,514524.7,930650,243750,249821.2,338450,314780,264703.5,592200
559880,493884.3,930650,243910,234098,338450,315970,259786.3,592200
561210,484026.9,930650,244090,227945.8,338450,317120,256081.1,592200
562120,468623.3,930650,244190,222351.2,338450,317930,246272.1,592200
563050,464924.6,930650,244300,222937.8,338450,318750,241986.8,592200
564020,469029.3,930650,244400,221139.8,338450,319620,247889.5,592200
565010,464069.5,930650,244520,220679.8,338450,320490,243389.7,592200
563220,444567.6,930650,244530,213189.6,338450,318690,231378,592200
561530,413194.7,930650,244540,191519.4,338450,316990,221675.3,592200
559750,416358.8,930650,244560,198462.7,338450,315190,217896.1,592200
558030,435406.3,930650,244580,214494,338450,313450,220912.3,592200
555460,442435.9,930650,244400,219067.1,338450,311060,223368.8,592200
552990,433227.1,930650,244250,216423.3,338450,308740,216803.8,592200
550470,433799.6,930650,244090,214501.7,338450,306380,219297.9,592200
547960,430916.2,930650,243920,218787.9,338450,304040,212128.3,592200
545620,431299.8,930650,243830,217860.9,338450,301790,213438.9,592200
543320,426602.6,930650,243780,214648.2,338450,299540,211954.4,592200
540960,431760.9,930650,243700,218589.5,338450,297260,213171.4,592200
538630,432329.5,930650,243630,219344.7,338450,295000,212984.8,592200
541180,443662.3,930650,244250,229548,338450,296930,214114.3,592200
543790,441729.7,930650,244890,228231.5,338450,298900,213498.2,592200
546430,463799.6,930650,245540,238337,338450,300890,225462.6,592200
549010,471936,930650,246160,239271.7,338450,302850,232664.3,592200
551490,482184.9,930650,246690,243178.7,338450,304800,239006.2,592200
554010,491326.7,930650,247230,250494,338450,306780,240832.7,592200
556520,490398,930650,247750,245239.7,338450,308770,245158.3,592200
558990,492848.1,930650,248290,243123.2,338450,310700,249724.9,592200
561260,492836.1,930650,248820,245527.2,338450,312440,247308.9,592200
563570,498266.1,930650,249370,248323.5,338450,314200,249942.6,592200
565800,484970.1,930650,249890,246335.7,338450,315910,238634.4,592200
568120,486833.4,930650,250450,246794.8,338450,317670,240038.6,592200
565200,481423.3,930650,249790,244398.4,338450,315410,237024.9,592200
562300,480751.7,930650,249110,244175.3,338450,313190,236576.4,592200
559360,468537.2,930650,248440,238912.7,338450,310920,229624.5,592200
556420,461016.7,930650,247770,235959.9,338450,308650,225056.8,592200
553600,461735.7,930650,247070,237491.7,338450,306530,224244,592200
550650,454251.4,930650,246360,234531.1,338450,304290,219720.3,592200
547790,446848.1,930650,245620,231617.5,338450,302170,215230.6,592200
494490,445185.1,930650,234450,231550.8,338450,260040,213634.3,592200
492150,437920.6,930650,233630,228676,338450,258520,209244.6,592200
489810,431240.8,930650,232790,229015.1,338450,257020,202225.7,592200
487500,434929.1,930650,231970,230809.1,338450,255530,204120,592200
485220,430501.4,930650,231150,228260.7,338450,254070,202240.7,592200
483620,431293.1,930650,230650,227976.6,338450,252970,203316.5,592200
482030,433171.4,930650,230130,228529.8,338450,251900,204641.6,592200
480420,438955.4,930650,229650,233062.5,338450,250770,205892.9,592200
478820,437310.4,930650,229140,233940.4,338450,249680,203370,592200
476950,428740.6,930650,228560,233020.3,338450,248390,195720.3,592200
475080,431447.6,930650,228000,234312.3,338450,247080,197135.3,592200
473320,426305.3,930650,227450,231039.8,338450,245870,195265.5,592200
471470,420492.2,930650,226900,228016.1,338450,244570,192476.1,592200
468920,422141.1,930650,226150,227621.9,338450,242770,194519.2,592200
466490,420680.3,930650,225450,227561.7,338450,241040,193118.6,592200
464070,420718.3,930650,224700,229330.4,338450,239370,191387.9,592200
461630,425131.7,930650,223980,230110.1,338450,237650,195021.6,592200
461570,423876.5,930650,224040,228164.1,338450,237530,195712.4,592200
461510,427845.3,930650,224090,226450.6,338450,237420,201394.7,592200
461500,427057.2,930650,224150,222980.7,338450,237350,204076.5,592200
461370,430060.2,930650,224180,222270.5,338450,237190,207789.7,592200
460320,428697,930650,223560,224718.5,338450,236760,203978.5,592200
459290,423102.4,930650,222910,222847.1,338450,236380,200255.3,592200
458230,416755.4,930650,222280,223057,338450,235950,193698.4,592200
457200,421317.2,930650,221630,225736.6,338450,235570,195580.6,592200
457340,422833.8,930650,221900,224445,338450,235440,198388.8,592200
457490,424189.4,930650,222180,226547.3,338450,235310,197642.1,592200
457600,421430.5,930650,222440,224830.2,338450,235160,196600.3,592200
457730,425966.7,930650,222730,230261.9,338450,235000,195704.8,592200
456770,422742.5,930650,222000,230006.8,338450,234770,192735.7,592200
455790,415764.5,930650,221260,222657.2,338450,234530,193107.3,592200
454890,404947,930650,220530,215927.8,338450,234360,189019.2,592200
453910,399342.5,930650,219770,214509.6,338450,234140,184832.9,592200
451840,391815.7,930650,218450,217420.6,338450,233390,174395.1,592200
449770,382094.6,930650,217100,217573.2,338450,232670,164521.4,592200
447730,379352.9,930650,215760,214783.2,338450,231970,164569.7,592200
445630,368837.2,930650,214400,212082.4,338450,231230,156754.8,592200
442980,360138.9,930650,212980,207606.5,338450,230000,152532.4,592200
440330,347554.2,930650,211550,200861.8,338450,228780,146692.4,592200
437650,331125.8,930650,210110,191101.3,338450,227540,140024.5,592200
435030,331404.3,930650,208680,186816.3,338450,226350,144588,592200
431200,331229.6,930650,207210,184984.8,338450,223990,146244.8,592200
427380,329147.8,930650,205740,185711.7,338450,221640,143436.1,592200
423560,336509.7,930650,204250,184117.9,338450,219310,152391.8,592200
419740,333036.3,930650,202790,183854.1,338450,216950,149182.2,592200
416060,333603.3,930650,201300,182847.5,338450,214760,150755.8,592200
412360,340836.8,930650,199800,180640,338450,212560,160196.8,592200
408730,348214.8,930650,198320,175792.7,338450,210410,172422.1,592200
405030,355432.6,930650,196830,174050.9,338450,208200,181381.7,592200
401720,329587.5,930650,195400,168789.7,338450,206320,160797.8,592200
398450,331501,930650,193970,170328.1,338450,204480,161172.9,592200
395200,314836.2,930650,192560,164178.6,338450,202640,150657.6,592200
391970,314111.8,930650,191130,163657,338450,200840,150454.8,592200
391610,310564.5,930650,190660,159826,338450,200950,150738.5,592200
391260,282779.8,930650,190220,144476.6,338450,201040,138303.2,592200
390940,269125.9,930650,189750,138632.7,338450,201190,130493.2,592200
390640,267702.1,930650,189290,135151.4,338450,201350,132550.7,592200
390360,262880.9,930650,188720,138099.4,338450,201640,124781.5,592200
390060,288628.2,930650,188120,157634.4,338450,201940,130993.8,592200
389860,281324.1,930650,187540,149002.4,338450,202320,132321.7,592200
389590,289843.6,930650,186960,158612.2,338450,202630,131231.4,592200
389090,303932.4,930650,186440,167232.4,338450,202650,136700,592200
388640,297537,930650,185940,166677.3,338450,202700,130859.7,592200
388200,301821.8,930650,185430,166680.5,338450,202770,135141.3,592200
387720,315611.3,930650,184940,171024.2,338450,202780,144587.1,592200
385350,298253.9,930650,184870,162842.7,338450,200480,135411.2,592200
383040,302924.1,930650,184810,165133.1,338450,198230,137791,592200
380690,290134.9,930650,184730,160314.9,338450,195960,129820,592200
378310,270559.3,930650,184670,148385,338450,193640,122174.3,592200
374520,258036.6,930650,184360,145237.8,338450,190160,112798.8,592200
370680,230396.8,930650,184070,129987.3,338450,186610,100409.5,592200
366940,197098.9,930650,183790,116522.5,338450,183150,80576.4,592200
363140,184518.7,930650,183490,112175.1,338450,179650,72343.6,592200
359790,155528.6,930650,183190,94651.9,338450,176600,60876.7,592200
356560,135157.8,930650,182920,84746.6,338450,173640,50411.2,592200
353270,132615.8,930650,182630,84584.8,338450,170640,48031,592200
350030,135949.3,930650,182350,84487.8,338450,167680,51461.5,592200
351290,155299.2,930650,182690,95656.4,338450,168600,59642.8,592200
352600,165962.7,930650,183000,100439,338450,169600,65523.7,592200
353940,185224,930650,183370,110441.1,338450,170570,74782.9,592200
355240,204389.4,930650,183700,118802,338450,171540,85587.4,592200
356350,240254.6,930650,183940,139238.7,338450,172410,101015.9,592200
357470,256879.2,930650,184200,149172.8,338450,173270,107706.4,592200
358530,263331.8,930650,184450,157815.1,338450,174080,105516.7,592200
359670,265185.5,930650,184720,160115.7,338450,174950,105069.8,592200
361300,289177.2,930650,185090,167403.3,338450,176210,121773.9,592200
362850,276615.2,930650,185450,167173.5,338450,177400,109441.7,592200
364510,285428,930650,185840,173879.5,338450,178670,111548.5,592200
366170,284845,930650,186240,172970.2,338450,179930,111874.8,592200
364630,293618.5,930650,186060,175547.8,338450,178570,118070.7,592200
363120,297281,930650,185910,176620.4,338450,177210,120660.6,592200
361620,291199.6,930650,185760,172977.7,338450,175860,118221.9,592200
360190,291887.8,930650,185590,172384,338450,174600,119503.8,592200
357970,296645,930650,185240,177389.9,338450,172730,119255.1,592200
355900,288082.8,930650,184910,171844.1,338450,170990,116238.7,592200
353740,274956.6,930650,184570,162816.9,338450,169170,112139.7,592200
334090,256619,930650,176910,151890.8,338450,157180,104728.2,592200
331920,248008.6,930650,176110,146325.4,338450,155810,101683.2,592200
329820,248245,930650,175330,145858.9,338450,154490,102386.1,592200
327740,229673.1,930650,174550,130697.2,338450,153190,98975.9,592200
325600,221160.7,930650,173770,121906.9,338450,151830,99253.8,592200
322950,217259.9,930650,172240,117340.6,338450,150710,99919.3,592200
320210,209654.5,930650,170760,111061.1,338450,149450,98593.4,592200
317520,201771.1,930650,169210,104308.3,338450,148310,97462.8,592200
314850,206323.7,930650,167730,104724.3,338450,147120,101599.4,592200
313010,196693.7,930650,166840,97948.1,338450,146170,98745.6,592200
311220,199133.3,930650,165980,97011,338450,145240,102122.3,592200
309350,200914,930650,165090,98771.7,338450,144260,102142.3,592200
307570,203516.6,930650,164230,102523.3,338450,143340,100993.3,592200
304750,213485.7,930650,162680,110627.4,338450,142070,102858.3,592200
301890,211894.8,930650,161130,109564.1,338450,140760,102330.7,592200
299100,220530.3,930650,159610,112302.7,338450,139490,108227.6,592200
296270,221970.8,930650,158040,112935.7,338450,138230,109035.1,592200
294480,208205.1,930650,157260,110763.3,338450,137220,97441.8,592200
292720,206471.5,930650,156470,111323.1,338450,136250,95148.4,592200
290990,205641.6,930650,155680,109529.7,338450,135310,96111.9,592200
289080,211500.9,930650,154850,111202.5,338450,134230,100298.4,592200
287810,210570.5,930650,154630,112830.9,338450,133180,97739.6,592200
286430,205851,930650,154350,113340.1,338450,132080,92510.9,592200
285100,198775.5,930650,154090,112232.7,338450,131010,86542.8,592200
283660,200254.6,930650,153820,112331.4,338450,129840,87923.2,592200
282860,211739.7,930650,153940,118763,338450,128920,92976.7,592200
282000,213722.5,930650,154040,119947.8,338450,127960,93774.7,592200
281200,210985.8,930650,154160,116611,338450,127040,94374.8,592200
280380,204038.1,930650,154260,111798.8,338450,126120,92239.3,592200
276470,194081.4,930650,152980,111855.1,338450,123490,82226.3,592200
272670,190603.2,930650,151700,112557.1,338450,120970,78046.1,592200
268820,198648.6,930650,150420,116156.9,338450,118400,82491.7,592200
265020,191004.1,930650,149140,115251.4,338450,115880,75752.7,592200
261890,195900,930650,147820,114395,338450,114070,81505,592200
258760,195988.5,930650,146510,112587.6,338450,112250,83400.9,592200
255670,199725.6,930650,145190,106348.8,338450,110480,93376.8,592200
252550,185981,930650,143870,100982.6,338450,108680,84998.4,592200
247660,203071.2,930650,142160,107777.7,338450,105500,95293.5,592200
242770,208493.5,930650,140400,107146.1,338450,102370,101347.4,592200
237940,200434.5,930650,138690,103740.7,338450,99250,96693.8,592200
233060,198264.5,930650,136940,98199.4,338450,96120,100065.1,592200
230180,210587.4,930650,134540,103101.5,338450,95640,107485.9,592200
227330,208999.6,930650,132150,103497.5,338450,95180,105502.1,592200
224520,211010.2,930650,129760,104544,338450,94760,106466.2,592200
221670,216570.7,930650,127380,108284.3,338450,94290,108286.4,592200
219020,241105.9,930650,124860,119348,338450,94160,121757.9,592200
216250,253334.3,930650,122360,132089.9,338450,93890,121244.4,592200
213610,279051.8,930650,119860,143465.5,338450,93750,135586.3,592200
210800,286052.3,930650,117320,145880.7,338450,93480,140171.6,592200
208370,272665.9,930650,114900,139028.3,338450,93470,133637.6,592200
205810,253644,930650,112470,131764.4,338450,93340,121879.6,592200
203270,227820.3,930650,110010,120543,338450,93260,107277.3,592200
200820,225505.9,930650,107590,119587.1,338450,93230,105918.8,592200
198340,229947,930650,105800,121501.8,338450,92540,108445.2,592200
196010,211633.9,930650,104040,112293.2,338450,91970,99340.7,592200
193580,196752.5,930650,102230,104771.3,338450,91350,91981.2,592200
191180,182913.6,930650,100450,95405.4,338450,90730,87508.2,592200
188700,173682,930650,98490,87702.2,338450,90210,85979.8,592200
186320,167965.6,930650,96530,85379.6,338450,89790,82586,592200
183870,139434.2,930650,94560,73358.6,338450,89310,66075.6,592200
181400,124365.5,930650,92610,67494,338450,88790,56871.5,592200
179160,136189.4,930650,90650,61060.7,338450,88510,75128.7,592200
176930,129588.2,930650,88670,57131.3,338450,88260,72456.9,592200
174650,115196.2,930650,86740,50939.8,338450,87910,64256.4,592200
172410,116431.4,930650,84750,48324.7,338450,87660,68106.7,592200
171910,118352,930650,85000,47043.2,338450,86910,71308.8,592200
171370,107620.8,930650,85240,46132.6,338450,86130,61488.2,592200
170840,117519.3,930650,85460,46812.4,338450,85380,70706.9,592200
170300,112069.9,930650,85720,44679.4,338450,84580,67390.5,592200
169630,108020.4,930650,86070,44402.7,338450,83560,63617.7,592200
168900,102592.7,930650,86400,46886.4,338450,82500,55706.3,592200
168260,105020,930650,86770,45889.5,338450,81490,59130.5,592200
167580,115820.8,930650,87100,53430.3,338450,80480,62390.5,592200
167020,106630.3,930650,87770,51484.1,338450,79250,55146.2,592200
166470,102090.2,930650,88410,51178.9,338450,78060,50911.3,592200
165970,99846.5,930650,89110,51439.5,338450,76860,48407,592200
165360,94469,930650,89730,48881.2,338450,75630,45587.8,592200
166060,80452.2,930650,90160,43027.3,338450,75900,37424.9,592200
166740,82667.4,930650,90580,40141.2,338450,76160,42526.2,592200
167520,83309.6,930650,91010,42080.5,338450,76510,41229.1,592200
168240,83904.7,930650,91440,45067.5,338450,76800,38837.2,592200
168070,81357.5,930650,90900,40597.8,338450,77170,40759.7,592200
167950,77414.3,930650,90340,37173.2,338450,77610,40241.1,592200
167780,71086.1,930650,89800,31232.8,338450,77980,39853.3,592200
167720,57779.6,930650,89280,25313.9,338450,78440,32465.7,592200
166920,60880.7,930650,88220,23383.6,338450,78700,37497.1,592200
166160,70338.8,930650,87180,28288.1,338450,78980,42050.7,592200
165350,81515.6,930650,86120,35549.3,338450,79230,45966.3,592200
164630,86493.1,930650,85090,38322.3,338450,79540,48170.8,592200
164930,96655.1,930650,86220,48608.6,338450,78710,48046.5,592200
165320,111247.6,930650,87390,57634.2,338450,77930,53613.4,592200
165750,121172.7,930650,88530,66179.1,338450,77220,54993.6,592200
165980,131807.8,930650,89650,74133.6,338450,76330,57674.2,592200
166030,122538.5,930650,90430,69746.4,338450,75600,52792.1,592200
166060,120316.4,930650,91230,68347.7,338450,74830,51968.7,592200
166110,121465.2,930650,92030,66009.2,338450,74080,55456,592200
154140,119009.4,930650,87490,63343.5,338450,66650,55665.9,592200
154090,133526.1,930650,88050,73447.6,338450,66040,60078.5,592200
154030,139941.6,930650,88660,77459.1,338450,65370,62482.5,592200
153970,139575.2,930650,89230,76467.1,338450,64740,63108.1,592200
153920,143709.6,930650,89850,79418.1,338450,64070,64291.5,592200
154890,146435.5,930650,90960,82209.9,338450,63930,64225.6,592200
155820,146887.1,930650,92070,81597.8,338450,63750,65289.3,592200
156760,146007.1,930650,93170,79917.7,338450,63590,66089.4,592200
157700,148636.2,930650,94290,80029.6,338450,63410,68606.6,592200
158900,148727.7,930650,95420,80243.8,338450,63480,68483.9,592200
160000,140375.5,930650,96520,73659.7,338450,63480,66715.8,592200
161150,128500.8,930650,97650,62724.4,338450,63500,65776.4,592200
162270,125558.1,930650,98760,62074.1,338450,63510,63484,592200
164480,128942.8,930650,100740,64475.1,338450,63740,64467.7,592200
166710,131320.7,930650,102690,64493.4,338450,64020,66827.3,592200
168960,122098.6,930650,104690,57573.5,338450,64270,64525.1,592200
171190,127061.4,930650,106650,60770.3,338450,64540,66291.1,592200
171110,132950.5,930650,106910,64549.1,338450,64200,68401.4,592200
171050,143892.8,930650,107220,71883.4,338450,63830,72009.4,592200
171000,154987.4,930650,107500,79197.1,338450,63500,75790.3,592200
170940,156553.4,930650,107780,79880.4,338450,63160,76673,592200
170260,162489,930650,107990,82581,338450,62270,79908,592200
169580,161734,930650,108200,83976.5,338450,61380,77757.5,592200
168910,159502.1,930650,108430,87347.8,338450,60480,72154.3,592200
168250,181504.9,930650,108620,103373.9,338450,59630,78131,592200
167260,184847.9,930650,108650,108232.7,338450,58610,76615.2,592200
166240,171775.3,930650,108670,103030.7,338450,57570,68744.6,592200
165210,185049.1,930650,108650,107538.2,338450,56560,77510.9,592200
164270,202728.7,930650,108680,120946.8,338450,55590,81781.9,592200
160820,200740.4,930650,107370,122182,338450,53450,78558.4,592200
157260,197466.7,930650,106050,122217.9,338450,51210,75248.8,592200
153760,197332.8,930650,104750,122331.6,338450,49010,75001.2,592200
150310,211058.7,930650,103440,132395,338450,46870,78663.7,592200
145840,215890.4,930650,101780,137229.5,338450,44060,78660.9,592200
141440,203872.5,930650,100120,130637.6,338450,41320,73234.9,592200
137030,211391.5,930650,98460,136124.3,338450,38570,75267.2,592200
132590,220044.2,930650,96800,141835.8,338450,35790,78208.4,592200
129790,233187,930650,95720,151211.8,338450,34070,81975.2,592200
127040,248055.3,930650,94660,161812.1,338450,32380,86243.2,592200
124240,240926.8,930650,93580,157108.6,338450,30660,83818.2,592200
121420,221063.8,930650,92510,144533.8,338450,28910,76530,592200
119430,202795.2,930650,91280,132015,338450,28150,70780.2,592200
117320,189212.2,930650,90030,122413.9,338450,27290,66798.3,592200
115330,175743.6,930650,88810,112717,338450,26520,63026.6,592200
113310,167103.3,930650,87570,106648,338450,25740,60455.3,592200
110920,172527.8,930650,86020,109640.3,338450,24900,62887.5,592200
108580,193061.7,930650,84450,123192,338450,24130,69869.7,592200
106210,201315.3,930650,82880,126822.2,338450,23330,74493.1,592200
103820,188362.4,930650,81340,118251.4,338450,22480,70111,592200
100980,168458.6,930650,79390,105583,338450,21590,62875.6,592200
98170,171628.6,930650,77450,107536.1,338450,20720,64092.5,592200
95310,182628.5,930650,75510,114156.1,338450,19800,68472.4,592200
92450,186225.5,930650,73580,115707.2,338450,18870,70518.3,592200
93070,185221.1,930650,73100,114892.6,338450,19970,70328.5,592200
93700,193369.5,930650,72680,120392.1,338450,21020,72977.4,592200
94350,196675.3,930650,72200,121662.9,338450,22150,75012.4,592200
95030,192555.3,930650,71780,118914.7,338450,23250,73640.6,592200
96020,186941.9,930650,71540,112827.5,338450,24480,74114.4,592200
97070,177416.5,930650,71300,108161.5,338450,25770,69255,592200
98080,179965.4,930650,71100,109429.4,338450,26980,70536,592200
99040,190426.5,930650,70850,115376.9,338450,28190,75049.6,592200
100590,194487.5,930650,70990,118158.2,338450,29600,76329.3,592200
102000,191561.7,930650,71070,115529.6,338450,30930,76032.1,592200
103480,188925.8,930650,71210,112141.4,338450,32270,76784.4,592200
104980,185005.3,930650,71330,104989.1,338450,33650,80016.2,592200
107570,190580.8,930650,71960,106881.4,338450,35610,83699.4,592200
110080,188332.9,930650,72590,106187.2,338450,37490,82145.7,592200
112710,183853.2,930650,73260,100568.2,338450,39450,83285,592200
115260,180951.4,930650,73870,98984,338450,41390,81967.4,592200
117450,174984.9,930650,74270,94042.3,338450,43180,80942.6,592200
119650,176525.7,930650,74650,95304.1,338450,45000,81221.6,592200
121890,189064.4,930650,75030,104790.3,338450,46860,84274.1,592200
124040,175844.9,930650,75410,99062,338450,48630,76782.9,592200
126900,201908.6,930650,76400,113921.9,338450,50500,87986.7,592200
129720,188644.8,930650,77370,106248.4,338450,52350,82396.4,592200
132440,180369.7,930650,78310,101914.2,338450,54130,78455.5,592200
135260,160675.3,930650,79280,86482.1,338450,55980,74193.2,592200
133030,179853.5,930650,78280,100706,338450,54750,79147.5,592200
130790,161242.9,930650,77280,93202.2,338450,53510,68040.7,592200
128520,147595,930650,76280,94896.5,338450,52240,52698.5,592200
126330,167329.2,930650,75300,95326.9,338450,51030,72002.3,592200
124070,146020.9,930650,74330,82463.8,338450,49740,63557.1,592200
121860,130268.4,930650,73390,70173.7,338450,48470,60094.7,592200
119620,124043.1,930650,72420,65257.9,338450,47200,58785.2,592200
117400,131771.4,930650,71470,71371.1,338450,45930,60400.3,592200
114510,128254,930650,70070,74135.2,338450,44440,54118.8,592200
111650,125544.2,930650,68640,74449.5,338450,43010,51094.7,592200
108850,110480.6,930650,67250,60449.7,338450,41600,50030.9,592200
105970,106498.5,930650,65860,58069.5,338450,40110,48429,592200
102470,116064.8,930650,63990,63889.7,338450,38480,52175.1,592200
99000,100191.8,930650,62110,55063.8,338450,36890,45128,592200
95530,84586.2,930650,60260,42875.5,338450,35270,41710.7,592200
92060,70498.1,930650,58390,33387,338450,33670,37111.1,592200
88810,66393.2,930650,56860,30880.6,338450,31950,35512.6,592200
85620,67434.9,930650,55360,30067.1,338450,30260,37367.8,592200
82270,71129.3,930650,53810,30952.9,338450,28460,40176.4,592200
75700,64788.1,930650,51650,25722.3,338450,24050,39065.8,592200
72060,63307.1,930650,48960,22159.6,338450,23100,41147.5,592200
68400,65424,930650,46260,21675,338450,22140,43749,592200
64800,65545.9,930650,43600,21259.5,338450,21200,44286.4,592200
61220,60997.7,930650,40920,16760.3,338450,20300,44237.4,592200
59320,70792.1,930650,40040,21687.6,338450,19280,49104.5,592200
57470,87301.4,930650,39210,33852.1,338450,18260,53449.3,592200
55610,80960.8,930650,38330,30401.7,338450,17280,50559.1,592200
53780,86121.9,930650,37480,34089,338450,16300,52032.9,592200
52310,95893.3,930650,37030,40053.5,338450,15280,55839.8,592200
50870,77488.3,930650,36560,27910.3,338450,14310,49578,592200
49410,74738.5,930650,36100,26647.7,338450,13310,48090.8,592200
47960,73818.3,930650,35660,26516.6,338450,12300,47301.7,592200
46590,62359,930650,35580,19301,338450,11010,43058,592200
45280,54701.7,930650,35530,14837.1,338450,9750,39864.6,592200
43860,51571.5,930650,35440,14273.6,338450,8420,37297.9,592200
42500,56781.3,930650,35370,17772.8,338450,7130,39008.5,592200
41300,59716.2,930650,34650,20297.7,338450,6650,39418.5,592200
40060,66205.2,930650,33880,24977,338450,6180,41228.2,592200
38900,60275.9,930650,33150,20454,338450,5750,39821.9,592200
37690,57181.5,930650,32400,19579.3,338450,5290,37602.2,592200
36520,52078,930650,31510,16993.8,338450,5010,35084.2,592200
35400,42150.7,930650,30610,11130.9,338450,4790,31019.8,592200
34260,39766.5,930650,29710,10199.4,338450,4550,29567.1,592200
33070,39990.2,930650,28780,10397.6,338450,4290,29592.6,592200
32030,40058.4,930650,27970,9601.1,338450,4060,30457.3,592200
30920,40583.2,930650,27150,10196.9,338450,3770,30386.3,592200
29910,35053.7,930650,26360,6678.4,338450,3550,28375.3,592200
28830,34177.5,930650,25530,6464.8,338450,3300,27712.7,592200
27180,48283.3,930650,24000,15183.1,338450,3180,33100.2,592200
25490,59869.5,930650,22470,21861.5,338450,3020,38008,592200
23820,44687.9,930650,20950,11114.4,338450,2870,33573.5,592200
22190,38011.6,930650,19400,7570.9,338450,2790,30440.7,592200
20770,32872.6,930650,18100,4701.1,338450,2670,28171.5,592200
19300,34310.5,930650,16790,4956.1,338450,2510,29354.4,592200
17830,33773.7,930650,15480,4498.8,338450,2350,29274.9,592200
16390,33759.1,930650,14160,4529.1,338450,2230,29230,592200
14920,39728.1,930650,12910,7698,338450,2010,32030.1,592200
13480,36067.4,930650,11670,4777.6,338450,1810,31289.8,592200
11970,37479.2,930650,10420,4856.7,338450,1550,32622.5,592200
10540,42396.6,930650,9170,6590.2,338450,1370,35806.4,592200
10310,44261.9,930650,8960,7693.1,338450,1350,36568.8,592200
10150,46048.4,930650,8750,8656.1,338450,1400,37392.3,592200
9930,42347.4,930650,8540,6539.9,338450,1390,35807.5,592200
9700,45278.3,930650,8330,8846.2,338450,1370,36432.1,592200
9800,55798.6,930650,8360,15865.5,338450,1440,39933.1,592200
9890,43394.1,930650,8380,9658,338450,1510,33736.1,592200
9950,42377.4,930650,8400,6800.4,338450,1550,35577,592200
9990,41967.5,930650,8420,6560.1,338450,1570,35407.4,592200
10400,40543.1,930650,8710,5702,338450,1690,34841.1,592200
10830,40514.7,930650,9010,5699.9,338450,1820,34814.8,592200
11270,38855.6,930650,9290,4928.5,338450,1980,33927.1,592200
11720,49900.5,930650,9590,12133.8,338450,2130,37766.7,592200
14600,51915.3,930650,11570,13930,338450,3030,37985.3,592200
17460,47849.8,930650,13530,11424.6,338450,3930,36425.2,592200
20370,41382.4,930650,15500,7535.5,338450,4870,33846.9,592200
23290,42055.3,930650,17470,7755.3,338450,5820,34300,592200
26480,47748.8,930650,19690,12426.3,338450,6790,35322.5,592200
29780,53463.2,930650,21950,16495.4,338450,7830,36967.8,592200
32990,54651.7,930650,24180,17550.5,338450,8810,37101.2,592200
36230,60954.6,930650,26410,21963.5,338450,9820,38991.1,592200
39550,61232,930650,28650,21919.3,338450,10900,39312.7,592200
42860,59015.9,930650,30910,21752.4,338450,11950,37263.5,592200
46190,53199.5,930650,33200,16703.9,338450,12990,36495.6,592200
49460,44811.5,930650,35420,12278.3,338450,14040,32533.2,592200
53850,47141.4,930650,38020,14571.3,338450,15830,32570.1,592200
58230,53532.9,930650,40610,18630.7,338450,17620,34902.2,592200
62550,57784,930650,43180,21988.5,338450,19370,35795.5,592200
66940,52907.1,930650,45730,18391.2,338450,21210,34515.9,592200
70890,58118.3,930650,48060,21965.9,338450,22830,36152.4,592200
74740,59083.1,930650,50360,23813.8,338450,24380,35269.3,592200
78690,46260,930650,52680,13392.3,338450,26010,32867.7,592200
82540,44710,930650,54990,12942.8,338450,27550,31767.2,592200
85640,57064.6,930650,56690,21888.5,338450,28950,35176.1,592200
88670,78055.8,930650,58360,37538.4,338450,30310,40517.4,592200
91710,84819,930650,60060,42416.8,338450,31650,42402.2,592200
94750,92363.8,930650,61730,46149.9,338450,33020,46213.9,592200
95180,94950.2,930650,62020,48918.9,338450,33160,46031.3,592200
95590,103022.1,930650,62320,54460.9,338450,33270,48561.2,592200
96040,114251.2,930650,62620,61156.9,338450,33420,53094.3,592200
96460,105126,930650,62910,55890.1,338450,33550,49235.9,592200
97070,102710.6,930650,63380,54262.6,338450,33690,48448,592200
97720,98229.7,930650,63840,50395.4,338450,33880,47834.3,592200
98330,100775.2,930650,64340,50814,338450,33990,49961.2,592200
99010,104740.1,930650,64810,51307.1,338450,34200,53433,592200
99170,96784.5,930650,64910,45381,338450,34260,51403.5,592200
99320,100663.2,930650,65060,47930.4,338450,34260,52732.8,592200
99430,105164.9,930650,65170,50125.9,338450,34260,55039,592200
99580,105828.8,930650,65290,50670.2,338450,34290,55158.6,592200
97590,114647.5,930650,63400,55659.7,338450,34190,58987.8,592200
95570,111861.7,930650,61480,53414.5,338450,34090,58447.2,592200
93590,105681.9,930650,59610,48609.8,338450,33980,57072.1,592200
91530,104236.5,930650,57700,45927.1,338450,33830,58309.4,592200
89170,101875.8,930650,55460,42501.7,338450,33710,59374.1,592200
86720,105119,930650,53250,44085.1,338450,33470,61033.9,592200
84320,98415.8,930650,51010,37550.4,338450,33310,60865.4,592200
81750,89755.8,930650,49670,30456.4,338450,32080,59299.4,592200
79940,87536,930650,47480,27486.8,338450,32460,60049.2,592200
78060,97245.4,930650,45280,31856.3,338450,32780,65389.1,592200
76270,101164.3,930650,43090,30833.6,338450,33180,70330.7,592200
74410,105507.9,930650,40920,31649.9,338450,33490,73858,592200
76910,102233.1,930650,41760,32736,338450,35150,69497.1,592200
79360,92138.1,930650,42610,28017.1,338450,36750,64121,592200
81900,87691.4,930650,43480,25964.6,338450,38420,61726.8,592200
84400,93712.4,930650,44330,28893.3,338450,40070,64819.1,592200
87220,103305.9,930650,45380,34094.7,338450,41840,69211.2,592200
90050,105436.1,930650,46410,34719.2,338450,43640,70716.9,592200
92790,104760.7,930650,47440,35142.2,338450,45350,69618.5,592200
95650,113584.7,930650,48490,39788.2,338450,47160,73796.5,592200
98600,112102,930650,49820,40577.1,338450,48780,71524.9,592200
101510,104400.4,930650,51150,37556.6,338450,50360,66843.8,592200
104490,96184.1,930650,52520,32997.4,338450,51970,63186.7,592200
107470,101983.9,930650,53870,37191.3,338450,53600,64792.6,592200
111190,101955.7,930650,56270,36720,338450,54920,65235.7,592200
114910,104356.4,930650,58690,37262.5,338450,56220,67093.9,592200
118670,105726,930650,61090,38263,338450,57580,67463,592200
122380,103961.6,930650,63500,37606.9,338450,58880,66354.7,592200
126620,100234.4,930650,66190,37074.9,338450,60430,63159.5,592200
130840,115807.7,930650,68900,49013,338450,61940,66794.7,592200
135180,132423.4,930650,71630,60577.2,338450,63550,71846.2,592200
139400,122417.7,930650,74350,51051.4,338450,65050,71366.3,592200
143760,117434.8,930650,77060,44156.2,338450,66700,73278.6,592200
148090,121043,930650,79760,43850.4,338450,68330,77192.6,592200
152490,127586.8,930650,82480,45740.1,338450,70010,81846.7,592200
156850,154194.2,930650,85200,59918.7,338450,71650,94275.5,592200
155680,152380.5,930650,84410,58174.7,338450,71270,94205.8,592200
154540,136820.5,930650,83650,49868.3,338450,70890,86952.2,592200
153400,133757.3,930650,82880,52086.9,338450,70520,81670.4,592200
152240,132008.8,930650,82100,53282.2,338450,70140,78726.6,592200
149710,123390.6,930650,80470,48076,338450,69240,75314.6,592200
147310,115026.2,930650,78860,45732,338450,68450,69294.2,592200
144880,117692.4,930650,77250,49116.9,338450,67630,68575.5,592200
142390,124040.5,930650,75600,50517,338450,66790,73523.5,592200
142930,145815.2,930650,75930,58517.6,338450,67000,87297.6,592200
143430,191082.3,930650,76220,84201.8,338450,67210,106880.5,592200
143890,147633.6,930650,76540,53357.9,338450,67350,94275.7,592200
144470,142911.8,930650,76870,51314,338450,67600,91597.8,592200
148070,192418,930650,77830,81014,338450,70240,111404,592200
151670,160084.7,930650,78780,58817.4,338450,72890,101267.3,592200
155290,148273.3,930650,79760,48951,338450,75530,99322.3,592200
158860,141009.7,930650,80710,45816.4,338450,78150,95193.3,592200
161670,146052.9,930650,81590,50173.6,338450,80080,95879.3,592200
164470,172100.5,930650,82480,67481.7,338450,81990,104618.8,592200
167360,168855.4,930650,83390,68996.2,338450,83970,99859.2,592200
170140,167026.9,930650,84260,71207.7,338450,85880,95819.2,592200
172430,183289,930650,84730,77378.1,338450,87700,105910.9,592200
174820,172257.3,930650,85180,72675.4,338450,89640,99581.9,592200
177130,177682.1,930650,85640,75615.4,338450,91490,102066.7,592200
179540,177656.5,930650,86100,76765.8,338450,93440,100890.7,592200
186240,180649.1,930650,88530,78924.6,338450,97710,101724.5,592200
193060,174297.7,930650,90990,76253.1,338450,102070,98044.6,592200
199810,186853.7,930650,93430,79571.1,338450,106380,107282.6,592200
206620,180456.4,930650,95890,76006.9,338450,110730,104449.5,592200
214820,195944.7,930650,99480,80246.8,338450,115340,115697.9,592200
223090,190107.1,930650,103130,79944.1,338450,119960,110163,592200
231250,199537.4,930650,106740,85162.5,338450,124510,114374.9,592200
239470,193364.4,930650,110350,82844.8,338450,129120,110519.6,592200
246930,197655,930650,112900,82799.6,338450,134030,114855.4,592200
254370,195856.4,930650,115450,81651.5,338450,138920,114204.9,592200
261900,193417.3,930650,118010,77515.6,338450,143890,115901.7,592200
269330,206416.6,930650,120550,85252.1,338450,148780,121164.5,592200
270050,202602.5,930650,121090,87537.2,338450,148960,115065.3,592200
270770,212126.1,930650,121660,86497.9,338450,149110,125628.2,592200
271510,220035.3,930650,122170,95034.5,338450,149340,125000.8,592200
272240,217093.4,930650,122710,90118.2,338450,149530,126975.2,592200
271630,202953.2,930650,122720,84043.6,338450,148910,118909.6,592200
270950,215564.5,930650,122760,90396.4,338450,148190,125168.1,592200
270360,225168.7,930650,122800,100193.5,338450,147560,124975.2,592200
269730,223579,930650,122800,95759.4,338450,146930,127819.6,592200
271060,248690.7,930650,126000,114903.9,338450,145060,133786.8,592200
272360,243379.1,930650,129190,113278.4,338450,143170,130100.7,592200
273690,236343.6,930650,132360,119399.2,338450,141330,116944.4,592200
274980,207836.5,930650,135530,113537.4,338450,139450,94299.1,592200
273180,209087.3,930650,134550,112303,338450,138630,96784.3,592200
271440,227734.2,930650,133570,115561.4,338450,137870,112172.8,592200
269580,211180.9,930650,132580,105674.7,338450,137000,105506.2,592200
267830,230130.1,930650,131590,108019.5,338450,136240,122110.6,592200
266570,244764.7,930650,130550,122347.6,338450,136020,122417.1,592200
265230,227616.4,930650,129500,113504.6,338450,135730,114111.8,592200
263970,218467.4,930650,128420,99449.8,338450,135550,119017.6,592200
262700,202023.3,930650,127380,103059.8,338450,135320,98963.5,592200
264070,203183.2,930650,128550,108006.7,338450,135520,95176.5,592200
265380,224399.2,930650,129710,121674.2,338450,135670,102725,592200
266770,219624.4,930650,130880,119021,338450,135890,100603.4,592200
268100,198252.8,930650,132050,106732.6,338450,136050,91520.2,592200
262220,197100.7,930650,128400,104905.2,338450,133820,92195.5,592200
256320,215693.5,930650,124750,105830.7,338450,131570,109862.8,592200
250420,232866.4,930650,121090,107467.8,338450,129330,125398.6,592200
244530,208235.1,930650,117440,92268.2,338450,127090,115966.9,592200
238350,221669.9,930650,114150,105585.3,338450,124200,116084.6,592200
232190,215179.3,930650,110840,101528.3,338450,121350,113651,592200
226030,205550.3,930650,107520,94256.4,338450,118510,111293.9,592200
170870,189672.8,930650,88140,88052.2,338450,82730,101620.6,592200
166560,243098.2,930650,85830,124060.7,338450,80730,119037.5,592200
162280,229184.2,930650,83530,114924.3,338450,78750,114259.9,592200
157980,184259.3,930650,81240,87526.7,338450,76740,96732.6,592200
153690,175408.2,930650,78940,81795.3,338450,74750,93612.9,592200
149820,203322.8,930650,76860,96637.4,338450,72960,106685.4,592200
146020,186786.5,930650,74780,85691.4,338450,71240,101095.1,592200
142130,186786.5,930650,72700,85691.4,338450,69430,101095.1,592200
138270,169104.1,930650,70610,77535.1,338450,67660,91569,592200
133660,170243.4,930650,68200,78123.3,338450,65460,92120.1,592200
129050,153942.1,930650,65770,66611.3,338450,63280,87330.8,592200
124500,143818.5,930650,63320,63639.3,338450,61180,80179.2,592200
119900,130512.6,930650,60930,56131.2,338450,58970,74381.4,592200
115790,110942.7,930650,58950,43142.3,338450,56840,67800.4,592200
111780,102138.7,930650,57000,38311,338450,54780,63827.7,592200
107730,93037.1,930650,55060,31017.1,338450,52670,62020,592200
103700,87458.8,930650,53120,27303.3,338450,50580,60155.5,592200
102990,91765.4,930650,53630,30049.6,338450,49360,61715.8,592200
102240,99579.4,930650,54150,32599.3,338450,48090,66980.1,592200
101560,97050.2,930650,54670,29159,338450,46890,67891.2,592200
100860,101037.8,930650,55190,32462.5,338450,45670,68575.3,592200
99960,98375.4,930650,55250,31552.1,338450,44710,66823.3,592200
98970,97625,930650,55310,29305.8,338450,43660,68319.2,592200
97980,86319.5,930650,55380,23338.2,338450,42600,62981.3,592200
97010,83606.9,930650,55420,24179.5,338450,41590,59427.4,592200
96380,75987.5,930650,55750,20341.4,338450,40630,55646.1,592200
95770,79136.2,930650,56130,24357.8,338450,39640,54778.4,592200
95210,91861.4,930650,56480,35534.1,338450,38730,56327.3,592200
94520,72378.1,930650,56830,24967.6,338450,37690,47410.5,592200
93580,80505.4,930650,55800,31258.6,338450,37780,49246.8,592200
92690,78308.1,930650,54740,30173.6,338450,37950,48134.5,592200
91720,77157.2,930650,53700,31362.2,338450,38020,45795,592200
90810,74512.4,930650,52670,35872.9,338450,38140,38639.5,592200
89770,73911.9,930650,51740,37383.8,338450,38030,36528.1,592200
88730,82478.9,930650,50800,34478.6,338450,37930,48000.3,592200
87710,77898.8,930650,49880,30078,338450,37830,47820.8,592200
86670,73132.4,930650,48960,27420.3,338450,37710,45712.1,592200
84850,82153.8,930650,47020,31553.9,338450,37830,50599.9,592200
83060,84720.5,930650,45090,31848.2,338450,37970,52872.3,592200
81300,80650.5,930650,43210,29739.5,338450,38090,50911,592200
79460,81141.7,930650,41290,30026.4,338450,38170,51115.3,592200
77270,84115.5,930650,39610,31180.8,338450,37660,52934.7,592200
75130,92014.5,930650,37960,34321.7,338450,37170,57692.8,592200
72970,93268.8,930650,36310,34192.8,338450,36660,59076,592200
70780,83708.8,930650,34640,28517.9,338450,36140,55190.9,592200
69430,71758,930650,33860,20533.8,338450,35570,51224.2,592200
68010,62832.2,930650,33080,15547.7,338450,34930,47284.5,592200
66520,69846.4,930650,32270,20726.9,338450,34250,49119.5,592200
65140,80024.1,930650,31490,27167.8,338450,33650,52856.3,592200
63440,87947.7,930650,30860,32316.8,338450,32580,55630.9,592200
61770,77847.5,930650,30210,25007.8,338450,31560,52839.7,592200
60080,70975.1,930650,29580,20229.8,338450,30500,50745.3,592200
58390,71621.5,930650,28920,21646.5,338450,29470,49975,592200
62000,71227.6,930650,31320,23805.3,338450,30680,47422.3,592200
65510,69510.2,930650,33700,21524,338450,31810,47986.2,592200
69090,69484.4,930650,36120,19653.9,338450,32970,49830.5,592200
72610,66773.8,930650,38500,19360.7,338450,34110,47413.1,592200
76140,67746.3,930650,40770,21841.2,338450,35370,45905.1,592200
79670,72146.9,930650,43010,25021.9,338450,36660,47125,592200
83170,69859.2,930650,45270,24488.1,338450,37900,45371.1,592200
86720,66316.6,930650,47540,21465.5,338450,39180,44851.1,592200
90300,67431.7,930650,49770,22805.9,338450,40530,44625.8,592200
93910,65090.6,930650,52040,21445.2,338450,41870,43645.4,592200
97490,65908.3,930650,54280,21890.3,338450,43210,44018,592200
101090,74182.3,930650,56530,28895.7,338450,44560,45286.6,592200
104610,83628.5,930650,58660,33805.7,338450,45950,49822.8,592200
108040,89775.5,930650,60780,34918.7,338450,47260,54856.8,592200
111530,91972.7,930650,62890,37881.5,338450,48640,54091.2,592200
115050,95646,930650,65020,38660.5,338450,50030,56985.5,592200
118850,108641.1,930650,67380,44534.3,338450,51470,64106.8,592200
122630,114572,930650,69750,47525.8,338450,52880,67046.2,592200
126460,111405.2,930650,72130,46734.6,338450,54330,64670.6,592200
130200,110783.3,930650,74490,48087.4,338450,55710,62695.9,592200
133600,109125.8,930650,76570,48780.3,338450,57030,60345.5,592200
136970,107610,930650,78620,47949.2,338450,58350,59660.8,592200
140330,114170.5,930650,80680,52316.8,338450,59650,61853.7,592200
143760,120633,930650,82730,55951.6,338450,61030,64681.4,592200
146730,129072.1,930650,84240,60338.9,338450,62490,68733.2,592200
149700,131333.8,930650,85730,61506,338450,63970,69827.8,592200
152630,134033.8,930650,87250,63609.6,338450,65380,70424.2,592200
155670,133922.4,930650,88770,63386,338450,66900,70536.4,592200
158040,143384.8,930650,89680,69675.9,338450,68360,73708.9,592200
160540,146613.6,930650,90600,68876.4,338450,69940,77737.2,592200
163050,153435.1,930650,91540,71501,338450,71510,81934.1,592200
165500,163812.8,930650,92500,74564.3,338450,73000,89248.5,592200
169310,175940.9,930650,94750,79446.7,338450,74560,96494.2,592200
173260,174405.9,930650,97020,81563.1,338450,76240,92842.8,592200
177080,165001.4,930650,99250,79292.8,338450,77830,85708.6,592200
180970,169071.5,930650,101510,83779.6,338450,79460,85291.9,592200
181810,178306.8,930650,101850,89224.4,338450,79960,89082.4,592200
182680,175731.4,930650,102200,87305.9,338450,80480,88425.5,592200
183510,160199.1,930650,102530,76901.7,338450,80980,83297.4,592200
182980,160268.8,930650,100380,78441.5,338450,82600,81827.3,592200
184140,140694.4,930650,99670,65515.9,338450,84470,75178.5,592200
185200,150395.9,930650,98960,67226.7,338450,86240,83169.2,592200
186340,166021.4,930650,98260,81114.9,338450,88080,84906.5,592200
187420,175436.8,930650,97540,90498.4,338450,89880,84938.4,592200
187760,171462.9,930650,96220,82379.7,338450,91540,89083.2,592200
188070,177285.4,930650,94900,84089,338450,93170,93196.4,592200
188330,174395.7,930650,93580,78510.4,338450,94750,95885.3,592200
188680,146015.7,930650,92290,62865.3,338450,96390,83150.4,592200
189270,132191,930650,92170,51830.9,338450,97100,80360.1,592200
189760,137271,930650,92050,56163.5,338450,97710,81107.5,592200
190290,149677,930650,91920,64538.5,338450,98370,85138.5,592200
190810,163815.2,930650,91800,76209.7,338450,99010,87605.5,592200
192220,182723.7,930650,92300,91082.8,338450,99920,91640.9,592200
193540,205686.9,930650,92790,100084.8,338450,100750,105602.1,592200
194910,236197,930650,93300,118620.1,338450,101610,117576.9,592200
196240,247515.1,930650,93780,124493.6,338450,102460,123021.5,592200
197750,256534.5,930650,94150,128909.5,338450,103600,127625,592200
199210,271041.7,930650,94520,136155.7,338450,104690,134886,592200
200670,261655.8,930650,94860,139901,338450,105810,121754.8,592200
202260,259226.7,930650,95220,137269.1,338450,107040,121957.6,592200
205030,253736.2,930650,96060,137121.2,338450,108970,116615,592200
207750,259844.9,930650,96860,142253.3,338450,110890,117591.6,592200
210560,244787.7,930650,97710,132217.7,338450,112850,112570,592200
213310,242902.7,930650,98530,127251.2,338450,114780,115651.5,592200
216260,249429.1,930650,99330,127745.3,338450,116930,121683.8,592200
219230,251977.3,930650,100140,127872.5,338450,119090,124104.8,592200
222250,250990.7,930650,100970,127024.5,338450,121280,123966.2,592200
225240,253362,930650,101770,129493.9,338450,123470,123868.1,592200
228490,251358.7,930650,102520,124233,338450,125970,127125.7,592200
231790,241371.5,930650,103280,115902.9,338450,128510,125468.6,592200
235090,237259.4,930650,103990,111060.2,338450,131100,126199.2,592200
238390,231110.2,930650,104770,108299,338450,133620,122811.2,592200
242840,229497.2,930650,106380,106982.5,338450,136460,122514.7,592200
247280,236428.2,930650,108010,110104.4,338450,139270,126323.8,592200
251710,240430.4,930650,109650,106367.8,338450,142060,134062.6,592200
256130,238727.9,930650,111270,107877.7,338450,144860,130850.2,592200
258580,226854.1,930650,112360,111159.9,338450,146220,115694.2,592200
260960,236228.1,930650,113440,111747.1,338450,147520,124481,592200
263400,274412.5,930650,114530,125362.8,338450,148870,149049.7,592200
265790,286942.2,930650,115630,131801.9,338450,150160,155140.3,592200
267890,321696.7,930650,116320,140335.4,338450,151570,181361.3,592200
269880,344174.9,930650,116980,152033.4,338450,152900,192141.5,592200
271930,380480.5,930650,117650,166138.3,338450,154280,214342.2,592200
273950,425273.2,930650,118330,178311,338450,155620,246962.2,592200
281580,455082.2,930650,120190,193849.4,338450,161390,261232.8,592200
289100,462856.7,930650,122070,193973.3,338450,167030,268883.4,592200
296610,491681.9,930650,123950,202084.2,338450,172660,289597.7,592200
304170,484817,930650,125810,201535.4,338450,178360,283281.6,592200
311560,498737.1,930650,127330,211114.2,338450,184230,287622.9,592200
318920,485449.5,930650,128860,210566.9,338450,190060,274882.6,592200
326350,461422.3,930650,130390,193010.3,338450,195960,268412,592200
333710,467341.5,930650,131920,197031.6,338450,201790,270309.9,592200
339930,455531.3,930650,133490,190920.1,338450,206440,264611.2,592200
346280,477647.9,930650,135080,205717.7,338450,211200,271930.2,592200
352440,507406.5,930650,136640,222858.4,338450,215800,284548.1,592200
358770,538369.7,930650,138230,239615.7,338450,220540,298754,592200
364890,541362.2,930650,141580,241957.7,338450,223310,299404.5,592200
371050,541543.2,930650,144890,245710.4,338450,226160,295832.8,592200
377200,560683.7,930650,148260,254986.2,338450,228940,305697.5,592200
383360,561646.1,930650,151580,261506.1,338450,231780,300140,592200
390430,556532.9,930650,155620,257769.8,338450,234810,298763.1,592200
397550,554137.3,930650,159640,256320.9,338450,237910,297816.4,592200
404740,539263,930650,163690,256592,338450,241050,282671,592200
411860,542883.6,930650,167720,260840.5,338450,244140,282043.1,592200
419560,547712.8,930650,172010,269231.2,338450,247550,278481.6,592200
427280,544896.5,930650,176280,268343.1,338450,251000,276553.4,592200
434970,556514.9,930650,180560,265057.1,338450,254410,291457.8,592200
442670,562738.4,930650,184850,267985.2,338450,257820,294753.2,592200
444170,576474.1,930650,187250,272199.7,338450,256920,304274.4,592200
445590,556909.9,930650,189660,266578.8,338450,255930,290331.1,592200
447020,571582.6,930650,192050,271772.4,338450,254970,299810.2,592200
448480,580904.6,930650,194430,277870.7,338450,254050,303033.9,592200
447730,576447.3,930650,196370,276999.4,338450,251360,299447.9,592200
446910,579441.6,930650,198310,279336.2,338450,248600,300105.4,592200
446080,580773.4,930650,200240,277762,338450,245840,303011.4,592200
445270,576059,930650,202180,275315.4,338450,243090,300743.6,592200
443570,550565.1,930650,203640,266984.1,338450,239930,283581,592200
441800,517066,930650,205090,257124,338450,236710,259942,592200
440100,492162.5,930650,206570,250551.5,338450,233530,241611,592200
438340,480865.3,930650,208010,244224.8,338450,230330,236640.5,592200
437130,471280.8,930650,208130,240940,338450,229000,230340.8,592200
435870,474897.1,930650,208260,242818.1,338450,227610,232079,592200
434650,474374.9,930650,208380,242325.4,338450,226270,232049.5,592200
433380,501170.7,930650,208530,251674.7,338450,224850,249496,592200
432640,507304.2,930650,208090,253301.2,338450,224550,254003,592200
431870,504592,930650,207660,252501.7,338450,224210,252090.3,592200
431140,491632.7,930650,207240,249898.3,338450,223900,241734.4,592200
430370,491763,930650,206790,252497.5,338450,223580,239265.5,592200
430810,494729.8,930650,207380,254296.9,338450,223430,240432.9,592200
431200,486909.2,930650,207980,249681.8,338450,223220,237227.4,592200
431600,481245.1,930650,208560,244667.2,338450,223040,236577.9,592200
431990,459437.3,930650,209160,236297.3,338450,222830,223140,592200
428980,448986,930650,207490,232084.6,338450,221490,216901.4,592200
425980,437442,930650,205840,226023.3,338450,220140,211418.7,592200
422920,421237.6,930650,204160,220087.2,338450,218760,201150.4,592200
405080,428985.4,930650,189030,216304.6,338450,216050,212680.8,592200
401400,440082.7,930650,187790,220684.2,338450,213610,219398.5,592200
397710,442168.9,930650,186580,223240.1,338450,211130,218928.8,592200
394010,428705.8,930650,185340,221382.2,338450,208670,207323.6,592200
390340,417570.5,930650,184130,216653.3,338450,206210,200917.2,592200
387130,413791.2,930650,183140,213045.8,338450,203990,200745.4,592200
384070,417363.3,930650,182170,213784.8,338450,201900,203578.5,592200
380820,424899.5,930650,181190,209896.4,338450,199630,215003.1,592200
377680,438124.1,930650,180190,211425.9,338450,197490,226698.2,592200
375460,433871.1,930650,177920,210807.5,338450,197540,223063.6,592200
373260,432790.8,930650,175650,208958.3,338450,197610,223832.5,592200
370990,409175.6,930650,173370,195847,338450,197620,213328.6,592200
368760,411501.9,930650,171080,200439.6,338450,197680,211062.3,592200
366380,388093.5,930650,168740,189864.3,338450,197640,198229.2,592200
363940,346486.3,930650,166400,167791.2,338450,197540,178695.1,592200
361610,304449.1,930650,164090,144256.4,338450,197520,160192.7,592200
359210,290944.2,930650,161740,134850.4,338450,197470,156093.8,592200
357890,296323.1,930650,160190,136920.1,338450,197700,159403,592200
356640,316968.8,930650,158640,147186.7,338450,198000,169782.1,592200
355340,333655.7,930650,157080,154266.5,338450,198260,179389.2,592200
353990,315862.1,930650,155520,143577.8,338450,198470,172284.3,592200
356900,320574.5,930650,157160,145782.1,338450,199740,174792.4,592200
359750,339184.8,930650,158790,154553.9,338450,200960,184630.9,592200
362620,327043.3,930650,160430,144405.1,338450,202190,182638.2,592200
365550,322274.9,930650,162110,137464.9,338450,203440,184810,592200
368370,336617.3,930650,163810,145613.9,338450,204560,191003.4,592200
371220,341908.6,930650,165500,147593.8,338450,205720,194314.8,592200
374080,338519.2,930650,167220,142314.8,338450,206860,196204.4,592200
376990,328807.2,930650,168930,130284.4,338450,208060,198522.8,592200
379420,320451.7,930650,170520,125159,338450,208900,195292.7,592200
381850,302129,930650,172100,126311.2,338450,209750,175817.8,592200
384280,295181.3,930650,173700,129027.1,338450,210580,166154.2,592200
386700,306196.9,930650,175300,141581.6,338450,211400,164615.3,592200
388280,313238.9,930650,174920,150831.3,338450,213360,162407.6,592200
389820,313579.7,930650,174560,150090,338450,215260,163489.7,592200
391450,305468.3,930650,174230,144660,338450,217220,160808.3,592200
392980,307947.1,930650,173870,144646.8,338450,219110,163300.3,592200
394330,319025.6,930650,173890,149970.2,338450,220440,169055.4,592200
395710,319983.6,930650,173940,155914.6,338450,221770,164069,592200
397090,318400.4,930650,173990,166001.2,338450,223100,152399.2,592200
398410,378051.5,930650,174020,197284.7,338450,224390,180766.8,592200
402010,412346.8,930650,174710,217029.2,338450,227300,195317.6,592200
405580,412611.8,930650,175390,216352.5,338450,230190,196259.3,592200
409160,460577.4,930650,176080,236768,338450,233080,223809.4,592200
412760,464113.1,930650,176760,229755.5,338450,236000,234357.6,592200
418820,460902,930650,177980,217088.7,338450,240840,243813.3,592200
424890,451698.9,930650,179200,210458.5,338450,245690,241240.4,592200
430930,436541.1,930650,180420,198092.5,338450,250510,238448.6,592200
437050,425790.7,930650,181640,191940.6,338450,255410,233850.1,592200
443660,440602.6,930650,183150,203361.7,338450,260510,237240.9,592200
450270,449008.9,930650,184640,211205.1,338450,265630,237803.8,592200
456900,471516.2,930650,186110,222337.8,338450,270790,249178.4,592200
463480,491166.6,930650,187620,231830.1,338450,275860,259336.5,592200
469220,503477.7,930650,188940,238429.2,338450,280280,265048.5,592200
474990,510551.7,930650,190280,239907.3,338450,284710,270644.4,592200
480660,536266.9,930650,191590,253139.3,338450,289070,283127.6,592200
486440,531251,930650,192920,257820.7,338450,293520,273430.3,592200
489220,536117.9,930650,195020,255114.5,338450,294200,281003.4,592200
492060,563688.6,930650,197130,265557.1,338450,294930,298131.5,592200
494950,557117,930650,199230,264938.5,338450,295720,292178.5,592200
497800,558802.8,930650,201320,264852.4,338450,296480,293950.4,592200
499740,553537,930650,202950,259910.2,338450,296790,293626.8,592200
501720,552913,930650,204560,259135.1,338450,297160,293777.9,592200
503720,555417.8,930650,206180,264677.2,338450,297540,290740.6,592200
505630,556283.3,930650,207790,265685.7,338450,297840,290597.6,592200
508090,556500.9,930650,209870,262606.3,338450,298220,293894.6,592200
510470,547102.5,930650,211930,255694.9,338450,298540,291407.6,592200
512860,542131.6,930650,213990,257830.1,338450,298870,284301.5,592200
515250,545705.1,930650,216040,255448.9,338450,299210,290256.2,592200
513940,553661.4,930650,217720,261286.5,338450,296220,292374.9,592200
512630,547771.3,930650,219380,265223.2,338450,293250,282548.1,592200
511260,546934.6,930650,221030,258663.9,338450,290230,288270.7,592200
509940,548966.4,930650,222710,261869.8,338450,287230,287096.6,592200
506980,530728.6,930650,223560,249870.9,338450,283420,280857.7,592200
503990,529668.5,930650,224380,251182.8,338450,279610,278485.7,592200
501140,506991.2,930650,225270,244245.5,338450,275870,262745.7,592200
498230,496706.4,930650,226110,245770.1,338450,272120,250936.3,592200
494560,484828.8,930650,226610,241392.3,338450,267950,243436.5,592200
490920,476223.9,930650,227160,238830.4,338450,263760,237393.5,592200
487310,458426.7,930650,227700,236473.4,338450,259610,221953.3,592200
483640,439675.1,930650,228230,235407,338450,255410,204268.1,592200
467800,429261.1,930650,225610,232740,338450,242190,196521.1,592200
464040,425183.5,930650,224590,228669.2,338450,239450,196514.3,592200
460220,430372.9,930650,223570,229679.9,338450,236650,200693,592200
456460,426393.7,930650,222530,225822,338450,233930,200571.7,592200
452700,420815.5,930650,221470,223031.8,338450,231230,197783.7,592200
448980,422614.8,930650,220450,221659.2,338450,228530,200955.6,592200
445200,439120.8,930650,219430,224503.6,338450,225770,214617.2,592200
441390,441143.8,930650,218400,229927.2,338450,222990,211216.6,592200
437630,452598.1,930650,217340,232585.9,338450,220290,220012.2,592200
433920,454100.2,930650,216310,234743.5,338450,217610,219356.7,592200
430080,435156.6,930650,215280,228184,338450,214800,206972.6,592200
426390,438896,930650,214270,230199.5,338450,212120,208696.5,592200
423290,449803.7,930650,211880,235292.7,338450,211410,214511,592200
420280,447101.9,930650,209480,231003.4,338450,210800,216098.5,592200
417150,412850.7,930650,207080,218532.8,338450,210070,194317.9,592200
373150,375723.9,930650,184650,194160,338450,188500,181563.9,592200
370890,360989.2,930650,183230,187286.6,338450,187660,173702.6,592200
368590,345911.7,930650,181760,176352.7,338450,186830,169559,592200
366340,315835.7,930650,180310,156809.1,338450,186030,159026.6,592200
364030,323008.6,930650,178840,159506.3,338450,185190,163502.3,592200
362600,344164.4,930650,177750,168866.8,338450,184850,175297.6,592200
361110,336716,930650,176670,164441.9,338450,184440,172274.1,592200
359630,319633.4,930650,175580,154294.6,338450,184050,165338.8,592200
358140,323578,930650,174490,161808,338450,183650,161770,592200
358590,347690.8,930650,174780,179303,338450,183810,168387.8,592200
359070,321873.8,930650,175050,164647.5,338450,184020,157226.3,592200
359600,303427.7,930650,175360,153230.5,338450,184240,150197.2,592200
360060,288921.4,930650,175640,141861.9,338450,184420,147059.5,592200
360390,322444.8,930650,175730,161416.5,338450,184660,161028.3,592200
360710,312107.3,930650,175860,153467.5,338450,184850,158639.8,592200
361050,319851.4,930650,175980,159194.9,338450,185070,160656.5,592200
361370,300361.3,930650,176080,146434.4,338450,185290,153926.9,592200
363100,333486.6,930650,177450,169860.8,338450,185650,163625.8,592200
364810,343363.7,930650,178820,178428.2,338450,185990,164935.5,592200
366470,327430.3,930650,180200,168293,338450,186270,159137.3,592200
368190,370356.5,930650,181570,197031.4,338450,186620,173325.1,592200
372360,359815.2,930650,183750,185288.1,338450,188610,174527.1,592200
376580,322410.2,930650,185970,160581.4,338450,190610,161828.8,592200
380760,341072.1,930650,188160,174601.7,338450,192600,166470.4,592200
385000,368642,930650,190350,191887.9,338450,194650,176754.1,592200
389330,386594.1,930650,192400,201642.1,338450,196930,184952,592200
393700,402098.4,930650,194430,210957.9,338450,199270,191140.5,592200
398090,408704.1,930650,196500,215882.2,338450,201590,192821.9,592200
402450,406017.3,930650,198550,217894.3,338450,203900,188123,592200
407430,394576,930650,200760,213342.3,338450,206670,181233.7,592200
412470,395460,930650,203010,214461,338450,209460,180999,592200
417440,387326,930650,205220,210752.2,338450,212220,176573.8,592200
422400,394079.8,930650,207460,215896.5,338450,214940,178183.3,592200
425230,385202,930650,208540,210246.8,338450,216690,174955.2,592200
428130,376614.4,930650,209620,205704.7,338450,218510,170909.7,592200
431010,371143.9,930650,210710,206640.4,338450,220300,164503.5,592200
433920,378169.1,930650,211800,210708.7,338450,222120,167460.4,592200
436970,381420.2,930650,212740,210733.4,338450,224230,170686.8,592200
440090,372075.9,930650,213650,206383.4,338450,226440,165692.5,592200
443140,369758,930650,214590,204607.2,338450,228550,165150.8,592200
446260,377253.2,930650,215530,208597.4,338450,230730,168655.8,592200
448760,382945.6,930650,216500,209665.8,338450,232260,173279.8,592200
451240,390195.2,930650,217480,207892.5,338450,233760,182302.7,592200
453750,391591.6,930650,218480,208633.3,338450,235270,182958.3,592200
456340,387851.7,930650,219470,206612.5,338450,236870,181239.2,592200
458200,390765.8,930650,219650,209958.6,338450,238550,180807.2,592200
460080,382923.6,930650,219880,209729.6,338450,240200,173194,592200
461950,371024,930650,220090,200768.4,338450,241860,170255.6,592200
463820,374877.2,930650,220290,200893.2,338450,243530,173984,592200
465300,384361.7,930650,220130,204914.1,338450,245170,179447.6,592200
466760,396223.3,930650,219980,213468.5,338450,246780,182754.8,592200
468130,418329.7,930650,219800,223260.4,338450,248330,195069.3,592200
469650,431417,930650,219640,228814.9,338450,250010,202602.1,592200
471270,450811.1,930650,219760,237890,338450,251510,212921.1,592200
472870,444911.7,930650,219880,232773.2,338450,252990,212138.5,592200
474600,447987.6,930650,220030,231732.9,338450,254570,216254.7,592200
476280,460528.9,930650,220170,239060.7,338450,256110,221468.2,592200
477930,484532.5,930650,220240,249154.6,338450,257690,235377.9,592200
479560,489801.3,930650,220340,250324.9,338450,259220,239476.4,592200
481190,481050.7,930650,220420,245587.7,338450,260770,235463,592200
482810,484361.3,930650,220500,244166.2,338450,262310,240195.1,592200
484340,465257,930650,220370,229660.7,338450,263970,235596.3,592200
485900,458548.2,930650,220250,221816.5,338450,265650,236731.7,592200
487470,470087.7,930650,220110,224862.7,338450,267360,245225,592200
488990,468030.1,930650,219980,228416.4,338450,269010,239613.7,592200
490300,451728.1,930650,219840,223508,338450,270460,228220.1,592200
491590,468445.5,930650,219680,228247.2,338450,271910,240198.3,592200
492860,485326.6,930650,219510,232715.6,338450,273350,252611,592200
494130,476596.9,930650,219350,235082.6,338450,274780,241514.3,592200
489750,455265,930650,218560,225104.7,338450,271190,230160.3,592200
485450,451320.2,930650,217760,217440.6,338450,267690,233879.6,592200
481080,443171.5,930650,216940,208823.7,338450,264140,234347.8,592200
476680,432507.5,930650,216160,207693.1,338450,260520,224814.4,592200
470920,423809.4,930650,214910,210482.1,338450,256010,213327.3,592200
465110,417859.9,930650,213670,209637.7,338450,251440,208222.2,592200
459320,408293.2,930650,212420,202866.3,338450,246900,205426.9,592200
453610,410715.4,930650,211180,212699.1,338450,242430,198016.3,592200
448070,446661.9,930650,210180,232966.3,338450,237890,213695.6,592200
442550,448414.6,930650,209190,235699.4,338450,233360,212715.2,592200
437030,431028.4,930650,208190,231057.4,338450,228840,199971,592200
431560,426074.7,930650,207200,233209.2,338450,224360,192865.5,592200
432900,423617.3,930650,207110,237152.4,338450,225790,186464.9,592200
434230,425788.5,930650,207040,236422.2,338450,227190,189366.3,592200
435690,433996.3,930650,206970,237020.8,338450,228720,196975.5,592200
437090,426981.6,930650,206900,225336.3,338450,230190,201645.3,592200
439080,427149.7,930650,207240,225333.1,338450,231840,201816.6,592200
441080,431950,930650,207580,225631.1,338450,233500,206318.9,592200
443120,444197.1,930650,207930,234594.5,338450,235190,209602.6,592200
445080,427960.1,930650,208260,221966.7,338450,236820,205993.4,592200
447370,360000.3,930650,209170,178886.7,338450,238200,181113.6,592200
449580,313836.2,930650,210060,144919.3,338450,239520,168916.9,592200
451890,319125.9,930650,210940,144662,338450,240950,174463.9,592200
454160,305185.3,930650,211860,140661.8,338450,242300,164523.5,592200
454920,343356.7,930650,212970,168707.2,338450,241950,174649.5,592200
455690,346027.6,930650,214070,174520.6,338450,241620,171507,592200
456510,333003.1,930650,215180,169727.6,338450,241330,163275.5,592200
367370,326381.6,930650,166680,160850,338450,200690,165531.6,592200
365390,325203,930650,167190,161589.8,338450,198200,163613.2,592200
363320,317740.6,930650,167740,154450.2,338450,195580,163290.4,592200
361280,301638.3,930650,168250,148002.9,338450,193030,153635.4,592200
359300,301900.9,930650,168790,146594.3,338450,190510,155306.6,592200
357920,296769.1,930650,169600,144353.4,338450,188320,152415.7,592200
356570,339444.9,930650,170430,158598.9,338450,186140,180846,592200
355210,357562.9,930650,171260,169477.9,338450,183950,188085,592200
353850,379266.4,930650,172110,186417,338450,181740,192849.4,592200
354540,382350.2,930650,173060,189959,338450,181480,192391.2,592200
355210,382368.2,930650,174030,191419,338450,181180,190949.2,592200
355900,383510.8,930650,175010,190850.6,338450,180890,192660.2,592200
356540,401506.4,930650,175980,188745.2,338450,180560,212761.2,592200
358070,407401.4,930650,177550,187867.5,338450,180520,219533.9,592200
359540,413426.6,930650,179120,192809.5,338450,180420,220617.1,592200
360950,395352.8,930650,180680,182799.1,338450,180270,212553.7,592200
362460,350962.6,930650,182260,166073.1,338450,180200,184889.5,592200
364910,347509.9,930650,184710,168793.8,338450,180200,178716.1,592200
367400,332935.1,930650,187150,163848.7,338450,180250,169086.4,592200
369800,356977.1,930650,189600,175141.8,338450,180200,181835.3,592200
372230,343477.4,930650,192050,158203,338450,180180,185274.4,592200
375210,359696.9,930650,193520,166253.1,338450,181690,193443.8,592200
378200,337217.5,930650,195000,159573.3,338450,183200,177644.2,592200
381170,300020.3,930650,196480,138656.1,338450,184690,161364.2,592200
384120,347444.5,930650,197940,152679.3,338450,186180,194765.2,592200
386690,351701.9,930650,199090,156025,338450,187600,195676.9,592200
389290,346222,930650,200270,158535.3,338450,189020,187686.7,592200
391830,324111.6,930650,201410,151957.4,338450,190420,172154.2,592200
394420,328678.2,930650,202560,150370.4,338450,191860,178307.8,592200
396400,319392.8,930650,203520,152113.9,338450,192880,167278.9,592200
398250,345461.2,930650,204460,167471.8,338450,193790,177989.4,592200
400200,364015.9,930650,205390,178216,338450,194810,185799.9,592200
402150,363516.2,930650,206370,181915.3,338450,195780,181600.9,592200
401340,363302.6,930650,206110,187822,338450,195230,175480.6,592200
400460,382154.2,930650,205820,203682.8,338450,194640,178471.4,592200
399750,382113.9,930650,205560,204601.3,338450,194190,177512.6,592200
398920,377545,930650,205280,199274.1,338450,193640,178270.9,592200
398260,368654.3,930650,204930,192787.1,338450,193330,175867.2,592200
397590,382843.9,930650,204560,204092,338450,193030,178751.9,592200
396890,396298.9,930650,204220,208600.8,338450,192670,187698.1,592200
396260,382220.6,930650,203870,201012.1,338450,192390,181208.5,592200
395930,374979.9,930650,203740,193742.7,338450,192190,181237.2,592200
395680,357357.7,930650,203630,185145.5,338450,192050,172212.2,592200
395430,357729,930650,203510,187398,338450,191920,170331,592200
395150,366170.6,930650,203380,193036,338450,191770,173134.6,592200
394550,371813.6,930650,202780,195261.2,338450,191770,176552.4,592200
393930,352273.6,930650,202130,185622.5,338450,191800,166651.1,592200
393350,345805.2,930650,201510,182340.6,338450,191840,163464.6,592200
392740,349394.7,930650,200880,186645.8,338450,191860,162748.9,592200
392000,359968.4,930650,200190,188928.2,338450,191810,171040.2,592200
391410,354526.5,930650,199520,190149.1,338450,191890,164377.4,592200
390770,344196.8,930650,198850,179207.6,338450,191920,164989.2,592200
390100,338185.9,930650,198180,174402,338450,191920,163783.9,592200
389670,340747.3,930650,197750,175251.5,338450,191920,165495.8,592200
389230,356285.8,930650,197290,184571.7,338450,191940,171714.1,592200
388790,331905.3,930650,196840,179652.3,338450,191950,152253,592200
388360,335714,930650,196410,179049.1,338450,191950,156664.9,592200
392810,366140.6,930650,196680,199828.6,338450,196130,166312,592200
397220,390019.2,930650,196990,209754.1,338450,200230,180265.1,592200
401670,427557.3,930650,197250,225194.6,338450,204420,202362.7,592200
406160,444270.7,930650,197560,232628.5,338450,208600,211642.2,592200
410500,477139.7,930650,197800,240571.9,338450,212700,236567.8,592200
414770,480674.5,930650,198050,238428.7,338450,216720,242245.8,592200
419150,490029.8,930650,198340,238549.2,338450,220810,251480.6,592200
423490,498138.3,930650,198570,237184.6,338450,224920,260953.7,592200
428070,537973.8,930650,198680,250254.3,338450,229390,287719.5,592200
432690,552172.4,930650,198820,255799.9,338450,233870,296372.5,592200
437220,542281,930650,198950,247432.3,338450,238270,294848.7,592200
441820,509553.2,930650,199060,226710.5,338450,242760,282842.7,592200
443420,517470.2,930650,199500,224838.4,338450,243920,292631.8,592200
444980,554793.5,930650,199940,247639.5,338450,245040,307154,592200
446560,559141,930650,200370,253968,338450,246190,305173,592200
448160,564860.7,930650,200830,254567.1,338450,247330,310293.6,592200
449100,536331.2,930650,201400,240863.4,338450,247700,295467.8,592200
450050,525707.1,930650,202000,239199.1,338450,248050,286508,592200
451060,513000.6,930650,202570,235069,338450,248490,277931.6,592200
452020,533531.7,930650,203160,245587.9,338450,248860,287943.8,592200
453330,502955.7,930650,204180,237075.4,338450,249150,265880.3,592200
454620,495655,930650,205180,227736.1,338450,249440,267918.9,592200
455950,496625.7,930650,206160,223279.8,338450,249790,273345.9,592200
457300,466637.7,930650,207190,212778.2,338450,250110,253859.5,592200
459270,467748.4,930650,208520,201998.9,338450,250750,265749.5,592200
461240,443785.1,930650,209860,199820.2,338450,251380,243964.9,592200
463210,434020.8,930650,211190,198153.3,338450,252020,235867.5,592200
465230,435545.5,930650,212550,199038.4,338450,252680,236507.1,592200
465800,419432.8,930650,212910,190396,338450,252890,229036.8,592200
466290,404659.7,930650,213260,183154.8,338450,253030,221504.9,592200
466830,387717.7,930650,213600,166486.8,338450,253230,221230.9,592200
467410,372937.6,930650,213980,154950.2,338450,253430,217987.4,592200
467010,350182.4,930650,214090,148403.3,338450,252920,201779.1,592200
466550,353468.2,930650,214240,151667.6,338450,252310,201800.6,592200
466170,341991.7,930650,214380,144801.1,338450,251790,197190.6,592200
465680,341844.6,930650,214510,143599.9,338450,251170,198244.7,592200
463450,333923.4,930650,214420,140516.6,338450,249030,193406.8,592200
461260,325718.6,930650,214310,138230.3,338450,246950,187488.3,592200
459060,349125.6,930650,214220,152206.5,338450,244840,196919.1,592200
469450,356061.5,930650,216510,156025.7,338450,252940,200035.8,592200
468960,359790.1,930650,216410,160260.7,338450,252550,199529.4,592200
468410,377298.5,930650,216300,171474.4,338450,252110,205824.1,592200
467970,393128.6,930650,216230,180487,338450,251740,212641.6,592200
467380,397699.3,930650,216120,182108.8,338450,251260,215590.5,592200
467820,394262.5,930650,216560,178139,338450,251260,216123.5,592200
468280,404963.8,930650,216980,184241.2,338450,251300,220722.6,592200
468670,400740.4,930650,217400,181156.1,338450,251270,219584.3,592200
469130,398466.7,930650,217840,178625,338450,251290,219841.7,592200
471610,373312.2,930650,218330,166043.6,338450,253280,207268.6,592200
474130,354606.2,930650,218840,154469.1,338450,255290,200137.1,592200
476610,373794.9,930650,219320,164291.5,338450,257290,209503.4,592200
479090,395549.8,930650,219830,176899.7,338450,259260,218650.1,592200
482510,429058.9,930650,221150,197171.4,338450,261360,231887.5,592200
485970,442583.8,930650,222500,206792,338450,263470,235791.8,592200
489450,431703.9,930650,223870,204413,338450,265580,227290.9,592200
492960,446276,930650,225220,209059.4,338450,267740,237216.6,592200
495450,438308.7,930650,226200,212368.4,338450,269250,225940.3,592200
498010,429899.9,930650,227200,207050.1,338450,270810,222849.8,592200
500560,445892.7,930650,228160,216350.5,338450,272400,229542.2,592200
503100,456847.7,930650,229140,223999.8,338450,273960,232847.9,592200
502090,455553.7,930650,228700,222871.4,338450,273390,232682.3,592200
501150,430564,930650,228280,206912.7,338450,272870,223651.3,592200
500170,423192,930650,227840,206968.4,338450,272330,216223.6,592200
499190,430346.5,930650,227410,211515.6,338450,271780,218830.9,592200
498500,447369.6,930650,227250,218819.6,338450,271250,228550,592200
497760,446831,930650,227080,215289.1,338450,270680,231541.9,592200
497060,437066.4,930650,226930,212545.1,338450,270130,224521.3,592200
496390,429127.3,930650,226770,208512.6,338450,269620,220614.7,592200
495200,425487.1,930650,226460,204496.3,338450,268740,220990.8,592200
494080,432346.9,930650,226160,206871.3,338450,267920,225475.6,592200
492840,450264.7,930650,225850,221736.1,338450,266990,228528.6,592200
491700,500752.9,930650,225560,239089.4,338450,266140,261663.5,592200
491040,487803.5,930650,225870,232205.6,338450,265170,255597.9,592200
490350,468782.9,930650,226230,227202.4,338450,264120,241580.5,592200
489740,461087.6,930650,226580,229034.8,338450,263160,232052.8,592200
488990,472911.5,930650,226900,238507.4,338450,262090,234404.1,592200
489340,489954,930650,227350,250765.8,338450,261990,239188.2,592200
489650,515179.9,930650,227800,259890.4,338450,261850,255289.5,592200
490010,533333.3,930650,228250,261432.6,338450,261760,271900.7,592200
490250,527066.8,930650,228700,255512.6,338450,261550,271554.2,592200
489340,544222.5,930650,228790,259699.1,338450,260550,284523.4,592200
488340,554813.3,930650,228860,264287.5,338450,259480,290525.8,592200
487420,571152.2,930650,228950,269391.4,338450,258470,301760.8,592200
486420,563192.4,930650,229050,271045.9,338450,257370,292146.5,592200
484950,550867.5,930650,228930,264014.3,338450,256020,286853.2,592200
483430,544265,930650,228790,261729.9,338450,254640,282535.1,592200
481970,542941.6,930650,228680,259153.4,338450,253290,283788.2,592200
480430,524802.1,930650,228570,254918.4,338450,251860,269883.7,592200
478190,510183.6,930650,227960,250753.1,338450,250230,259430.5,592200
476020,509646.9,930650,227370,250209.9,338450,248650,259437,592200
473880,519238.9,930650,226810,254527.3,338450,247070,264711.6,592200
471710,510016.6,930650,226220,247369.6,338450,245490,262647,592200
469860,517546.8,930650,225750,247004.9,338450,244110,270541.9,592200
468070,533379.3,930650,225280,252954.8,338450,242790,280424.5,592200
466260,541121.7,930650,224820,263634.9,338450,241440,277486.8,592200
464480,525045.9,930650,224340,253829.6,338450,240140,271216.3,592200
463110,512674.5,930650,223280,245539.1,338450,239830,267135.4,592200
461720,523050.5,930650,222230,253023.1,338450,239490,270027.4,592200
460390,505752.6,930650,221180,240413.2,338450,239210,265339.4,592200
459050,501015.8,930650,220130,241490.8,338450,238920,259525,592200
456590,492448.8,930650,218470,238893.3,338450,238120,253555.5,592200
454110,484599.6,930650,216840,238645,338450,237270,245954.6,592200
451760,514962.6,930650,215200,244685.4,338450,236560,270277.2,592200
449350,503657.6,930650,213560,242970.8,338450,235790,260686.8,592200
447900,498172.8,930650,212650,240160.3,338450,235250,258012.5,592200
446450,500428.5,930650,211740,245425.6,338450,234710,255002.9,592200
445000,494731.9,930650,210810,242432.7,338450,234190,252299.2,592200
443530,468580.4,930650,209910,225997.5,338450,233620,242582.9,592200
439980,453483.9,930650,209260,215543.8,338450,230720,237940.1,592200
436390,433401.5,930650,208580,204668.1,338450,227810,228733.4,592200
432800,430008.8,930650,207940,207868.3,338450,224860,222140.5,592200
429220,431031.2,930650,207260,207510.9,338450,221960,223520.3,592200
424660,441230.9,930650,206270,210331,338450,218390,230899.9,592200
420120,417436.3,930650,205250,196671.9,338450,214870,220764.4,592200
415490,375887.7,930650,204220,180679.9,338450,211270,195207.8,592200
410980,360706.9,930650,203230,172466.2,338450,207750,188240.7,592200
406180,341504.5,930650,203000,166492.8,338450,203180,175011.7,592200
401580,329795.1,930650,202810,167218.4,338450,198770,162576.7,592200
396860,306460.6,930650,202610,156238,338450,194250,150222.6,592200
392140,305877.4,930650,202390,159188.1,338450,189750,146689.3,592200
386550,294925.3,930650,200750,158033.5,338450,185800,136891.8,592200
380950,313823.8,930650,199100,170943.4,338450,181850,142880.4,592200
375370,320520.7,930650,197460,178899.2,338450,177910,141621.5,592200
369730,317073.5,930650,195820,176826.8,338450,173910,140246.7,592200
364340,294570.1,930650,193570,162098,338450,170770,132472.1,592200
359010,275348.3,930650,191320,151678,338450,167690,123670.3,592200
353640,280036.7,930650,189070,156806,338450,164570,123230.7,592200
348340,287551.2,930650,186850,165703.8,338450,161490,121847.4,592200
342790,303008.8,930650,184550,176190.7,338450,158240,126818.1,592200
337300,308910.2,930650,182250,180641.2,338450,155050,128269,592200
331770,296749.7,930650,179960,172427.6,338450,151810,124322.1,592200
326320,280119.2,930650,177690,163284.3,338450,148630,116834.9,592200
321320,248109.5,930650,175110,156508,338450,146210,91601.5,592200
316430,246943.6,930650,172570,149051.3,338450,143860,97892.3,592200
311390,225618.4,930650,170000,145811,338450,141390,79807.4,592200
272280,248916.8,930650,157590,150591.2,338450,114690,98325.6,592200
266580,254248.9,930650,154610,149269.3,338450,111970,104979.6,592200
260940,253059.9,930650,151630,149184.6,338450,109310,103875.3,592200
255190,246697.2,930650,148630,144630.5,338450,106560,102066.7,592200
249510,255775.9,930650,145670,150391.9,338450,103840,105384,592200
243720,253547.7,930650,142520,147239.1,338450,101200,106308.6,592200
238050,248523.3,930650,139370,143006.8,338450,98680,105516.5,592200
232270,268142.8,930650,136220,153921.8,338450,96050,114221,592200
226470,267064.9,930650,133050,153559.9,338450,93420,113505,592200
224990,242617.1,930650,131900,137819.4,338450,93090,104797.7,592200
223540,222493.4,930650,130730,124632.8,338450,92810,97860.6,592200
222030,224288.7,930650,129570,125332.6,338450,92460,98956.1,592200
220530,220901.5,930650,128410,123019.2,338450,92120,97882.3,592200
219330,233394.7,930650,127590,130122.5,338450,91740,103272.2,592200
218090,233878.9,930650,126830,129941.1,338450,91260,103937.8,592200
216930,224572.4,930650,126030,124741.3,338450,90900,99831.1,592200
215680,227677.5,930650,125230,126477,338450,90450,101200.5,592200
214660,223436.9,930650,124480,123128.8,338450,90180,100308.1,592200
213580,221007.3,930650,123730,122145.2,338450,89850,98862.1,592200
212600,219197.3,930650,122990,121172.4,338450,89610,98024.9,592200
211540,216887.9,930650,122240,119708.5,338450,89300,97179.4,592200
212750,210352.3,930650,123370,116113.2,338450,89380,94239.1,592200
214020,202453.1,930650,124520,116174,338450,89500,86279.1,592200
215200,199430.2,930650,125670,117811.3,338450,89530,81618.9,592200
216510,224645.6,930650,126820,126298.4,338450,89690,98347.2,592200
217290,241209.6,930650,127380,136346.5,338450,89910,104863.1,592200
218110,244504,930650,127940,137809.6,338450,90170,106694.4,592200
218930,240327.7,930650,128520,136583.8,338450,90410,103743.9,592200
219770,231723.2,930650,129080,129466.9,338450,90690,102256.3,592200
220720,215534.3,930650,130160,123353.4,338450,90560,92180.9,592200
221650,207556.2,930650,131250,116769.3,338450,90400,90786.9,592200
222630,190688.7,930650,132320,106221.4,338450,90310,84467.3,592200
223570,182449.9,930650,133390,102553.8,338450,90180,79896.1,592200
220070,180633.9,930650,131200,101906.3,338450,88870,78727.6,592200
216600,187191.1,930650,129040,107604.6,338450,87560,79586.5,592200
213060,193858.7,930650,126810,112197,338450,86250,81661.7,592200
209590,188579.9,930650,124620,109855.6,338450,84970,78724.3,592200
207180,183300.6,930650,122690,106945,338450,84490,76355.6,592200
204730,197867.8,930650,120730,116319.7,338450,84000,81548.1,592200
202370,215502.7,930650,118810,126921.7,338450,83560,88581,592200
199960,211426.8,930650,116860,122531,338450,83100,88895.8,592200
198480,212417.3,930650,115210,121735.9,338450,83270,90681.4,592200
197050,221573.5,930650,113590,125292.4,338450,83460,96281.1,592200
195560,226969,930650,111920,127557.4,338450,83640,99411.6,592200
194110,218038.5,930650,110290,122275.4,338450,83820,95763.1,592200
193650,211960.7,930650,108290,115755.1,338450,85360,96205.6,592200
193120,209562.5,930650,106250,112976.8,338450,86870,96585.7,592200
192600,202422.4,930650,104250,107818.6,338450,88350,94603.8,592200
192120,197599,930650,102250,102864,338450,89870,94735,592200
191900,185417.5,930650,100840,93535.4,338450,91060,91882.1,592200
191650,178923.5,930650,99430,89339.5,338450,92220,89584,592200
191420,179897.7,930650,98030,86327,338450,93390,93570.7,592200
191140,170800,930650,96630,79508.6,338450,94510,91291.4,592200
190290,169281.7,930650,94970,74773.2,338450,95320,94508.5,592200
189460,170187.6,930650,93310,73906.4,338450,96150,96281.2,592200
188570,175917.8,930650,91660,73237,338450,96910,102680.8,592200
187770,171968.2,930650,90020,69031.2,338450,97750,102937,592200
190060,162465.8,930650,90060,61050.6,338450,100000,101415.2,592200
192280,160902.1,930650,90070,58415.5,338450,102210,102486.6,592200
194560,154917.2,930650,90120,55511.6,338450,104440,99405.6,592200
196840,159644.5,930650,90160,58333.9,338450,106680,101310.6,592200
199230,171342.5,930650,89940,68765.5,338450,109290,102577,592200
201670,170829.1,930650,89750,72207.1,338450,111920,98622,592200
204080,186151.9,930650,89520,78928.5,338450,114560,107223.4,592200
206510,189877.6,930650,89330,81778.3,338450,117180,108099.3,592200
209070,198950,930650,89300,82025.4,338450,119770,116924.6,592200
211650,212108.3,930650,89250,85547.4,338450,122400,126560.9,592200
214170,219338.9,930650,89250,85541,338450,124920,133797.9,592200
216810,219984.6,930650,89210,88129.6,338450,127600,131855,592200
216000,232746.4,930650,89520,92740.4,338450,126480,140006,592200
215220,243094.7,930650,89830,98566.5,338450,125390,144528.2,592200
214330,253286.3,930650,90140,105239.6,338450,124190,148046.7,592200
213670,243021.4,930650,90470,102898.9,338450,123200,140122.5,592200
211730,237741.3,930650,89660,98002.1,338450,122070,139739.2,592200
209800,230382.3,930650,88850,92752.9,338450,120950,137629.4,592200
207970,206986.1,930650,88060,93803.3,338450,119910,113182.8,592200
206060,185475.2,930650,87250,90072,338450,118810,95403.2,592200
203290,168856.3,930650,86060,80310.7,338450,117230,88545.6,592200
200500,163075,930650,84880,76395.2,338450,115620,86679.8,592200
197770,145526.4,930650,83700,71512.1,338450,114070,74014.3,592200
195020,133589.3,930650,82530,67227.4,338450,112490,66361.9,592200
189010,116098.8,930650,79700,57758.2,338450,109310,58340.6,592200
182980,110736.6,930650,76870,54375.9,338450,106110,56360.7,592200
177020,97517.1,930650,74060,46200.7,338450,102960,51316.4,592200
171040,91368.6,930650,71250,39559.3,338450,99790,51809.3,592200
164250,96521.2,930650,68020,39780.1,338450,96230,56741.1,592200
157470,104828.4,930650,64810,41415.3,338450,92660,63413.1,592200
150700,113058.5,930650,61600,42785.1,338450,89100,70273.4,592200
143870,111994.4,930650,58390,40883.7,338450,85480,71110.7,592200
137390,111294.7,930650,55510,40120.5,338450,81880,71174.2,592200
130830,105094.6,930650,52590,37140.7,338450,78240,67953.9,592200
124330,93613.1,930650,49690,31298.9,338450,74640,62314.2,592200
117770,93401.5,930650,46790,30416.6,338450,70980,62984.9,592200
113140,85645.8,930650,44220,27551.8,338450,68920,58094,592200
108530,82565.5,930650,41650,24898,338450,66880,57667.5,592200
103840,83229.3,930650,39100,23084.1,338450,64740,60145.2,592200
111360,89635.2,930650,39400,24520.7,338450,71960,65114.5,592200
107390,86048.5,930650,37100,21455.4,338450,70290,64593.1,592200
103410,81127.6,930650,34790,16650.5,338450,68620,64477.1,592200
99410,86062.7,930650,32480,15367.5,338450,66930,70695.2,592200
95500,89777.7,930650,30190,14590.7,338450,65310,75187,592200
91860,86286.6,930650,27990,11750.5,338450,63870,74536.1,592200
88170,90088.7,930650,25760,11736,338450,62410,78352.7,592200
84500,94150.8,930650,23550,13218,338450,60950,80932.8,592200
80800,95233,930650,21350,13783.4,338450,59450,81449.6,592200
78310,96729.9,930650,20560,14716.3,338450,57750,82013.6,592200
75810,99040.6,930650,19770,15055.5,338450,56040,83985.1,592200
73250,98342.5,930650,18960,14110.3,338450,54290,84232.2,592200
70760,98047.8,930650,18180,13074.3,338450,52580,84973.5,592200
68450,96257.3,930650,17430,12099.2,338450,51020,84158.1,592200
66100,96518.4,930650,16680,12585.7,338450,49420,83932.7,592200
63830,90566.9,930650,15920,12120.9,338450,47910,78446,592200
61480,88771.3,930650,15180,13234.6,338450,46300,75536.7,592200
59040,87818,930650,14340,13453,338450,44700,74365,592200
56530,83536.2,930650,13500,12707.3,338450,43030,70828.9,592200
54070,79554.6,930650,12650,11453.8,338450,41420,68100.8,592200
51590,72306.5,930650,11810,9173,338450,39780,63133.5,592200
51170,66091.3,930650,11820,7375,338450,39350,58716.3,592200
50820,59650.3,930650,11860,4902.8,338450,38960,54747.5,592200
50440,55900.7,930650,11870,4177.6,338450,38570,51723.1,592200
50040,54727.8,930650,11880,3958.1,338450,38160,50769.7,592200
49910,53071.3,930650,12120,3438.6,338450,37790,49632.7,592200
49790,52579.3,930650,12370,3322.5,338450,37420,49256.8,592200
49640,52122.7,930650,12590,3154.7,338450,37050,48968,592200
49520,52118.9,930650,12840,3660.6,338450,36680,48458.3,592200
49220,50568.1,930650,12910,2823.3,338450,36310,47744.8,592200
48870,51854.6,930650,12970,3314,338450,35900,48540.6,592200
48580,54676.7,930650,13060,3547.1,338450,35520,51129.6,592200
48290,56207.5,930650,13140,4904.4,338450,35150,51303.1,592200
45610,61496.2,930650,12190,7916,338450,33420,53580.2,592200
42950,68837.6,930650,11230,10610.2,338450,31720,58227.4,592200
40300,75690.2,930650,10290,11125.9,338450,30010,64564.3,592200
37640,79443.3,930650,9350,10656.9,338450,28290,68786.4,592200
35180,77485.2,930650,8490,7443.6,338450,26690,70041.6,592200
32610,61462.1,930650,7600,3894,338450,25010,57568.1,592200
30070,49058.3,930650,6730,2377.8,338450,23340,46680.5,592200
27590,47724.9,930650,5870,2225,338450,21720,45499.9,592200
24840,47286.4,930650,4870,2099,338450,19970,45187.4,592200
21970,45080.7,930650,3820,2114.9,338450,18150,42965.8,592200
19230,49726,930650,2780,2488.5,338450,16450,47237.5,592200
16400,51466.5,930650,1750,2638.5,338450,14650,48828,592200
15890,52139,930650,1720,2763.5,338450,14170,49375.5,592200
15450,51765.2,930650,1690,2763.5,338450,13760,49001.7,592200
14960,49511.9,930650,1640,2948,338450,13320,46563.9,592200
14500,50739.3,930650,1630,4138.6,338450,12870,46600.7,592200
13890,49510,930650,1610,3408.9,338450,12280,46101.1,592200
13300,49420.7,930650,1600,3379.2,338450,11700,46041.5,592200
12760,45868.6,930650,1600,2915,338450,11160,42953.6,592200
12230,45826.6,930650,1550,2999,338450,10680,42827.6,592200
11790,46552,930650,1610,3193.1,338450,10180,43358.9,592200
11270,47287.1,930650,1640,3673.6,338450,9630,43613.5,592200
10810,50102.3,930650,1690,5056.3,338450,9120,45046,592200
10350,53321.5,930650,1750,5904.6,338450,8600,47416.9,592200
11600,51179,930650,2540,5643.7,338450,9060,45535.3,592200
12870,57396.7,930650,3330,8582,338450,9540,48814.7,592200
14220,54070.5,930650,4120,6501.3,338450,10100,47569.2,592200
15470,53195.3,930650,4920,6818,338450,10550,46377.3,592200
16560,53421,930650,5650,7063.9,338450,10910,46357.1,592200
17620,58828,930650,6400,9084.1,338450,11220,49743.9,592200
18680,56256.2,930650,7140,7322.1,338450,11540,48934.1,592200
19740,56228.6,930650,7870,9344.2,338450,11870,46884.4,592200
21330,63289.3,930650,8900,13721.6,338450,12430,49567.7,592200
22940,64184,930650,9950,13771.6,338450,12990,50412.4,592200
24480,65330.7,930650,10990,13010.1,338450,13490,52320.6,592200
26040,68871.4,930650,12010,12941.3,338450,14030,55930.1,592200
33570,70068.9,930650,16190,13855.3,338450,17380,56213.6,592200
41110,78343.5,930650,20330,19245.2,338450,20780,59098.3,592200
48610,77337.7,930650,24470,19939.5,338450,24140,57398.2,592200
56130,84908.8,930650,28620,23731.3,338450,27510,61177.5,592200
63470,84444.8,930650,32830,25262.7,338450,30640,59182.1,592200
70890,92977.1,930650,37090,27950.4,338450,33800,65026.7,592200
78230,95324.8,930650,41300,29411.7,338450,36930,65913.1,592200
85630,102641.6,930650,45520,33368.2,338450,40110,69273.4,592200
93630,116492.8,930650,50210,39432.9,338450,43420,77059.9,592200
101640,133049,930650,54930,46973.6,338450,46710,86075.4,592200
109630,135064.6,930650,59600,49562.6,338450,50030,85502,592200
117650,154209.1,930650,64300,56337,338450,53350,97872.1,592200
127830,145112.8,930650,68050,60796.6,338450,59780,84316.2,592200
138010,176325,930650,71830,70956.7,338450,66180,105368.3,592200
148190,188041.4,930650,75590,78717.4,338450,72600,109324,592200
158430,221599.7,930650,79370,82301.8,338450,79060,139297.9,592200
167620,244718.2,930650,82680,90166.9,338450,84940,154551.3,592200
176790,226817.3,930650,86000,82150.5,338450,90790,144666.8,592200
185980,240146.9,930650,89300,93521.1,338450,96680,146625.8,592200
195120,244573.2,930650,92620,95830.3,338450,102500,148742.9,592200
204580,261144.9,930650,96050,105844.1,338450,108530,155300.8,592200
214090,267415.3,930650,99470,107410.5,338450,114620,160004.8,592200
223640,279435.9,930650,102920,105600.8,338450,120720,173835.1,592200
233120,293021.7,930650,106330,106459.1,338450,126790,186562.6,592200
235390,290304.2,930650,108630,107548.8,338450,126760,182755.4,592200
237790,275270.7,930650,110970,101235.7,338450,126820,174035,592200
240060,259180.2,930650,113280,94338.3,338450,126780,164841.9,592200
222220,266835.3,930650,96880,97730.1,338450,125340,169105.2,592200
222330,270366.5,930650,95970,97490.5,338450,126360,172876,592200
222460,274801.8,930650,95050,98194.1,338450,127410,176607.7,592200
222490,266187.1,930650,94140,94352.6,338450,128350,171834.5,592200
222610,235176.4,930650,93240,83688.5,338450,129370,151487.9,592200
222090,206012.7,930650,92680,75619,338450,129410,130393.7,592200
221580,194597.4,930650,92160,74641.2,338450,129420,119956.2,592200
221050,187608.4,930650,91600,76208,338450,129450,111400.4,592200
220550,201316.1,930650,91060,86931,338450,129490,114385.1,592200
217720,240937.4,930650,91720,102863.2,338450,126000,138074.2,592200
214910,258790.7,930650,92390,110686.8,338450,122520,148103.9,592200
212040,250527.8,930650,93020,107502.9,338450,119020,143024.9,592200
209230,251995.1,930650,93690,108903.3,338450,115540,143091.8,592200
206810,252163.6,930650,94740,114340.7,338450,112070,137822.9,592200
204460,261635.2,930650,95740,121810.7,338450,108720,139824.5,592200
201950,257900.9,930650,96780,121776.4,338450,105170,136124.5,592200
199580,259404.9,930650,97810,125482.7,338450,101770,133922.2,592200
196960,271447.9,930650,98120,135070.2,338450,98840,136377.7,592200
194280,288183.7,930650,98440,143525.6,338450,95840,144658.1,592200
191610,296842,930650,98750,148758.9,338450,92860,148083.1,592200
188960,318977.8,930650,99060,162791.4,338450,89900,156186.4,592200
191490,311990.6,930650,100760,164899,338450,90730,147091.6,592200
193900,279823.6,930650,102460,154265.4,338450,91440,125558.2,592200
196280,281717.5,930650,104180,152470.9,338450,92100,129246.6,592200
198790,323764.8,930650,105870,164908.8,338450,92920,158856,592200
202250,368848.7,930650,108250,187239.1,338450,94000,181609.6,592200
205670,382696.3,930650,110600,191516.9,338450,95070,191179.4,592200
209180,380444.2,930650,112970,186387.2,338450,96210,194057,592200
212650,316366.3,930650,115330,156972.8,338450,97320,159393.5,592200
216570,324802.1,930650,117350,149289.7,338450,99220,175512.4,592200
220480,321590.7,930650,119340,141180.8,338450,101140,180409.9,592200
224350,307234.4,930650,121340,136616.8,338450,103010,170617.6,592200
228290,304739.4,930650,123360,138909.9,338450,104930,165829.5,592200
231010,289641,930650,123840,140339.4,338450,107170,149301.6,592200
233660,270064.7,930650,124300,130268.5,338450,109360,139796.2,592200
236300,259152.3,930650,124770,121749.8,338450,111530,137402.5,592200
239010,251299.5,930650,125250,115578.9,338450,113760,135720.6,592200
238120,238900.1,930650,124760,111955.1,338450,113360,126945,592200
237300,229956.3,930650,124280,106886.2,338450,113020,123070.1,592200
236370,215705.9,930650,123820,94246,338450,112550,121459.9,592200
235530,210268.5,930650,123340,89111.2,338450,112190,121157.3,592200
231500,198127.8,930650,121320,82661.3,338450,110180,115466.5,592200
227440,202598.2,930650,119320,80730.1,338450,108120,121868.1,592200
223440,172536.7,930650,117310,75332.2,338450,106130,97204.5,592200
219350,150570.9,930650,115300,70031.1,338450,104050,80539.8,592200
217220,175153.7,930650,113240,78534.6,338450,103980,96619.1,592200
215040,150572,930650,111170,79848.2,338450,103870,70723.8,592200
212910,146470.3,930650,109110,77780,338450,103800,68690.3,592200
210780,129627.8,930650,107040,67618.3,338450,103740,62009.5,592200
208150,125264.1,930650,105170,65880.1,338450,102980,59384,592200
205600,123629,930650,103280,61823.5,338450,102320,61805.5,592200
202990,120586.5,930650,101410,56718.6,338450,101580,63867.9,592200
200380,104704.9,930650,99520,50782.9,338450,100860,53922,592200
198630,123108.7,930650,98350,53978.3,338450,100280,69130.4,592200
197010,103073.9,930650,97210,51362,338450,99800,51711.9,592200
195260,111334.6,930650,96080,57103.1,338450,99180,54231.5,592200
193560,107196.6,930650,94910,57777.7,338450,98650,49418.9,592200
188240,120140.8,930650,93410,67090.8,338450,94830,53050,592200
183010,131360.9,930650,91930,69999.4,338450,91080,61361.5,592200
177720,127525.3,930650,90430,69004.3,338450,87290,58521,592200
172410,123300,930650,88920,71926.7,338450,83490,51373.3,592200
167160,130343.2,930650,87730,72293.5,338450,79430,58049.7,592200
161950,141348.9,930650,86550,80394.1,338450,75400,60954.8,592200
156650,185886.4,930650,85360,103953.9,338450,71290,81932.5,592200
151340,203267.1,930650,84190,115997.5,338450,67150,87269.6,592200
145750,222651.6,930650,82720,122791.4,338450,63030,99860.2,592200
140150,240017.5,930650,81270,135705,338450,58880,104312.5,592200
134590,243237.2,930650,79830,136537.7,338450,54760,106699.5,592200
128960,221630.9,930650,78350,125266.6,338450,50610,96364.3,592200
127770,209687.1,930650,78690,118210,338450,49080,91477.1,592200
126590,209296.4,930650,79030,119485.7,338450,47560,89810.7,592200
125380,193425.9,930650,79320,110194.9,338450,46060,83231,592200
124180,186597.2,930650,79670,106683,338450,44510,79914.2,592200
123490,196360.7,930650,80120,113437.1,338450,43370,82923.6,592200
122820,186097.8,930650,80580,107397,338450,42240,78700.8,592200
122170,174720.7,930650,81020,100618.3,338450,41150,74102.4,592200
121430,169533.6,930650,81480,99227.6,338450,39950,70306,592200
120620,160150.2,930650,81730,94767.5,338450,38890,65382.7,592200
119760,159167,930650,81960,94617.6,338450,37800,64549.4,592200
118960,166734.2,930650,82200,99157.9,338450,36760,67576.3,592200
118130,163419.9,930650,82460,97398.7,338450,35670,66021.2,592200
118170,167293.3,930650,81970,99796,338450,36200,67497.3,592200
118180,196085.5,930650,81460,117013.7,338450,36720,79071.8,592200
118210,194066.9,930650,80970,115142.8,338450,37240,78924.1,592200
118220,183247.7,930650,80470,106761.7,338450,37750,76486,592200
118700,156616.6,930650,80160,89205.4,338450,38540,67411.2,592200
119240,130864.9,930650,79860,71422.1,338450,39380,59442.8,592200
119710,120041.9,930650,79560,64637.5,338450,40150,55404.4,592200
120200,137865.1,930650,79270,75614.7,338450,40930,62250.4,592200
120790,143160.4,930650,79090,79443.7,338450,41700,63716.7,592200
121310,118515.3,930650,78910,63352.1,338450,42400,55163.2,592200
121820,96792.6,930650,78750,46560,338450,43070,50232.6,592200
122350,84546.2,930650,78570,38646.6,338450,43780,45899.6,592200
122980,85576.3,930650,77790,39928.1,338450,45190,45648.2,592200
123690,84561.7,930650,77040,35839,338450,46650,48722.7,592200
124240,80156,930650,76260,31415.1,338450,47980,48740.9,592200
52070,82081.9,930650,33270,25240.9,338450,18800,56841,592200
54180,84098.1,930650,33900,24630.5,338450,20280,59467.6,592200
56420,88211.4,930650,34570,26002.3,338450,21850,62209.1,592200
58610,87779.6,930650,35200,26054.6,338450,23410,61725,592200
60830,85940.9,930650,35850,24368.2,338450,24980,61572.7,592200
62590,84254,930650,35870,22858.6,338450,26720,61395.4,592200
64280,87048.4,930650,35820,21504.6,338450,28460,65543.8,592200
65990,96995.7,930650,35810,23964.3,338450,30180,73031.4,592200
67760,105976.6,930650,35820,24994,338450,31940,80982.6,592200
73500,124637.6,930650,38280,32336.2,338450,35220,92301.4,592200
79260,130722.5,930650,40760,35420.6,338450,38500,95301.9,592200
85020,125966.4,930650,43230,31932.6,338450,41790,94033.8,592200
90810,127351.2,930650,45710,33330.4,338450,45100,94020.8,592200
96380,128741.6,930650,47730,33814.4,338450,48650,94927.2,592200
102050,124021.4,930650,49760,29891.2,338450,52290,94130.2,592200
107620,116417.5,930650,51770,28414.4,338450,55850,88003.1,592200
113280,122187.3,930650,53800,29267.7,338450,59480,92919.6,592200
120040,129004.4,930650,56450,32769.7,338450,63590,96234.7,592200
126880,144805.5,930650,59100,37541.1,338450,67780,107264.4,592200
133660,147690.8,930650,61780,37016.1,338450,71880,110674.7,592200
140410,165218,930650,64420,43924.5,338450,75990,121293.5,592200
153080,173019.6,930650,69860,46928.7,338450,83220,126090.9,592200
165690,168146.1,930650,75300,44846.3,338450,90390,123299.8,592200
178380,165132.4,930650,80730,44074.6,338450,97650,121057.8,592200
190930,159966.8,930650,86150,41848.6,338450,104780,118118.2,592200
202970,162288.9,930650,91490,45020.5,338450,111480,117268.4,592200
215010,174465.5,930650,96840,54156,338450,118170,120309.5,592200
227000,173537.9,930650,102170,54686.7,338450,124830,118851.2,592200
239000,170967.3,930650,107490,57627.7,338450,131510,113339.6,592200
250390,189435.1,930650,113010,65406.5,338450,137380,124028.6,592200
261780,203705.1,930650,118500,71699.3,338450,143280,132005.8,592200
273110,213256.2,930650,124020,79229.4,338450,149090,134026.8,592200
284560,210967.1,930650,129540,77073,338450,155020,133894.1,592200
288800,210662.7,930650,129760,77059.7,338450,159040,133603,592200
293080,211405.6,930650,130000,78032.7,338450,163080,133372.9,592200
297350,225211,930650,130230,88058.1,338450,167120,137152.9,592200
301640,223206.7,930650,130490,88778.1,338450,171150,134428.6,592200
306190,221274,930650,130350,86944.4,338450,175840,134329.6,592200
310700,251305.8,930650,130220,103321.7,338450,180480,147984.1,592200
315210,277187,930650,130060,114676.1,338450,185150,162510.9,592200
319740,255331.6,930650,129940,95729.5,338450,189800,159602.1,592200
324360,245396.1,930650,129200,89121.7,338450,195160,156274.4,592200
328960,241646.6,930650,128490,85920.9,338450,200470,155725.7,592200
333540,243079.1,930650,127750,86777.3,338450,205790,156301.8,592200
338140,225820.4,930650,127030,73132.9,338450,211110,152687.5,592200
338560,217940.1,930650,126400,65510.3,338450,212160,152429.8,592200
338990,207302.6,930650,125790,63608.2,338450,213200,143694.4,592200
339310,211651.8,930650,125150,60770.1,338450,214160,150881.7,592200
339720,221138.3,930650,124530,64049.5,338450,215190,157088.8,592200
340110,217893.3,930650,124100,59459.6,338450,216010,158433.7,592200
340600,215475.4,930650,123680,59174.5,338450,216920,156300.9,592200
341000,225896,930650,123230,60355.5,338450,217770,165540.5,592200
341480,246242.4,930650,122810,70512.1,338450,218670,175730.3,592200
340070,249115.8,930650,121440,70380.7,338450,218630,178735.1,592200
338670,220554.3,930650,120110,62055.1,338450,218560,158499.2,592200
337310,209625.5,930650,118740,49313.7,338450,218570,160311.8,592200
335870,161256.8,930650,117400,44512.5,338450,218470,116744.3,592200
322650,169894.4,930650,112540,49247.3,338450,210110,120647.1,592200
309490,184693.8,930650,107690,49751.7,338450,201800,134942.1,592200
296320,166717.7,930650,102860,44422.2,338450,193460,122295.5,592200
283060,172720.7,930650,98040,46420.5,338450,185020,126300.2,592200
272240,148288.8,930650,95050,36667.5,338450,177190,111621.3,592200
261490,136901.9,930650,92120,29505.7,338450,169370,107396.2,592200
250640,131902.9,930650,89150,29885.2,338450,161490,102017.7,592200
239870,133670.2,930650,86200,31096.3,338450,153670,102573.9,592200
230020,145837.2,930650,83000,41930.1,338450,147020,103907.1,592200
220170,155625.8,930650,79840,53409.4,338450,140330,102216.4,592200
210310,181206.8,930650,76670,69170.1,338450,133640,112036.7,592200
200500,179007.7,930650,73480,67905.3,338450,127020,111102.4,592200
202420,190867.6,930650,75100,63458.2,338450,127320,127409.4,592200
204380,198375.7,930650,76710,65517.7,338450,127670,132858,592200
206350,186760.4,930650,78320,70251.7,338450,128030,116508.7,592200
208270,216164,930650,79940,86245.2,338450,128330,129918.8,592200
207890,190366.2,930650,80020,77355.6,338450,127870,113010.6,592200
207450,175444,930650,80090,68645.2,338450,127360,106798.8,592200
207060,163329.5,930650,80170,58145.7,338450,126890,105183.8,592200
206630,175468.6,930650,80240,64217.1,338450,126390,111251.5,592200
205620,168753,930650,81340,55397.8,338450,124280,113355.2,592200
204650,182044.9,930650,82450,67309.8,338450,122200,114735.1,592200
203610,145080.9,930650,83550,47049.3,338450,120060,98031.6,592200
202640,121407.6,930650,84640,33629.5,338450,118000,87778.1,592200
198900,121980.1,930650,82400,34190.7,338450,116500,87789.4,592200
195240,118430.4,930650,80150,33803.1,338450,115090,84627.3,592200
191540,101674.1,930650,77900,30704.1,338450,113640,70970,592200
187860,104267.3,930650,75610,30443.3,338450,112250,73824,592200
182990,98758.2,930650,72500,27333.8,338450,110490,71424.4,592200
178020,94559.6,930650,69320,25591.6,338450,108700,68968,592200
173140,88030.7,930650,66190,22862.5,338450,106950,65168.2,592200
168250,85836.5,930650,63050,20870.5,338450,105200,64966,592200
162400,81499.7,930650,58500,17735.4,338450,103900,63764.3,592200
156500,75240.3,930650,53940,12937.5,338450,102560,62302.8,592200
150690,74303.1,930650,49400,11658.7,338450,101290,62644.4,592200
144870,77118.4,930650,44880,11218.4,338450,99990,65900,592200
147580,80085.2,930650,44470,9759.3,338450,103110,70325.9,592200
150400,83248.2,930650,44100,9891.4,338450,106300,73356.8,592200
153240,94331.7,930650,43720,12139.3,338450,109520,82192.4,592200
87720,110598.9,930650,28960,21146.3,338450,58760,89452.6,592200
92580,117118.2,930650,30060,25485.3,338450,62520,91632.9,592200
97490,124555.4,930650,31190,25855.6,338450,66300,98699.8,592200
102400,96225,930650,32300,20835.6,338450,70100,75389.4,592200
107370,110706.1,930650,33450,20353.7,338450,73920,90352.4,592200
113200,103718,930650,34770,18694.1,338450,78430,85023.9,592200
119130,80393.7,930650,36110,19626.2,338450,83020,60767.5,592200
125000,116847.2,930650,37470,24655.5,338450,87530,92191.7,592200
130930,121926,930650,38810,20968.4,338450,92120,100957.6,592200
133230,140837.7,930650,38790,26015.8,338450,94440,114821.9,592200
135550,147159,930650,38750,28939.4,338450,96800,118219.6,592200
137850,147708.8,930650,38730,24410.9,338450,99120,123297.9,592200
140210,149522.8,930650,38690,25761.6,338450,101520,123761.2,592200
142210,152712.8,930650,39170,26083.4,338450,103040,126629.4,592200
144250,157636.5,930650,39620,27381.5,338450,104630,130255,592200
146230,158815.4,930650,40090,33503.8,338450,106140,125311.6,592200
148280,179555.8,930650,40560,39839.1,338450,107720,139716.7,592200
149100,183753.7,930650,40180,41828,338450,108920,141925.7,592200
150000,180181.4,930650,39770,39146.5,338450,110230,141034.9,592200
150870,174269.8,930650,39390,31258.8,338450,111480,143011,592200
151630,158137.9,930650,38960,26654.9,338450,112670,131483,592200
153520,160793.9,930650,41120,30778.2,338450,112400,130015.7,592200
155470,174274.9,930650,43290,37761.5,338450,112180,136513.4,592200
157350,158802,930650,45450,34695.9,338450,111900,124106.1,592200
159230,175520,930650,47600,42288.5,338450,111630,133231.5,592200
160340,202514.2,930650,49330,57488.6,338450,111010,145025.6,592200
161500,242446,930650,51070,80174.9,338450,110430,162271.1,592200
162670,266775.1,930650,52820,92709.4,338450,109850,174065.7,592200
163780,307151.7,930650,54560,117184.6,338450,109220,189967.1,592200
163310,328866.7,930650,55280,126600.1,338450,108030,202266.6,592200
162760,310520.5,930650,56000,115097.6,338450,106760,195422.9,592200
162300,304881.8,930650,56720,109061.1,338450,105580,195820.7,592200
161770,300509.8,930650,57430,107380.5,338450,104340,193129.3,592200
167890,294194.9,930650,58310,99084,338450,109580,195110.9,592200
174010,281581.2,930650,59210,85109.6,338450,114800,196471.6,592200
180110,291214.2,930650,60090,88390.8,338450,120020,202823.4,592200
186280,307613,930650,60970,88760.2,338450,125310,218852.8,592200
191440,314385.8,930650,61670,95099.9,338450,129770,219285.9,592200
196680,289499.1,930650,62380,87662.5,338450,134300,201836.6,592200
201950,276258.1,930650,63120,86737.9,338450,138830,189520.2,592200
207140,261273.3,930650,63820,83260.5,338450,143320,178012.8,592200
213150,256130.9,930650,65410,79906.9,338450,147740,176224,592200
219280,228492.6,930650,67040,70392.2,338450,152240,158100.4,592200
225260,225058,930650,68610,67001.4,338450,156650,158056.6,592200
231290,228815.1,930650,70190,66783,338450,161100,162032.1,592200
232380,229265.4,930650,69430,60574.5,338450,162950,168690.9,592200
233410,205833.8,930650,68670,48073.9,338450,164740,157759.9,592200
234430,187332,930650,67890,37841.1,338450,166540,149490.9,592200
235530,196024.8,930650,67120,38187.3,338450,168410,157837.5,592200
237190,202081.4,930650,66820,36781.2,338450,170370,165300.2,592200
238880,191235.7,930650,66520,39845,338450,172360,151390.7,592200
240580,188726.1,930650,66210,39287.6,338450,174370,149438.5,592200
242320,204405.5,930650,65920,43601,338450,176400,160804.5,592200
244020,194153.3,930650,65130,39335.1,338450,178890,154818.2,592200
245680,183741.8,930650,64350,32997.2,338450,181330,150744.6,592200
247350,167533.2,930650,63590,25160.5,338450,183760,142372.7,592200
249080,177936.7,930650,62790,24583.9,338450,186290,153352.8,592200
243220,188904.2,930650,61320,32406,338450,181900,156498.2,592200
237430,196693,930650,59850,34574.4,338450,177580,162118.6,592200
231610,192725.3,930650,58340,32491.4,338450,173270,160233.9,592200
225760,178780.9,930650,56860,25766.3,338450,168900,153014.6,592200
218760,155701.1,930650,54300,20820.3,338450,164460,134880.8,592200
211820,152444.5,930650,51740,22081.7,338450,160080,130362.8,592200
204870,150523.4,930650,49170,19146.5,338450,155700,131376.9,592200
197960,148743.8,930650,46620,16016.6,338450,151340,132727.2,592200
191500,141043.5,930650,44590,17055.8,338450,146910,123987.7,592200
185110,140807.8,930650,42560,17097.4,338450,142550,123710.4,592200
178790,120143.7,930650,40580,13505.1,338450,138210,106638.6,592200
172370,103061,930650,38520,8058.6,338450,133850,95002.4,592200
161840,92854.4,930650,36110,6194,338450,125730,86660.4,592200
151210,87839,930650,33730,4754.2,338450,117480,83084.8,592200
140530,79920,930650,31280,3922,338450,109250,75998,592200
129960,76825.6,930650,28870,2974.7,338450,101090,73850.9,592200
119630,69843.8,930650,26570,2476.5,338450,93060,67367.3,592200
109310,65010.9,930650,24280,1858.2,338450,85030,63152.7,592200
99030,60867.6,930650,21960,1909.8,338450,77070,58957.8,592200
88760,57956.7,930650,19660,1493.1,338450,69100,56463.6,592200
78900,57058.4,930650,17360,1733.4,338450,61540,55325,592200
69110,64257.9,930650,15080,7673.1,338450,54030,56584.8,592200
59270,67208.9,930650,12800,9935.3,338450,46470,57273.6,592200
49480,70853.4,930650,10520,11645,338450,38960,59208.4,592200
71990,76673.4,930650,20250,14135.5,338450,51740,62537.9,592200
94500,93057,930650,30030,19870.2,338450,64470,73186.8,592200
117070,109784.9,930650,39800,28457.3,338450,77270,81327.6,592200
139580,122817.1,930650,49540,34135.5,338450,90040,88681.6,592200
164010,153045.9,930650,60410,48880.4,338450,103600,104165.5,592200
188440,197325.5,930650,71260,72806.7,338450,117180,124518.8,592200
212840,227526,930650,82100,87356.4,338450,130740,140169.6,592200
237180,254198.4,930650,92930,102645.5,338450,144250,151552.9,592200
261980,279389,930650,103900,117211,338450,158080,162178,592200
286700,274272.7,930650,114870,113074.2,338450,171830,161198.5,592200
311430,306900.3,930650,125830,129152.7,338450,185600,177747.6,592200
336080,317028.3,930650,136780,131598.8,338450,199300,185429.5,592200
356630,371779.8,930650,144370,162237.9,338450,212260,209541.9,592200
377170,416850.7,930650,152000,186975.5,338450,225170,229875.2,592200
397690,418402.7,930650,159570,193324.4,338450,238120,225078.3,592200
286300,418243.3,930650,126420,199820.2,338450,159880,218423.1,592200
304710,428813.4,930650,133990,205421,338450,170720,223392.4,592200
323200,438968.2,930650,141550,206316.6,338450,181650,232651.6,592200
341600,437068.7,930650,149110,202885.2,338450,192490,234183.5,592200
360020,464338,930650,156660,214510,338450,203360,249828,592200
378090,483863.3,930650,164350,224015.8,338450,213740,259847.5,592200
396210,528210.3,930650,172030,239971.4,338450,224180,288238.9,592200
414310,556650.5,930650,179700,251159.4,338450,234610,305491.1,592200
432350,562257.8,930650,187370,254602.7,338450,244980,307655.1,592200
434970,570828,930650,185330,254592.9,338450,249640,316235.1,592200
437630,600851.3,930650,183290,259664.8,338450,254340,341186.5,592200
440190,608737.2,930650,181240,265058.8,338450,258950,343678.4,592200
442780,600163,930650,179160,255646.9,338450,263620,344516.1,592200
445460,620460.5,930650,176890,254609.4,338450,268570,365851.1,592200
448040,597516.1,930650,174650,242997.4,338450,273390,354518.7,592200
450660,596264.6,930650,172380,244101.5,338450,278280,352163.1,592200
453300,619654,930650,170110,250430.9,338450,283190,369223.1,592200
456580,633315.1,930650,168920,254840.6,338450,287660,378474.5,592200
459860,634408,930650,167740,259357.8,338450,292120,375050.2,592200
463160,644713.5,930650,166570,253379.5,338450,296590,391334,592200
466490,663438.4,930650,165400,258225.8,338450,301090,405212.6,592200
477400,628842.3,930650,172560,233842.6,338450,304840,394999.7,592200
488380,569198,930650,179720,199648.2,338450,308660,369549.8,592200
499330,524636,930650,186880,177626.2,338450,312450,347009.8,592200
510250,509655.6,930650,194030,167625.5,338450,316220,342030.1,592200
520200,487684.4,930650,200020,153149.6,338450,320180,334534.8,592200
530000,463308.1,930650,206010,136983.1,338450,323990,326325,592200
539880,456986.9,930650,211960,128297.1,338450,327920,328689.8,592200
549740,481375.7,930650,217940,142125.8,338450,331800,339249.9,592200
561330,553016.9,930650,224460,179185.5,338450,336870,373831.4,592200
572970,601099.6,930650,230980,209840.4,338450,341990,391259.2,592200
584540,640035.7,930650,237510,239514.4,338450,347030,400521.3,592200
596160,719630,930650,244000,281992.7,338450,352160,437637.3,592200
604260,752843.7,930650,246470,298309.2,338450,357790,454534.5,592200
612340,746998.3,930650,248960,296270.7,338450,363380,450727.6,592200
620440,731104.6,930650,251430,293224.7,338450,369010,437879.9,592200
628550,715695.4,930650,253890,288170.8,338450,374660,427524.6,592200
635980,707757.3,930650,255980,273542,338450,380000,434215.3,592200
643360,731949.5,930650,258050,276521.9,338450,385310,455427.6,592200
650780,706683,930650,260120,259853.9,338450,390660,446829.1,592200
658180,670337.7,930650,262190,247485.4,338450,395990,422852.3,592200
664570,661649.1,930650,263260,222697.7,338450,401310,438951.4,592200
670920,657930.6,930650,264330,215737.8,338450,406590,442192.8,592200
677320,617675.1,930650,265410,212481.1,338450,411910,405194,592200
683670,647967.1,930650,266480,232798.2,338450,417190,415168.9,592200
682500,666592.1,930650,266660,241845.8,338450,415840,424746.3,592200
681290,671608.3,930650,266820,246819.2,338450,414470,424789.1,592200
680150,669390.6,930650,267010,253541.1,338450,413140,415849.5,592200
678940,690414.5,930650,267180,265634.8,338450,411760,424779.7,592200
679590,696023,930650,267670,266152.8,338450,411920,429870.2,592200
680230,700826.2,930650,268210,262913.2,338450,412020,437913,592200
680840,706232.7,930650,268690,264580.8,338450,412150,441651.9,592200
681470,723887.9,930650,269200,281490.6,338450,412270,442397.3,592200
681070,708542.9,930650,268820,269588.6,338450,412250,438954.3,592200
680650,662083.4,930650,268430,237633.3,338450,412220,424450.1,592200
680250,616779.9,930650,268040,212732.5,338450,412210,404047.4,592200
679800,626569.7,930650,267650,225396.7,338450,412150,401173,592200
659960,633382.9,930650,262680,240808.7,338450,397280,392574.2,592200
640090,558847.2,930650,257710,205761.7,338450,382380,353085.5,592200
620170,434429.7,930650,252730,137708.1,338450,367440,296721.6,592200
600340,401880.8,930650,247770,123283.7,338450,352570,278597.1,592200
579040,394306.8,930650,242550,117966.5,338450,336490,276340.3,592200
557750,391196.2,930650,237320,120552.2,338450,320430,270644,592200
536480,392833.7,930650,232100,131357.8,338450,304380,261475.9,592200
515180,358672.5,930650,226890,128260.3,338450,288290,230412.2,592200
494390,304976,930650,221910,106876,338450,272480,198100,592200
473480,249435.7,930650,216900,83972.4,338450,256580,165463.3,592200
452590,222162.6,930650,211890,75832.9,338450,240700,146329.7,592200
431740,200628.6,930650,206880,72421.4,338450,224860,128207.2,592200
416900,187648.9,930650,201180,58650.8,338450,215720,128998.1,592200
402060,163858.5,930650,195470,58619.3,338450,206590,105239.2,592200
387200,154112.8,930650,189780,58224,338450,197420,95888.8,592200
372330,143664.8,930650,184060,54994.5,338450,188270,88670.3,592200
356750,134905.6,930650,179040,43544.6,338450,177710,91361,592200
341200,100882.8,930650,174010,29340.5,338450,167190,71542.3,592200
325660,109360.9,930650,169000,26076.8,338450,156660,83284.1,592200
310080,94501,930650,163950,25607.4,338450,146130,68893.6,592200
293910,85640.1,930650,158920,27734,338450,134990,57906.1,592200
277760,67442.1,930650,153900,20969.7,338450,123860,46472.4,592200
261670,61424.6,930650,148880,19858,338450,112790,41566.6,592200
245510,58155.7,930650,143860,19549.3,338450,101650,38606.4,592200
244840,57188.6,930650,144110,19944.2,338450,100730,37244.4,592200
244190,54438.9,930650,144400,20011.5,338450,99790,34427.4,592200
243510,52546.8,930650,144650,19937.3,338450,98860,32609.5,592200
242830,56433,930650,144920,20816.3,338450,97910,35616.7,592200
243180,54989.9,930650,144870,21079.4,338450,98310,33910.5,592200
243440,55572.8,930650,144800,21147.1,338450,98640,34425.7,592200
243750,57904.2,930650,144740,20419.1,338450,99010,37485.1,592200
244000,56436.5,930650,144660,20276,338450,99340,36160.5,592200
245620,55249.1,930650,145560,20401,338450,100060,34848.1,592200
247150,54643.2,930650,146410,20476,338450,100740,34167.2,592200
248700,53561.6,930650,147300,20486.7,338450,101400,33074.9,592200
250280,53646.7,930650,148140,20739.5,338450,102140,32907.2,592200
258990,55056.3,930650,150760,21043.6,338450,108230,34012.7,592200
267570,56155.1,930650,153380,20799.7,338450,114190,35355.4,592200
276330,59515.4,930650,156010,22530,338450,120320,36985.4,592200
64650,56435.1,930650,25260,8345.1,338450,39390,48090,592200
70230,57311.4,930650,28390,6680.1,338450,41840,50631.3,592200
75780,59729.7,930650,31510,8988.9,338450,44270,50740.8,592200
81330,66963.4,930650,34630,9901.1,338450,46700,57062.3,592200
86920,69491.1,930650,37780,8134.7,338450,49140,61356.4,592200
92900,77189.5,930650,41050,10146.9,338450,51850,67042.6,592200
98850,72823.6,930650,44310,7051.5,338450,54540,65772.1,592200
104810,77386.3,930650,47570,9700.4,338450,57240,67685.9,592200
110890,84689.3,930650,50870,18844,338450,60020,65845.3,592200
126280,96916.5,930650,59020,26638.6,338450,67260,70277.9,592200
141790,108353.6,930650,67180,30162.2,338450,74610,78191.4,592200
157290,117679.4,930650,75330,35560.4,338450,81960,82119,592200
172750,131542.8,930650,83480,38130.4,338450,89270,93412.4,592200
188960,133816.7,930650,91750,35644.3,338450,97210,98172.4,592200
205280,140292.4,930650,100060,36513.2,338450,105220,103779.2,592200
221520,145707.6,930650,108340,37988.1,338450,113180,107719.5,592200
237820,167327,930650,116620,41110.1,338450,121200,126216.9,592200
254710,180275.1,930650,125580,54620.7,338450,129130,125654.4,592200
271510,183962.1,930650,134490,60612.9,338450,137020,123349.2,592200
288440,150136.2,930650,143410,64085.5,338450,145030,86050.7,592200
305310,152957.4,930650,152330,72217.2,338450,152980,80740.2,592200
315060,159958.6,930650,153830,82350.8,338450,161230,77607.8,592200
324860,199002.9,930650,155330,105221.4,338450,169530,93781.5,592200
334630,227002.4,930650,156820,115632.6,338450,177810,111369.8,592200
344370,247159.5,930650,158320,117154.2,338450,186050,130005.3,592200
353590,284536.6,930650,159560,131636.2,338450,194030,152900.4,592200
362850,308489.5,930650,160820,133355.1,338450,202030,175134.4,592200
372030,363497.6,930650,162050,157772.3,338450,209980,205725.3,592200
381220,398663.7,930650,163300,177280,338450,217920,221383.7,592200
390230,437001.4,930650,164720,193095.6,338450,225510,243905.8,592200
399320,451402.6,930650,166180,187702.9,338450,233140,263699.7,592200
408290,488431,930650,167600,197940.3,338450,240690,290490.7,592200
417310,565682.3,930650,169040,236659.3,338450,248270,329023,592200
438790,582661.7,930650,175830,236789.9,338450,262960,345871.8,592200
460190,606196.5,930650,182600,249714,338450,277590,356482.5,592200
481690,636396.7,930650,189390,264215.6,338450,292300,372181.1,592200
503110,661365.7,930650,196170,273318.5,338450,306940,388047.2,592200
525020,610273.3,930650,204000,238451.8,338450,321020,371821.5,592200
547000,606645.8,930650,211870,233002.7,338450,335130,373643.1,592200
568930,675174.8,930650,219720,267915.6,338450,349210,407259.2,592200
590880,681380.9,930650,227570,274725.1,338450,363310,406655.8,592200
610300,689870.5,930650,234510,277895.7,338450,375790,411974.8,592200
629680,681565.1,930650,241450,275512.2,338450,388230,406052.9,592200
649070,669673.6,930650,248410,269437.4,338450,400660,400236.2,592200
668480,690502.2,930650,255380,278680.5,338450,413100,411821.7,592200
666740,624294.3,930650,254840,237245.9,338450,411900,387048.4,592200
664970,577088,930650,254320,208950.7,338450,410650,368137.3,592200
663220,565030.9,930650,253780,204662.9,338450,409440,360368,592200
661490,608965.6,930650,253300,212959,338450,408190,396006.6,592200
660960,639760.2,930650,253380,230316,338450,407580,409444.2,592200
660540,692036.8,930650,253480,265357.9,338450,407060,426678.9,592200
660040,725968.7,930650,253570,287223.8,338450,406470,438744.9,592200
659560,757651.1,930650,253700,292855.5,338450,405860,464795.6,592200
657730,730690.9,930650,252520,276432.8,338450,405210,454258.1,592200
656020,733593.7,930650,251360,283193.9,338450,404660,450399.8,592200
654220,753679.9,930650,250180,287009.2,338450,404040,466670.7,592200
652490,744559.2,930650,249010,284417.1,338450,403480,460142.1,592200
648860,737691.5,930650,247750,285915,338450,401110,451776.5,592200
645230,753286,930650,246430,290040.3,338450,398800,463245.7,592200
641620,734248.1,930650,245130,269999.4,338450,396490,464248.7,592200
638020,771192.9,930650,243840,285215.4,338450,394180,485977.5,592200
634570,780784.4,930650,243260,296588.2,338450,391310,484196.2,592200
631260,813632.1,930650,242700,310103.7,338450,388560,503528.4,592200
627850,795353.8,930650,242110,302239.1,338450,385740,493114.7,592200
624550,765456.4,930650,241530,281458.3,338450,383020,483998.1,592200
619830,758193.5,930650,240550,278007.7,338450,379280,480185.8,592200
614980,767633.6,930650,239560,283544.5,338450,375420,484089.1,592200
610270,687472.4,930650,238550,246704,338450,371720,440768.4,592200
605420,709028.6,930650,237560,263837,338450,367860,445191.6,592200
600870,697704.8,930650,238800,279913.7,338450,362070,417791.1,592200
596310,673208.6,930650,240010,275511,338450,356300,397697.6,592200
591830,650670.8,930650,241240,265989.7,338450,350590,384681.1,592200
587230,639653.2,930650,242470,259989.7,338450,344760,379663.5,592200
580510,598633.6,930650,242190,250962.9,338450,338320,347670.7,592200
573740,600441.5,930650,241900,252520.1,338450,331840,347921.4,592200
567050,608164.9,930650,241640,265858,338450,325410,342306.9,592200
560250,592167,930650,241350,263247.3,338450,318900,328919.7,592200
550880,597027,930650,239520,255512.2,338450,311360,341514.8,592200
541410,575016.2,930650,237670,242708.1,338450,303740,332308.1,592200
531990,567621.1,930650,235820,237064.4,338450,296170,330556.7,592200
522540,596113.1,930650,233990,255355.5,338450,288550,340757.6,592200
525610,642685.1,930650,234280,283048,338450,291330,359637.1,592200
528780,691757.8,930650,234600,299534.5,338450,294180,392223.3,592200
531740,663451.1,930650,234900,273069.8,338450,296840,390381.3,592200
534860,679401.5,930650,235210,283637.6,338450,299650,395763.9,592200
541380,690014.1,930650,236790,286606.6,338450,304590,403407.5,592200
547880,648133.6,930650,238390,275489.6,338450,309490,372644,592200
554460,640320.6,930650,239980,271739.8,338450,314480,368580.8,592200
560960,634036.6,930650,241590,259550.7,338450,319370,374485.9,592200
568660,600830.3,930650,244200,244421,338450,324460,356409.3,592200
576400,632759.7,930650,246820,251083.2,338450,329580,381676.5,592200
584130,661328.1,930650,249450,263800.1,338450,334680,397528,592200
591840,666194.2,930650,252080,266578.2,338450,339760,399616,592200
589290,649480.5,930650,246230,246694.3,338450,343060,402786.2,592200
586740,616513.8,930650,240400,227984.6,338450,346340,388529.2,592200
584110,611492.1,930650,234560,220162,338450,349550,391330.1,592200
573290,600751.8,930650,211820,201119.3,338450,361470,399632.5,592200
568150,577518.5,930650,209210,188809.1,338450,358940,388709.4,592200
563080,613389,930650,206620,211688.8,338450,356460,401700.2,592200
557930,628834.2,930650,204010,229996.2,338450,353920,398838,592200
552790,629903.7,930650,201410,233782,338450,351380,396121.7,592200
548920,588866.3,930650,199870,212259,338450,349050,376607.3,592200
545030,573086.1,930650,198310,206404.6,338450,346720,366681.5,592200
541160,570707.5,930650,196780,194835.7,338450,344380,375871.8,592200
537310,550798.5,930650,195270,182921,338450,342040,367877.5,592200
527050,537090.7,930650,192510,175042.5,338450,334540,362048.2,592200
516760,483688.2,930650,189760,145798.8,338450,327000,337889.4,592200
506530,474182.2,930650,187000,140492.1,338450,319530,333690.1,592200
496270,494354.5,930650,184260,155959.7,338450,312010,338394.8,592200
484240,495437.9,930650,180380,162309.9,338450,303860,333128,592200
472310,502994.5,930650,176530,174114.2,338450,295780,328880.3,592200
460300,527374.6,930650,172660,190635.1,338450,287640,336739.5,592200
448240,499754.9,930650,168770,177648.5,338450,279470,322106.4,592200
436890,483618.3,930650,165300,174439.6,338450,271590,309178.7,592200
425510,459856.2,930650,161860,168667.1,338450,263650,291189.1,592200
414180,475483.3,930650,158390,171504.9,338450,255790,303978.4,592200
402690,506153.2,930650,154910,179430.2,338450,247780,326723,592200
394880,474500.4,930650,152250,170481.3,338450,242630,304019.1,592200
387070,441024,930650,149570,159714.1,338450,237500,281309.9,592200
379210,418967.8,930650,146890,152043.2,338450,232320,266924.6,592200
371340,408405.7,930650,144210,146318.4,338450,227130,262087.3,592200
363790,396080.4,930650,141810,143313.9,338450,221980,252766.5,592200
356270,384115.2,930650,139430,141214.2,338450,216840,242901,592200
348760,367638,930650,137060,130244,338450,211700,237394,592200
341240,375547.3,930650,134690,127265.7,338450,206550,248281.6,592200
333510,340790.3,930650,132740,111358.8,338450,200770,229431.5,592200
325830,347473,930650,130810,116896.2,338450,195020,230576.8,592200
318130,308257.4,930650,128860,104258.2,338450,189270,203999.2,592200
310440,332988.9,930650,126950,130892.5,338450,183490,202096.4,592200
309960,312757.1,930650,126900,124307.2,338450,183060,188449.9,592200
309360,306298.1,930650,126840,119383.5,338450,182520,186914.6,592200
308880,294878.2,930650,126800,115378.7,338450,182080,179499.5,592200
308330,317799.3,930650,126770,125059.3,338450,181560,192740,592200
308680,319133.5,930650,126810,116949.9,338450,181870,202183.6,592200
309040,305679.6,930650,126890,114913.6,338450,182150,190766,592200
309390,302358.5,930650,126950,109283.6,338450,182440,193074.9,592200
309670,341816.7,930650,127000,136915.2,338450,182670,204901.5,592200
310080,377719.5,930650,126440,155849.1,338450,183640,221870.4,592200
310480,409149.2,930650,125860,176686.4,338450,184620,232462.8,592200
310880,398746.7,930650,125310,163679.9,338450,185570,235066.8,592200
311290,383316.9,930650,124760,149429.9,338450,186530,233887,592200
311290,392599.6,930650,122310,144613.1,338450,188980,247986.5,592200
311350,402936.6,930650,119850,144621.6,338450,191500,258315,592200
311410,472848,930650,117400,163772.2,338450,194010,309075.8,592200
311340,469691.1,930650,114920,162938.1,338450,196420,306753,592200
310300,440664.7,930650,112480,151449.3,338450,197820,289215.4,592200
309340,405541.2,930650,110060,135381.6,338450,199280,270159.6,592200
308260,432935,930650,107600,151165.3,338450,200660,281769.7,592200
307240,426679.8,930650,105150,140532.9,338450,202090,286146.9,592200
306980,446788.4,930650,103100,156606.1,338450,203880,290182.3,592200
306640,410606.4,930650,101060,132956.6,338450,205580,277649.8,592200
306320,356762.5,930650,99000,105599.5,338450,207320,251163,592200
305960,366357,930650,96950,107877,338450,209010,258480,592200
302540,343025.8,930650,94550,85365.9,338450,207990,257659.9,592200
299070,319293.4,930650,92130,78684.9,338450,206940,240608.5,592200
295560,324872.4,930650,89720,76044.3,338450,205840,248828.1,592200
292060,328933,930650,87270,78231.1,338450,204790,250701.9,592200
291180,336277.3,930650,85350,74969.1,338450,205830,261308.2,592200
290140,331082.7,930650,83390,70703.6,338450,206750,260379.1,592200
289240,336630.4,930650,81480,78322,338450,207760,258308.4,592200
288290,343181.4,930650,79530,78197.3,338450,208760,264984.1,592200
285740,350408.5,930650,76060,82881.9,338450,209680,267526.6,592200
283150,354943.1,930650,72570,81598.8,338450,210580,273344.3,592200
280650,395126.7,930650,69080,96922.3,338450,211570,298204.4,592200
278120,432876.9,930650,65600,114428.9,338450,212520,318448,592200
290510,432028.7,930650,75760,116565,338450,214750,315463.7,592200
303000,533365,930650,85900,174998.3,338450,217100,358366.7,592200
315420,556055.5,930650,96070,204251.5,338450,219350,351804,592200
327830,537768.3,930650,106240,201760.9,338450,221590,336007.4,592200
343000,599292.1,930650,118500,229447.1,338450,224500,369845,592200
358210,568460.2,930650,130780,218901.9,338450,227430,349558.3,592200
373430,534989.8,930650,143080,207819.6,338450,230350,327170.2,592200
388600,550472.8,930650,155360,216519.2,338450,233240,333953.6,592200
402260,523362,930650,165880,204744.7,338450,236380,318617.3,592200
415890,522590,930650,176410,227781.1,338450,239480,294808.9,592200
429600,522121.6,930650,186940,239424.5,338450,242660,282697.1,592200
443220,530651.2,930650,197470,248204.1,338450,245750,282447.1,592200
451390,549340.2,930650,201260,254318,338450,250130,295022.2,592200
459630,568498.6,930650,205080,257998.6,338450,254550,310500,592200
467840,577971.2,930650,208870,256823.7,338450,258970,321147.5,592200
476060,585466.9,930650,212690,262296.8,338450,263370,323170.1,592200
484890,592760,930650,216870,262658.3,338450,268020,330101.7,592200
493730,602746.2,930650,221030,265687.4,338450,272700,337058.8,592200
502490,619334.6,930650,225240,276699.4,338450,277250,342635.2,592200
511350,636965.1,930650,229400,288579.4,338450,281950,348385.7,592200
520010,654088.9,930650,233490,291621.2,338450,286520,362467.7,592200
528660,661305.8,930650,237520,294351.2,338450,291140,366954.6,592200
537230,664837,930650,241580,293384.6,338450,295650,371452.4,592200
545930,671999.9,930650,245660,296040.9,338450,300270,375959,592200
546990,676557.1,930650,246160,300281.1,338450,300830,376276,592200
548060,680212.8,930650,246680,296614,338450,301380,383598.8,592200
549130,664621.7,930650,247210,294762.1,338450,301920,369859.6,592200
573640,676737,930650,256360,299822.8,338450,317280,376914.2,592200
572550,672683.4,930650,256440,294832.8,338450,316110,377850.6,592200
571420,677022.4,930650,256500,298627.8,338450,314920,378394.6,592200
570240,679005.6,930650,256560,301496.8,338450,313680,377508.8,592200
569090,672861.9,930650,256620,296196.6,338450,312470,376665.3,592200
567590,647193.2,930650,256520,283697.8,338450,311070,363495.4,592200
565880,630577.2,930650,256370,271248.8,338450,309510,359328.4,592200
564350,606026.8,930650,256260,263256.2,338450,308090,342770.6,592200
562780,603084.5,930650,256130,264397.5,338450,306650,338687,592200
559210,591608.6,930650,255230,260699.8,338450,303980,330908.8,592200
555640,593748.8,930650,254340,261157.3,338450,301300,332591.5,592200
552120,579642.5,930650,253460,254323.1,338450,298660,325319.4,592200
548520,582530.3,930650,252560,248631,338450,295960,333899.3,592200
545060,576816.8,930650,251430,249538.5,338450,293630,327278.3,592200
541590,591655.8,930650,250290,261072.8,338450,291300,330583,592200
538210,603591.2,930650,249160,268345.7,338450,289050,335245.5,592200
534760,601783.6,930650,248040,264390.9,338450,286720,337392.7,592200
530630,610093.5,930650,245710,262087.6,338450,284920,348005.9,592200
526500,614202.1,930650,243420,269030.4,338450,283080,345171.7,592200
522320,603387.3,930650,241080,267311.1,338450,281240,336076.2,592200
518270,587469,930650,238780,265091.4,338450,279490,322377.6,592200
514430,577609,930650,238110,267464.9,338450,276320,310144.1,592200
510490,565939.2,930650,237470,266742.6,338450,273020,299196.6,592200
506670,523565.2,930650,236810,244771.4,338450,269860,278793.8,592200
502810,515795.4,930650,236160,234961.2,338450,266650,280834.2,592200
499560,492236.4,930650,235840,218855,338450,263720,273381.4,592200
496370,519419.3,930650,235510,233159.2,338450,260860,286260.1,592200
493190,486262.3,930650,235180,220100,338450,258010,266162.3,592200
489880,473602.7,930650,234850,220852.4,338450,255030,252750.3,592200
485450,476465.9,930650,233650,229742,338450,251800,246723.9,592200
480970,461242.2,930650,232460,221619.5,338450,248510,239622.7,592200
476530,452480.4,930650,231260,222882,338450,245270,229598.4,592200
472040,448883.8,930650,230050,218688,338450,241990,230195.8,592200
467520,424539.4,930650,228970,207356.7,338450,238550,217182.7,592200
462890,440042.3,930650,227850,220369.3,338450,235040,219673,592200
458290,441048.7,930650,226750,228916.4,338450,231540,212132.3,592200
453650,406595.4,930650,225630,211459.2,338450,228020,195136.2,592200
447730,385476.1,930650,224510,201624.9,338450,223220,183851.2,592200
441850,402094.9,930650,223370,209485.4,338450,218480,192609.5,592200
435870,415942.3,930650,222220,219749,338450,213650,196193.3,592200
430000,412248.9,930650,221070,221049.2,338450,208930,191199.7,592200
423490,417513.6,930650,219340,228744.7,338450,204150,188768.9,592200
416930,437966.4,930650,217600,233783.1,338450,199330,204183.3,592200
410430,448653,930650,215860,239910.5,338450,194570,208742.5,592200
404000,464445.8,930650,214110,238894.3,338450,189890,225551.5,592200
410390,447703.4,930650,215330,233027,338450,195060,214676.4,592200
416800,438530.1,930650,216550,227268.8,338450,200250,211261.3,592200
423260,407889.9,930650,217770,215488.1,338450,205490,192401.8,592200
429720,412755.9,930650,218970,219435.7,338450,210750,193320.2,592200
436550,417413.9,930650,220000,217973.7,338450,216550,199440.2,592200
443370,423495.6,930650,220980,216630.3,338450,222390,206865.3,592200
450170,453083.6,930650,222000,234446.3,338450,228170,218637.3,592200
457000,458429.4,930650,222970,230641.3,338450,234030,227788.1,592200
465280,460439.5,930650,225500,223109,338450,239780,237330.5,592200
473460,470310.6,930650,227990,223611.5,338450,245470,246699.1,592200
481780,508297.7,930650,230490,235249.7,338450,251290,273048,592200
490030,505642.5,930650,233030,230183.4,338450,257000,275459.1,592200
497300,524694.4,930650,233730,236252.4,338450,263570,288442,592200
504600,543107.3,930650,234460,239287.1,338450,270140,303820.2,592200
511810,526901.8,930650,235170,229751.7,338450,276640,297150.1,592200
519120,553095.1,930650,235900,238917.8,338450,283220,314177.3,592200
527070,580181.2,930650,237620,259505.6,338450,289450,320675.6,592200
535050,580480.7,930650,239340,254943.5,338450,295710,325537.2,592200
542980,603925.7,930650,241030,263207.4,338450,301950,340718.3,592200
551020,606146.6,930650,242770,262369.3,338450,308250,343777.3,592200
557510,629037.6,930650,243680,265513.8,338450,313830,363523.8,592200
564040,639611.9,930650,244620,261684.3,338450,319420,377927.6,592200
570550,644171.4,930650,245570,268237.2,338450,324980,375934.2,592200
577070,649233.9,930650,246490,268194.2,338450,330580,381039.7,592200
569670,650001,930650,242950,271730.8,338450,326720,378270.2,592200
562320,660652.5,930650,239430,268082.8,338450,322890,392569.7,592200
554880,647614.9,930650,235880,264403.8,338450,319000,383211.1,592200
547460,632218.6,930650,232340,261781.8,338450,315120,370436.8,592200
538440,594800.1,930650,227750,247456.8,338450,310690,347343.3,592200
529320,601482.4,930650,223150,255541,338450,306170,345941.4,592200
520220,602190.9,930650,218560,262773.6,338450,301660,339417.3,592200
511110,573795.7,930650,213970,256455.4,338450,297140,317340.3,592200
503650,494926.7,930650,210380,218852.8,338450,293270,276073.9,592200
496010,439905.1,930650,206760,182633.5,338450,289250,257271.6,592200
488490,366884,930650,203170,141654,338450,285320,225230,592200
480960,360012.3,930650,199560,131958,338450,281400,228054.3,592200
477810,341250.3,930650,195250,114052.7,338450,282560,227197.6,592200
474690,359322.6,930650,190980,123205,338450,283710,236117.6,592200
471560,366617.7,930650,186710,120645.4,338450,284850,245972.3,592200
468470,353388.6,930650,182410,112693,338450,286060,240695.6,592200
461490,359976.3,930650,174950,111030.2,338450,286540,248946.1,592200
454450,371779.7,930650,167500,111866.2,338450,286950,259913.5,592200
447460,385026.6,930650,160060,111071.5,338450,287400,273955.1,592200
440480,388161.4,930650,152580,111685.9,338450,287900,276475.5,592200
436040,400824.6,930650,147980,118049.9,338450,288060,282774.7,592200
431570,423864.4,930650,143370,129399.2,338450,288200,294465.2,592200
427160,468510.2,930650,138770,148277.6,338450,288390,320232.6,592200
422740,487758.8,930650,134170,151160.9,338450,288570,336597.9,592200
418470,484811.6,930650,134680,154438.6,338450,283790,330373,592200
414150,482172,930650,135180,164165.5,338450,278970,318006.5,592200
409940,497018.6,930650,135710,171576.3,338450,274230,325442.3,592200
433620,499321,930650,146650,168193.4,338450,286970,331127.6,592200
429810,511689.8,930650,147040,178257.8,338450,282770,333432,592200
425980,511179.6,930650,147400,188978.2,338450,278580,322201.4,592200
422160,496839.5,930650,147770,186847.8,338450,274390,309991.7,592200
418390,471025.4,930650,148150,174965.5,338450,270240,296059.9,592200
414140,480987.7,930650,148620,183535.2,338450,265520,297452.5,592200
409920,512361.6,930650,149070,204997.3,338450,260850,307364.3,592200
405640,486596.1,930650,149500,193535,338450,256140,293061.1,592200
401450,460933.2,930650,149960,186445.5,338450,251490,274487.7,592200
389870,476152.1,930650,147360,198941.6,338450,242510,277210.5,592200
378290,431316.1,930650,144760,173599.4,338450,233530,257716.7,592200
366710,425526.7,930650,142180,169241.4,338450,224530,256285.3,592200
355180,393334.4,930650,139580,150224.7,338450,215600,243109.7,592200
342060,344343.7,930650,135770,129849.4,338450,206290,214494.3,592200
329020,315355.2,930650,131950,114735.4,338450,197070,200619.8,592200
315920,298791.4,930650,128140,104551.9,338450,187780,194239.5,592200
302960,270077.2,930650,124350,106922.9,338450,178610,163154.3,592200
290110,279499.2,930650,120160,122164.9,338450,169950,157334.3,592200
277200,262806,930650,115990,108507.2,338450,161210,154298.8,592200
264400,258686.8,930650,111850,101511.8,338450,152550,157175,592200
251560,280903.3,930650,107660,114027.3,338450,143900,166876,592200
249900,303064.4,930650,109390,130694.9,338450,140510,172369.5,592200
248190,311762.9,930650,111080,137057,338450,137110,174705.9,592200
246600,378217.3,930650,112820,181623.9,338450,133780,196593.4,592200
244780,386024.2,930650,114510,188856.5,338450,130270,197167.7,592200
243370,379719.9,930650,116740,184450.1,338450,126630,195269.8,592200
241880,384420.9,930650,118960,190196.9,338450,122920,194224,592200
240400,342647.4,930650,121200,181819.2,338450,119200,160828.2,592200
239000,344854.6,930650,123450,184275.4,338450,115550,160579.2,592200
238160,330048.8,930650,125810,179677.2,338450,112350,150371.6,592200
237240,306144.5,930650,128130,165663.4,338450,109110,140481.1,592200
236420,295380,930650,130490,154875.9,338450,105930,140504.1,592200
235480,311160,930650,132820,163309.1,338450,102660,147850.9,592200
227650,301901.3,930650,130440,145165.5,338450,97210,156735.8,592200
219850,271124.8,930650,128070,131820.5,338450,91780,139304.3,592200
212000,267014.2,930650,125710,135302.2,338450,86290,131712,592200
204230,280055.8,930650,123330,145287.4,338450,80900,134768.4,592200
193670,265925.5,930650,120650,137529.4,338450,73020,128396.1,592200
183170,284956,930650,117920,145804.2,338450,65250,139151.8,592200
172670,286346.9,930650,115270,148044.6,338450,57400,138302.3,592200
162190,206039.4,930650,112590,100128.2,338450,49600,105911.2,592200
153230,183923.7,930650,110040,94908.1,338450,43190,89015.6,592200
144350,194595.2,930650,107490,104002.5,338450,36860,90592.7,592200
135490,207961.9,930650,105000,112266.2,338450,30490,95695.7,592200
126590,182741.9,930650,102470,95461.3,338450,24120,87280.6,592200
130200,171006.3,930650,104230,87996.3,338450,25970,83010,592200
133850,152584.5,930650,106000,78621.6,338450,27850,73962.9,592200
137480,147773,930650,107760,76551.1,338450,29720,71221.9,592200
141100,145373.6,930650,109540,75248.9,338450,31560,70124.7,592200
144340,135118.7,930650,111420,71042.2,338450,32920,64076.5,592200
147540,135252.4,930650,113320,72065.5,338450,34220,63186.9,592200
150740,123469.7,930650,115200,61648,338450,35540,61821.7,592200
153950,130612.1,930650,117110,67549.8,338450,36840,63062.3,592200
157400,129451.2,930650,119320,68214.7,338450,38080,61236.5,592200
160860,148105.2,930650,121550,78456.4,338450,39310,69648.8,592200
164240,155337,930650,123780,84858.2,338450,40460,70478.8,592200
167700,170243.4,930650,126030,95054.3,338450,41670,75189.1,592200
168370,200404.8,930650,127030,114992.8,338450,41340,85412,592200
169100,224990.4,930650,128040,132788.7,338450,41060,92201.7,592200
169770,258744.8,930650,129050,155626.5,338450,40720,103118.3,592200
170490,279279.8,930650,130070,168887.8,338450,40420,110392,592200
171350,304676.4,930650,131370,186795.7,338450,39980,117880.7,592200
172090,305687.3,930650,132610,187474.5,338450,39480,118212.8,592200
172940,313632.6,930650,133900,192211.8,338450,39040,121420.8,592200
173810,319769.5,930650,135170,195102.1,338450,38640,124667.4,592200
173620,325896.3,930650,135490,199494.1,338450,38130,126402.2,592200
173530,328732.6,930650,135810,200433.4,338450,37720,128299.2,592200
173410,324882.8,930650,136120,197565.1,338450,37290,127317.7,592200
173290,320919.2,930650,136440,194625,338450,36850,126294.2,592200
170260,328278.9,930650,134450,200379.4,338450,35810,127899.5,592200
167290,331564.2,930650,132450,202772.3,338450,34840,128791.9,592200
164220,334184.1,930650,130440,203957.5,338450,33780,130226.6,592200
161260,331583.5,930650,128440,201744.3,338450,32820,129839.2,592200
159440,317561.6,930650,127730,193481.2,338450,31710,124080.4,592200
157610,315610.9,930650,127010,194197.2,338450,30600,121413.7,592200
155810,311163,930650,126280,190649.9,338450,29530,120513.1,592200
153950,319374.6,930650,125590,196330,338450,28360,123044.6,592200
151600,302861.2,930650,124310,187251.2,338450,27290,115610,592200
149230,297902,930650,123040,185053.6,338450,26190,112848.4,592200
146900,261851.1,930650,121750,161754.7,338450,25150,100096.4,592200
144570,219870.7,930650,120480,134783.2,338450,24090,85087.5,592200
140080,211269.8,930650,116930,129145.2,338450,23150,82124.6,592200
135640,222977.5,930650,113360,135707,338450,22280,87270.5,592200
131170,246019.1,930650,109830,149394.8,338450,21340,96624.3,592200
126710,227386.1,930650,106250,136329.2,338450,20460,91056.9,592200
123010,205992.9,930650,103350,121463.3,338450,19660,84529.6,592200
119280,224533.6,930650,100480,132922.6,338450,18800,91611,592200
115650,217545.8,930650,97580,127311.8,338450,18070,90234,592200
111960,193799.8,930650,94710,111313,338450,17250,82486.8,592200
107820,174199.4,930650,91350,96964.1,338450,16470,77235.3,592200
103670,163360.6,930650,88030,89443.9,338450,15640,73916.7,592200
99550,156805.5,930650,84670,84161.2,338450,14880,72644.3,592200
95410,156733.5,930650,81330,82997.4,338450,14080,73736.1,592200
92090,157939.9,930650,77850,82438.3,338450,14240,75501.6,592200
88720,170760.5,930650,74390,89743.3,338450,14330,81017.2,592200
85350,150476.5,930650,70900,75359.9,338450,14450,75116.6,592200
77540,128564.2,930650,61550,58546.5,338450,15990,70017.7,592200
77960,126281.8,930650,59950,55248.8,338450,18010,71033,592200
78460,132446.2,930650,58390,58045.5,338450,20070,74400.7,592200
78860,125823.6,930650,56820,51241.8,338450,22040,74581.8,592200
79360,127598.3,930650,55270,50967.3,338450,24090,76631,592200
79850,143311.9,930650,53480,58764.6,338450,26370,84547.3,592200
80230,148185.3,930650,51670,58521.1,338450,28560,89664.2,592200
80700,152017.7,930650,49890,64845.3,338450,30810,87172.4,592200
81190,145089.5,930650,48110,66701.4,338450,33080,78388.1,592200
96180,156819.1,930650,55910,72457.2,338450,40270,84361.9,592200
111080,157905.8,930650,63700,69247.3,338450,47380,88658.5,592200
126000,177521.2,930650,71490,77329.9,338450,54510,100191.3,592200
140960,188142.3,930650,79290,78682.3,338450,61670,109460,592200
156910,201011.8,930650,87960,83458.5,338450,68950,117553.3,592200
172810,206812.6,930650,96650,85684.3,338450,76160,121128.3,592200
188750,215583.7,930650,105330,88976.9,338450,83420,126606.8,592200
204720,241987.8,930650,114020,102256.2,338450,90700,139731.6,592200
220070,267604.7,930650,121990,118285.6,338450,98080,149319.1,592200
235470,283589.2,930650,129970,122953.4,338450,105500,160635.8,592200
250880,305172,930650,137930,137439,338450,112950,167733,592200
266340,324291.5,930650,145910,149536.8,338450,120430,174754.7,592200
274880,361766.7,930650,150080,171195.9,338450,124800,190570.8,592200
283380,369909.4,930650,154210,170290.2,338450,129170,199619.2,592200
291960,405249.9,930650,158370,190972.2,338450,133590,214277.7,592200
300530,443420.4,930650,162530,219762.9,338450,138000,223657.5,592200
309600,436779.9,930650,167150,218852.9,338450,142450,217927,592200
318670,416499.2,930650,171790,210489.9,338450,146880,206009.3,592200
327820,440428.7,930650,176400,220841.8,338450,151420,219586.9,592200
336860,426412.5,930650,181040,214820.3,338450,155820,211592.2,592200
345850,427184.5,930650,185080,216641.2,338450,160770,210543.3,592200
354800,432830.3,930650,189150,219458,338450,165650,213372.3,592200
363770,460749.3,930650,193190,235110.5,338450,170580,225638.8,592200
372780,458215.8,930650,197260,235148,338450,175520,223067.8,592200
381050,478570.3,930650,200630,237774.1,338450,180420,240796.2,592200
389340,466999,930650,204000,237875.2,338450,185340,229123.8,592200
397590,437617.9,930650,207360,228283.7,338450,190230,209334.2,592200
405900,427380.8,930650,210720,218528.3,338450,195180,208852.5,592200
410090,412916.6,930650,212880,222495.6,338450,197210,190421,592200
414250,418146.1,930650,215020,221858.4,338450,199230,196287.7,592200
418440,405298.1,930650,217180,214401.3,338450,201260,190896.8,592200
422580,412049.4,930650,219310,218030.6,338450,203270,194018.8,592200
432130,446433.9,930650,222390,225162.5,338450,209740,221271.4,592200
441650,464703.9,930650,225460,228288.8,338450,216190,236415.1,592200
451180,479098.3,930650,228520,233337.2,338450,222660,245761.1,592200
460650,485479.2,930650,231580,233074.2,338450,229070,252405,592200
471020,503147.3,930650,233500,229875.3,338450,237520,273272,592200
481280,522507.2,930650,235420,233728.3,338450,245860,288778.9,592200
491560,539694.1,930650,237330,239463.5,338450,254230,300230.6,592200
501830,564147.4,930650,239250,242169.2,338450,262580,321978.2,592200
511260,587051.4,930650,240890,247790.2,338450,270370,339261.2,592200
520750,607943.1,930650,242510,251215,338450,278240,356728.1,592200
530170,617922.4,930650,244140,254697.8,338450,286030,363224.6,592200
539620,614946.3,930650,245760,254517.5,338450,293860,360428.8,592200
548160,612488,930650,247060,250527.9,338450,301100,361960.1,592200
556600,602608,930650,248350,256308.9,338450,308250,346299.1,592200
565100,602679.3,930650,249640,258123.8,338450,315460,344555.5,592200
573570,614447.6,930650,250930,261370.7,338450,322640,353076.9,592200
566300,648868.4,930650,249310,270447.3,338450,316990,378421.1,592200
559000,650320.5,930650,247720,278727.4,338450,311280,371593.1,592200
551700,620369.1,930650,246100,267740.4,338450,305600,352628.7,592200
544390,612833,930650,244470,260451.7,338450,299920,352381.3,592200
537700,629054.9,930650,243030,269067.3,338450,294670,359987.6,592200
530950,621844.3,930650,241590,273089.8,338450,289360,348754.5,592200
524250,614680.6,930650,240130,277254.9,338450,284120,337425.7,592200
517530,627557.1,930650,238680,273507.4,338450,278850,354049.7,592200
511100,649082.6,930650,237230,273631.6,338450,273870,375451,592200
504630,614630.2,930650,235800,272944.4,338450,268830,341685.8,592200
498180,615687.7,930650,234320,278332.5,338450,263860,337355.2,592200
491730,608354.5,930650,232890,264476.5,338450,258840,343878,592200
481140,584285.1,930650,230880,255074.1,338450,250260,329211,592200
470610,589273.1,930650,228880,256731.1,338450,241730,332542,592200
459920,563628.8,930650,226860,247724.7,338450,233060,315904.1,592200
449350,552063.1,930650,224860,248316.6,338450,224490,303746.5,592200
437220,516322.4,930650,222270,238487,338450,214950,277835.4,592200
425040,491058.2,930650,219690,234057.6,338450,205350,257000.6,592200
412920,481716.7,930650,217110,224929,338450,195810,256787.7,592200
400770,445623.6,930650,214520,224258.5,338450,186250,221365.1,592200
388690,428827.4,930650,212300,226147.6,338450,176390,202679.8,592200
376650,417977.2,930650,210070,223500.8,338450,166580,194476.4,592200
364580,421199.3,930650,207850,222173.9,338450,156730,199025.4,592200
352550,405724.7,930650,205600,219022.8,338450,146950,186701.9,592200
346720,399920.4,930650,203320,216642.3,338450,143400,183278.1,592200
340850,394658.1,930650,201030,213004.9,338450,139820,181653.2,592200
335090,407671.7,930650,198770,214839.2,338450,136320,192832.5,592200
329230,385009.8,930650,196470,218774.3,338450,132760,166235.5,592200
324080,379969.2,930650,194710,221535.5,338450,129370,158433.7,592200
318920,393918.1,930650,192960,224575.4,338450,125960,169342.7,592200
313750,426396,930650,191230,233098.9,338450,122520,193297.1,592200
308540,423083.4,930650,189470,229700.6,338450,119070,193382.8,592200
303500,411681.1,930650,187210,232031.4,338450,116290,179649.7,592200
298430,406294.3,930650,184990,226794.7,338450,113440,179499.6,592200
293370,419776.8,930650,182720,228648.9,338450,110650,191127.9,592200
288290,431775.8,930650,180490,228924.4,338450,107800,202851.4,592200
281930,427303.8,930650,176530,226286,338450,105400,201017.8,592200
275580,411129,930650,172570,214327.9,338450,103010,196801.1,592200
269150,382003.8,930650,168590,195733.6,338450,100560,186270.2,592200
254760,376244,930650,158560,192237,338450,96200,184007,592200
246360,359945.9,930650,152780,182540.8,338450,93580,177405.1,592200
238030,348308.9,930650,146980,175172.4,338450,91050,173136.5,592200
229750,328396.1,930650,141180,162669.4,338450,88570,165726.7,592200
221430,324418.4,930650,135370,160317.3,338450,86060,164101.1,592200
214520,334664.3,930650,131000,162300.7,338450,83520,172363.6,592200
207630,359184.2,930650,126660,179950.6,338450,80970,179233.6,592200
200740,346127.7,930650,122260,177933.5,338450,78480,168194.2,592200
193900,291963,930650,117910,145581.5,338450,75990,146381.5,592200
186110,291399.2,930650,112350,146711.1,338450,73760,144688.1,592200
178310,283715,930650,106790,142715.8,338450,71520,140999.2,592200
170500,274684.7,930650,101220,133168.8,338450,69280,141515.9,592200
162740,279185.2,930650,95670,133995.2,338450,67070,145190,592200
156180,266404.5,930650,91450,127389.7,338450,64730,139014.8,592200
149590,267422.1,930650,87210,127330.7,338450,62380,140091.4,592200
143090,247532.4,930650,83000,114353,338450,60090,133179.4,592200
136490,235529,930650,78800,105709.9,338450,57690,129819.1,592200
129200,235794.9,930650,73700,105559.2,338450,55500,130235.7,592200
121920,216904.4,930650,68590,94791.8,338450,53330,122112.6,592200
114660,163729.5,930650,63530,59779.4,338450,51130,103950.1,592200
107420,204479.4,930650,58440,84458.2,338450,48980,120021.2,592200
111500,172345.5,930650,60500,64220.3,338450,51000,108125.2,592200
115550,161978.3,930650,62560,57201.2,338450,52990,104777.1,592200
119650,154104,930650,64640,53707.4,338450,55010,100396.6,592200
123710,150089.3,930650,66710,51652.4,338450,57000,98436.9,592200
127320,177705.3,930650,68110,66946.3,338450,59210,110759,592200
130840,185027.9,930650,69510,67630.4,338450,61330,117397.5,592200
134430,178436.8,930650,70910,57896.2,338450,63520,120540.6,592200
138030,176597.7,930650,72300,53446.8,338450,65730,123150.9,592200
142030,200709.7,930650,73930,66175.7,338450,68100,134534,592200
146090,243579.9,930650,75620,87968.9,338450,70470,155611,592200
150100,245920.7,930650,77250,87277.7,338450,72850,158643,592200
154160,281033.4,930650,78920,112016.5,338450,75240,169016.9,592200
164520,267238.8,930650,82880,107007.5,338450,81640,160231.3,592200
174860,229715.7,930650,86810,85955.2,338450,88050,143760.5,592200
185240,212914.8,930650,90770,79948.7,338450,94470,132966.1,592200
195650,199158.7,930650,94740,74954.7,338450,100910,124204,592200
206460,210996.6,930650,98720,83304.3,338450,107740,127692.3,592200
217320,208369.2,930650,102710,84444.5,338450,114610,123924.7,592200
228170,212503.9,930650,106720,84246.8,338450,121450,128257.1,592200
239020,214523.9,930650,110710,81914,338450,128310,132609.9,592200
250790,241076.1,930650,115740,93518.1,338450,135050,147558,592200
262540,260446.7,930650,120760,101470.5,338450,141780,158976.2,592200
274220,283932.3,930650,125760,109544.9,338450,148460,174387.4,592200
286040,284263.3,930650,130770,101119.2,338450,155270,183144.1,592200
292780,290222.1,930650,132700,100453.7,338450,160080,189768.4,592200
299590,298169.1,930650,134610,109113.1,338450,164980,189056,592200
306300,268515.6,930650,136520,95931.4,338450,169780,172584.2,592200
313080,273656.4,930650,138420,93041.6,338450,174660,180614.8,592200
318740,305687.1,930650,139180,103690.5,338450,179560,201996.6,592200
324390,307523.2,930650,139920,108650.3,338450,184470,198872.9,592200
330090,298675.2,930650,140670,94230,338450,189420,204445.2,592200
335700,287992.7,930650,141400,87447.7,338450,194300,200545,592200
341040,277440.6,930650,142700,86279.7,338450,198340,191160.9,592200
346350,275431.9,930650,144020,84613.1,338450,202330,190818.8,592200
351610,256996.5,930650,145320,76902.2,338450,206290,180094.3,592200
356970,275646.5,930650,146620,88851.7,338450,210350,186794.8,592200
352110,276250.6,930650,144400,88379.6,338450,207710,187871,592200
347350,330769.3,930650,142170,127273.9,338450,205180,203495.4,592200
342560,370763.2,930650,139970,150640,338450,202590,220123.2,592200
337800,388949.6,930650,137770,164206.2,338450,200030,224743.4,592200
332420,450918.6,930650,134960,199506.7,338450,197460,251411.9,592200
327200,489352.9,930650,132180,226129,338450,195020,263223.9,592200
321920,451496.5,930650,129370,203322,338450,192550,248174.5,592200
316650,450274.4,930650,126590,203395.5,338450,190060,246878.9,592200
311800,384007.2,930650,124270,165219.1,338450,187530,218788.1,592200
306960,370656.1,930650,121950,156396.2,338450,185010,214259.9,592200
302120,348688.1,930650,119660,143112.4,338450,182460,205575.7,592200
297200,338126.5,930650,117320,137266,338450,179880,200860.5,592200
295160,330732.7,930650,116560,130730.9,338450,178600,200001.8,592200
293100,328926.3,930650,115780,129691.1,338450,177320,199235.2,592200
291000,346476.8,930650,115010,141815.4,338450,175990,204661.4,592200
288940,348622.5,930650,114220,147377.4,338450,174720,201245.1,592200
286520,314429.4,930650,113600,114404,338450,172920,200025.4,592200
284030,270347.8,930650,112980,79599.4,338450,171050,190748.4,592200
281530,229242.6,930650,112340,67571.2,338450,169190,161671.4,592200
279050,224502.1,930650,111740,64722.2,338450,167310,159779.9,592200
280170,234157.4,930650,113010,69625,338450,167160,164532.4,592200
281240,254067.2,930650,114270,75193.8,338450,166970,178873.4,592200
282300,292583.5,930650,115510,96514.4,338450,166790,196069.1,592200
283340,357841.6,930650,116790,141842.9,338450,166550,215998.7,592200
308860,417844.2,930650,129090,180619.1,338450,179770,237225.1,592200
334400,454765.4,930650,141440,201196.7,338450,192960,253568.7,592200
359960,457168.7,930650,153780,198600.3,338450,206180,258568.4,592200
385520,490007.6,930650,166120,218766.5,338450,219400,271241.1,592200
411980,502526.1,930650,178750,221101.6,338450,233230,281424.5,592200
438540,530584.5,930650,191380,234548.8,338450,247160,296035.7,592200
465040,573291,930650,204000,256464.5,338450,261040,316826.5,592200
491540,581148.7,930650,216620,266808.5,338450,274920,314340.2,592200
516720,582774.2,930650,228240,267497.4,338450,288480,315276.8,592200
541840,582901,930650,239810,268325.2,338450,302030,314575.8,592200
567070,616147.4,930650,251420,283516,338450,315650,332631.4,592200
592260,639562.3,930650,263020,287515.3,338450,329240,352047,592200
600920,666792.9,930650,265150,296169.1,338450,335770,370623.8,592200
609640,686662.3,930650,267280,303137.6,338450,342360,383524.7,592200
618390,690893,930650,269420,305528.5,338450,348970,385364.5,592200
666400,715731,930650,277770,308229.1,338450,388630,407501.9,592200
670500,742172.1,930650,279060,310993.9,338450,391440,431178.2,592200
674530,754984.2,930650,280340,313908.7,338450,394190,441075.5,592200
678720,774884.4,930650,281650,318693.3,338450,397070,456191.1,592200
682820,759557.7,930650,282950,315474.1,338450,399870,444083.6,592200
685650,747932.1,930650,283900,314057.1,338450,401750,433875,592200
688520,754411.5,930650,284850,317596.5,338450,403670,436815,592200
691320,743964.1,930650,285820,312869.4,338450,405500,431094.7,592200
694220,715680.4,930650,286800,301304.1,338450,407420,414376.3,592200
686940,706854.2,930650,284570,300284.9,338450,402370,406569.3,592200
679580,689547.6,930650,282340,288332.1,338450,397240,401215.5,592200
672300,667627.8,930650,280150,279732.5,338450,392150,387895.3,592200
664960,655548,930650,277920,270818.3,338450,387040,384729.7,592200
658240,655260,930650,275920,268311.3,338450,382320,386948.7,592200
651590,656685.6,930650,273940,273424.8,338450,377650,383260.8,592200
644860,672562.6,930650,271930,281112,338450,372930,391450.6,592200
638200,665955.3,930650,269940,273037.5,338450,368260,392917.8,592200
632050,626482.9,930650,267600,259239.1,338450,364450,367243.8,592200
625840,641100.3,930650,265260,269163,338450,360580,371937.3,592200
619670,657771.4,930650,262900,279404.6,338450,356770,378366.8,592200
613550,655270.1,930650,260570,274022.7,338450,352980,381247.4,592200
610050,639212.7,930650,260130,280134.3,338450,349920,359078.4,592200
606580,665892.5,930650,259700,295715,338450,346880,370177.5,592200
603070,669300.7,930650,259260,296663.5,338450,343810,372637.2,592200
599670,661246.2,930650,258840,285341.8,338450,340830,375904.4,592200
595270,650460.3,930650,258400,294121.5,338450,336870,356338.8,592200
590970,635518.3,930650,257990,287044.5,338450,332980,348473.8,592200
586650,654462.7,930650,257570,293647.4,338450,329080,360815.3,592200
582280,613741.3,930650,257130,272573.9,338450,325150,341167.4,592200
578790,555736.5,930650,256850,248148.8,338450,321940,307587.7,592200
575380,570758.4,930650,256590,257179.4,338450,318790,313579,592200
571890,586072.1,930650,256320,257000.1,338450,315570,329072,592200
568410,570220.5,930650,256070,254033.8,338450,312340,316186.7,592200
576210,581189.9,930650,258210,256061.3,338450,318000,325128.6,592200
583930,571698,930650,260350,256566.6,338450,323580,315131.4,592200
591670,589038.8,930650,262510,258746.9,338450,329160,330291.9,592200
599430,596549.6,930650,264680,259368.8,338450,334750,337180.8,592200
608710,605836.4,930650,267060,261387.7,338450,341650,344448.7,592200
617960,653481.6,930650,269430,280314.8,338450,348530,373166.8,592200
627080,645252.1,930650,271790,276082.4,338450,355290,369169.7,592200
636330,661062.1,930650,274170,290239.8,338450,362160,370822.3,592200
645320,676752,930650,276390,290796.5,338450,368930,385955.5,592200
654290,683632.6,930650,278640,292330,338450,375650,391302.6,592200
663300,693842.5,930650,280890,295460.8,338450,382410,398381.7,592200
672270,697742.3,930650,283120,296143.5,338450,389150,401598.8,592200
676510,695951.1,930650,282940,293223.6,338450,393570,402727.5,592200
680810,723268,930650,282790,305098.2,338450,398020,418169.8,592200
685140,721084,930650,282610,303752.7,338450,402530,417331.3,592200
689330,727687.1,930650,282420,306686.2,338450,406910,421000.9,592200
693440,731545.7,930650,282290,305728.2,338450,411150,425817.5,592200
697490,750969.3,930650,282130,313019,338450,415360,437950.3,592200
701470,746538.4,930650,281950,310169.2,338450,419520,436369.2,592200
705520,756742.7,930650,281820,313660.7,338450,423700,443082,592200
709680,781816.4,930650,281590,321760.7,338450,428090,460055.7,592200
713790,769496.7,930650,281350,312427.3,338450,432440,457069.4,592200
717880,773247.8,930650,281120,312570.2,338450,436760,460677.6,592200
722020,775330.1,930650,280920,311728.5,338450,441100,463601.6,592200
721900,780389,930650,281580,314040,338450,440320,466349,592200
721760,746130.1,930650,282270,298257.6,338450,439490,447872.5,592200
721630,759388.1,930650,282970,306425.8,338450,438660,452962.3,592200
721500,776375.8,930650,283650,313376.4,338450,437850,462999.4,592200
721060,759409.6,930650,284330,307522.4,338450,436730,451887.2,592200
720670,750754.5,930650,285040,304832,338450,435630,445922.5,592200
720220,735536.9,930650,285720,300611.4,338450,434500,434925.5,592200
719800,748326.3,930650,286420,303184.3,338450,433380,445142,592200
719290,761171.9,930650,287100,313938.3,338450,432190,447233.6,592200
718750,753130.5,930650,287790,315828.5,338450,430960,437302,592200
718200,759633.5,930650,288460,316353.8,338450,429740,443279.7,592200
717630,746208.4,930650,289140,311376.5,338450,428490,434831.9,592200
708280,723859.4,930650,287380,303592.7,338450,420900,420266.7,592200
698910,735748.2,930650,285650,302830.5,338450,413260,432917.7,592200
689570,728286.2,930650,283890,302716.6,338450,405680,425569.6,592200
680090,728284.8,930650,282130,299924.4,338450,397960,428360.4,592200
670300,696876.3,930650,280290,296060,338450,390010,400816.3,592200
660400,659265.1,930650,278430,291906.4,338450,381970,367358.7,592200
650570,653482.4,930650,276580,291348.4,338450,373990,362134,592200
640780,642973.6,930650,274730,284891.3,338450,366050,358082.3,592200
629750,618562.5,930650,272830,273475.4,338450,356920,345087.1,592200
618740,624056.6,930650,270950,275882.9,338450,347790,348173.7,592200
607800,613661.3,930650,269050,260278.1,338450,338750,353383.2,592200
596830,570266.7,930650,267160,247291.4,338450,329670,322975.3,592200
592410,551588.5,930650,266270,241725.4,338450,326140,309863.1,592200
587970,517524.5,930650,265380,237191.4,338450,322590,280333.1,592200
583500,511759.4,930650,264460,235193.6,338450,319040,276565.8,592200
579120,511556.3,930650,263580,236023.1,338450,315540,275533.2,592200
576220,500835,930650,262870,232684.5,338450,313350,268150.5,592200
573260,494898.8,930650,262170,235785,338450,311090,259113.8,592200
570320,510346.4,930650,261470,239339,338450,308850,271007.4,592200
567420,517393.9,930650,260760,244173.9,338450,306660,273220,592200
564240,539360.2,930650,259880,264307.6,338450,304360,275052.6,592200
561030,600370.8,930650,258980,296289.1,338450,302050,304081.7,592200
557880,594757.4,930650,258100,281712.2,338450,299780,313045.2,592200
554740,624389,930650,257230,282496.6,338450,297510,341892.4,592200
549180,603884,930650,255030,276763.7,338450,294150,327120.3,592200
543620,632050.3,930650,252880,287147.6,338450,290740,344902.7,592200
538070,637561.2,930650,250680,288552.3,338450,287390,349008.9,592200
548130,618573.7,930650,251890,281931.2,338450,296240,336642.5,592200
543520,597985,930650,249950,277157.3,338450,293570,320827.7,592200
538940,581813.3,930650,247990,266704,338450,290950,315109.3,592200
534360,579667.5,930650,246050,268802.7,338450,288310,310864.8,592200
529780,575749.2,930650,244070,266845.1,338450,285710,308904.1,592200
525050,559441.5,930650,242110,261349.6,338450,282940,298091.9,592200
520230,543697.1,930650,240140,249862.5,338450,280090,293834.6,592200
515560,522953.3,930650,238200,234398.9,338450,277360,288554.4,592200
510750,498249.4,930650,236230,225516.7,338450,274520,272732.7,592200
504310,505920.8,930650,234220,233639.1,338450,270090,272281.7,592200
497860,496855.4,930650,232210,224749.4,338450,265650,272106,592200
491430,522801.8,930650,230210,240374.8,338450,261220,282427,592200
485000,516926,930650,228190,240970,338450,256810,275956,592200
478620,500281.7,930650,226210,232210.8,338450,252410,268070.9,592200
472390,469133,930650,224250,218228.4,338450,248140,250904.6,592200
466060,473994.5,930650,222260,226611.7,338450,243800,247382.8,592200
459760,486831.7,930650,220280,234361.6,338450,239480,252470.1,592200
454120,479462.8,930650,218740,231322.1,338450,235380,248140.7,592200
448510,485095.5,930650,217200,239346.5,338450,231310,245749,592200
442910,411777.9,930650,215670,197091.8,338450,227240,214686.1,592200
437290,402122.4,930650,214110,187490.7,338450,223180,214631.7,592200
429760,410316.4,930650,210280,193502.4,338450,219480,216814,592200
422210,386765.9,930650,206430,182200.7,338450,215780,204565.2,592200
414610,384088.6,930650,202570,181034.6,338450,212040,203054,592200
407020,370979.1,930650,198730,169979.4,338450,208290,200999.7,592200
399390,370534.2,930650,194860,170413.1,338450,204530,200121.1,592200
391900,396226.1,930650,191030,184948.8,338450,200870,211277.3,592200
384280,424752.9,930650,187190,209858.8,338450,197090,214894.1,592200
376680,415874.1,930650,183340,206408,338450,193340,209466.1,592200
368860,385430.2,930650,179430,190565.6,338450,189430,194864.6,592200
361100,379360.4,930650,175520,186376.8,338450,185580,192983.6,592200
353330,386888,930650,171610,182165.4,338450,181720,204722.6,592200
345490,373563.8,930650,167690,173493.5,338450,177800,200070.3,592200
336490,389860.1,930650,162330,175793.4,338450,174160,214066.7,592200
327430,382688.3,930650,156960,182557.7,338450,170470,200130.6,592200
318300,415365.7,930650,151620,204618.6,338450,166680,210747.1,592200
309280,405833.1,930650,146280,197280.3,338450,163000,208552.8,592200
301960,373044.4,930650,140640,174768.5,338450,161320,198275.9,592200
294770,330853.2,930650,135040,151983.7,338450,159730,178869.5,592200
287540,360699.5,930650,129420,166672.4,338450,158120,194027.1,592200
280260,355176.7,930650,123820,174355.5,338450,156440,180821.2,592200
273080,363395.9,930650,118230,168530.5,338450,154850,194865.4,592200
265930,328855.6,930650,112650,144482.3,338450,153280,184373.3,592200
258830,306697.4,930650,107070,129999.4,338450,151760,176698,592200
251660,303026.4,930650,101490,120314,338450,150170,182712.4,592200
242330,271862.9,930650,96710,99020.4,338450,145620,172842.5,592200
232990,273542,930650,91920,98905.6,338450,141070,174636.4,592200
223730,275981.7,930650,87160,103308.2,338450,136570,172673.5,592200
214380,257056,930650,82370,87793.1,338450,132010,169262.9,592200
205690,257227,930650,78610,88676.7,338450,127080,168550.3,592200
197030,244694.7,930650,74860,80619.4,338450,122170,164075.3,592200
188370,206445.8,930650,71130,59549.4,338450,117240,146896.4,592200
179680,183375.2,930650,67380,47132.8,338450,112300,136242.4,592200
171550,189473.7,930650,63680,55924,338450,107870,133549.7,592200
163430,196527.7,930650,60010,56039.6,338450,103420,140488.1,592200
155310,189961.9,930650,56340,53210.9,338450,98970,136751,592200
147180,201800.5,930650,52660,60017.2,338450,94520,141783.3,592200
150100,195852.5,930650,54190,59906.9,338450,95910,135945.6,592200
153060,200163.8,930650,55730,62746.5,338450,97330,137417.3,592200
156020,201347.7,930650,57290,59260.8,338450,98730,142086.9,592200
159000,200878.8,930650,58840,60867.7,338450,100160,140011.1,592200
161700,224124.6,930650,60230,66496.7,338450,101470,157627.9,592200
164480,176720,930650,61640,49805.9,338450,102840,126914.1,592200
167170,143444.1,930650,63030,47885,338450,104140,95559.1,592200
169920,166651.3,930650,64420,54093.5,338450,105500,112557.8,592200
172680,161564.6,930650,66520,58688.7,338450,106160,102875.9,592200
175400,171114.6,930650,68610,58253,338450,106790,112861.6,592200
178180,196504.6,930650,70730,68902.8,338450,107450,127601.8,592200
180860,196810,930650,72800,71624,338450,108060,125186,592200
185910,208803.2,930650,75530,75982.9,338450,110380,132820.3,592200
190930,215507.1,930650,78240,75641,338450,112690,139866.1,592200
195940,199296.6,930650,80960,73571.2,338450,114980,125725.4,592200
201020,221336,930650,83690,87390.5,338450,117330,133945.5,592200
207110,237953.9,930650,86560,100986.9,338450,120550,136967,592200
213240,221874.8,930650,89460,89980.4,338450,123780,131894.4,592200
219440,210338.7,930650,92340,82544.6,338450,127100,127794.1,592200
225540,228470.2,930650,95200,89439.9,338450,130340,139030.3,592200
230950,237560.7,930650,97470,95367,338450,133480,142193.7,592200
236400,238845.3,930650,99710,95319,338450,136690,143526.3,592200
241780,235515.1,930650,101950,91556.7,338450,139830,143958.4,592200
247190,228781.2,930650,104200,92835.8,338450,142990,135945.4,592200
245380,238981.5,930650,103010,101474.6,338450,142370,137506.9,592200
243530,239361.4,930650,101790,100836.9,338450,141740,138524.5,592200
241740,255384.7,930650,100590,112075.9,338450,141150,143308.8,592200
239890,221363.3,930650,99380,95988.8,338450,140510,125374.5,592200
237310,220620.5,930650,97590,94437.4,338450,139720,126183.1,592200
234740,209439.9,930650,95790,87112.7,338450,138950,122327.2,592200
232150,209164.6,930650,94010,76761.3,338450,138140,132403.3,592200
229540,209808.5,930650,92210,72081,338450,137330,137727.5,592200
226900,199439.3,930650,90700,63804.9,338450,136200,135634.4,592200
224330,195292.9,930650,89200,63749.4,338450,135130,131543.5,592200
221760,188434.3,930650,87690,59178.8,338450,134070,129255.5,592200
219150,210518.5,930650,86190,63256.8,338450,132960,147261.7,592200
217360,195268.1,930650,85000,58851.1,338450,132360,136417,592200
215670,205921,930650,83810,61960.3,338450,131860,143960.7,592200
213960,172840.2,930650,82640,51750.1,338450,131320,121090.1,592200
232540,176610,930650,83950,54564.8,338450,148590,122045.2,592200
232010,174169.4,930650,83740,49646,338450,148270,124523.4,592200
231430,202499.6,930650,83510,52646.2,338450,147920,149853.4,592200
230830,177347.8,930650,83290,46869.9,338450,147540,130477.9,592200
230330,189257.1,930650,83080,49057.6,338450,147250,140199.5,592200
229040,211627.6,930650,81830,55152.8,338450,147210,156474.8,592200
227670,215599.4,930650,80570,58447.1,338450,147100,157152.3,592200
226320,225834.4,930650,79300,62695.8,338450,147020,163138.6,592200
225000,248936.2,930650,78060,66481.5,338450,146940,182454.7,592200
225830,260158.3,930650,77930,74773.6,338450,147900,185384.7,592200
226600,257419.5,930650,77810,86686.6,338450,148790,170732.9,592200
227400,292791.8,930650,77690,93696.2,338450,149710,199095.6,592200
228170,277934.9,930650,77560,96406.7,338450,150610,181528.2,592200
228870,284126.9,930650,77520,98348.6,338450,151350,185778.3,592200
229580,259945.8,930650,77500,88439.1,338450,152080,171506.7,592200
230270,245973.7,930650,77470,79166,338450,152800,166807.7,592200
230860,243981.5,930650,77420,78277.7,338450,153440,165703.8,592200
231360,241868.6,930650,77610,76079.2,338450,153750,165789.4,592200
231870,234915.5,930650,77800,72315.6,338450,154070,162599.9,592200
232300,230312.4,930650,77990,70852.9,338450,154310,159459.5,592200
232760,231830.4,930650,78140,69309.8,338450,154620,162520.6,592200
231290,247498.6,930650,78370,74220.1,338450,152920,173278.5,592200
229780,251874.4,930650,78600,73840.3,338450,151180,178034.1,592200
228230,262092.4,930650,78810,76726.6,338450,149420,185365.8,592200
226740,265567.4,930650,79000,78225.1,338450,147740,187342.3,592200
225460,252991.2,930650,78970,70396.9,338450,146490,182594.3,592200
224200,255631.9,930650,78940,74637.7,338450,145260,180994.2,592200
222840,274793.3,930650,78890,84834.4,338450,143950,189958.9,592200
221630,266690,930650,78870,84659.8,338450,142760,182030.2,592200
220480,261076.8,930650,78970,81850.9,338450,141510,179225.9,592200
219250,253386.4,930650,79030,79132.9,338450,140220,174253.5,592200
218110,235590.9,930650,79120,70704.9,338450,138990,164886,592200
216870,233155.5,930650,79170,68264.9,338450,137700,164890.6,592200
217390,244374.5,930650,79150,67065.5,338450,138240,177309,592200
217950,243549,930650,79080,69112.8,338450,138870,174436.2,592200
218450,262427.7,930650,79070,71109.8,338450,139380,191317.9,592200
218980,266122.1,930650,79000,71990.9,338450,139980,194131.2,592200
219680,301605.3,930650,78650,83951.7,338450,141030,217653.6,592200
220380,283123.2,930650,78290,84700.7,338450,142090,198422.5,592200
220960,313639.3,930650,77900,97939.5,338450,143060,215699.8,592200
221670,332912.8,930650,77560,104619.5,338450,144110,228293.3,592200
224080,306081.4,930650,77670,90294,338450,146410,215787.4,592200
226490,294182.9,930650,77800,82701.1,338450,148690,211481.8,592200
228870,278274,930650,77920,76013.8,338450,150950,202260.2,592200
231260,282098.1,930650,78040,73276.8,338450,153220,208821.3,592200
232930,276200.6,930650,78860,74998.7,338450,154070,201201.9,592200
234680,281089.8,930650,79730,78600.5,338450,154950,202489.3,592200
236340,294677.8,930650,80560,85576.9,338450,155780,209100.9,592200
238030,283088.1,930650,81400,81060.4,338450,156630,202027.7,592200
239440,282925.4,930650,81960,86038.1,338450,157480,196887.3,592200
240910,284185.7,930650,82520,85357.6,338450,158390,198828.1,592200
242330,299449.8,930650,83100,91297.8,338450,159230,208152,592200
243720,313645.2,930650,83640,90488.5,338450,160080,223156.7,592200
245320,303955.2,930650,84550,91835.9,338450,160770,212119.3,592200
246920,308693.3,930650,85430,86881.9,338450,161490,221811.4,592200
248440,314196.4,930650,86320,94924.5,338450,162120,219271.9,592200
249980,331875.8,930650,87190,102476.3,338450,162790,229399.5,592200
252680,338132.4,930650,89080,107668.2,338450,163600,230464.2,592200
255440,352818.1,930650,90960,110046.9,338450,164480,242771.2,592200
258200,368642.3,930650,92870,117344.7,338450,165330,251297.6,592200
260870,374770.1,930650,94750,125649.8,338450,166120,249120.3,592200
263870,405730.5,930650,96720,134644.9,338450,167150,271085.6,592200
266790,374671.9,930650,98690,125159.2,338450,168100,249512.7,592200
269780,397586.3,930650,100650,144869.9,338450,169130,252716.4,592200
272690,403161.9,930650,102600,142810.5,338450,170090,260351.4,592200
275710,416727.8,930650,104280,147133.7,338450,171430,269594.1,592200
278830,403680.3,930650,105990,143131.2,338450,172840,260549.1,592200
281890,424513.8,930650,107670,151498.2,338450,174220,273015.6,592200
284820,423920.4,930650,109340,154435.4,338450,175480,269485,592200
285590,400332.4,930650,110900,146993.1,338450,174690,253339.3,592200
286270,397545.6,930650,112440,148353.3,338450,173830,249192.3,592200
287000,416480.1,930650,113990,154120.5,338450,173010,262359.6,592200
287700,400130.3,930650,115540,159354.1,338450,172160,240776.2,592200
288100,418719.4,930650,117470,167057.4,338450,170630,251662,592200
288520,418233.8,930650,119410,169756.9,338450,169110,248476.9,592200
288870,407599.9,930650,121320,165450.7,338450,167550,242149.2,592200
289230,414885.6,930650,123240,166628,338450,165990,248257.6,592200
287700,397040.7,930650,124900,168400.5,338450,162800,228640.2,592200
286050,385848.1,930650,126540,170591.9,338450,159510,215256.2,592200
284470,373237.7,930650,128180,165357.2,338450,156290,207880.5,592200
282840,349832.5,930650,129830,158723.8,338450,153010,191108.7,592200
280180,353100.3,930650,129870,152129.3,338450,150310,200971,592200
277620,315901.6,930650,129950,147083.6,338450,147670,168818,592200
275020,331423.7,930650,129990,149676,338450,145030,181747.7,592200
272440,337066.3,930650,130050,147012.8,338450,142390,190053.5,592200
270280,333455,930650,129580,143148.2,338450,140700,190306.8,592200
268100,344710.9,930650,129110,151044.7,338450,138990,193666.2,592200
265910,345999.1,930650,128630,153083.9,338450,137280,192915.2,592200
263700,346899.8,930650,128150,153038.4,338450,135550,193861.4,592200
261630,336547.8,930650,127760,148800.5,338450,133870,187747.3,592200
259470,338407.2,930650,127330,146479.2,338450,132140,191928,592200
257420,326134.7,930650,126910,134793.8,338450,130510,191340.9,592200
255260,312739.9,930650,126510,129538.5,338450,128750,183201.4,592200
248810,308571.7,930650,122530,125751.6,338450,126280,182820.1,592200
242400,296233.9,930650,118560,120324.3,338450,123840,175909.6,592200
235960,292480.2,930650,114580,115510.6,338450,121380,176969.6,592200
226680,288790,930650,107410,112042.2,338450,119270,176747.8,592200
220350,288489.9,930650,103930,110663.1,338450,116420,177826.8,592200
214030,279781.3,930650,100450,106713.8,338450,113580,173067.5,592200
207750,242438.6,930650,96990,95680.6,338450,110760,146758,592200
201410,248122.1,930650,93530,87779.8,338450,107880,160342.3,592200
194300,208147.4,930650,89080,74720.1,338450,105220,133427.3,592200
187190,191567,930650,84650,68593.9,338450,102540,122973.1,592200
180130,179919.9,930650,80200,60809.4,338450,99930,119110.5,592200
172930,180161.8,930650,75740,63373.8,338450,97190,116788,592200
165950,186090.7,930650,71550,66495.3,338450,94400,119595.4,592200
158910,175878.7,930650,67340,58937.2,338450,91570,116941.5,592200
151970,191301.1,930650,63140,59907.8,338450,88830,131393.3,592200
144940,195809.5,930650,58940,54947.2,338450,86000,140862.3,592200
137960,200404.9,930650,54840,50881.6,338450,83120,149523.3,592200
130940,187695.5,930650,50760,46856.6,338450,80180,140838.9,592200
123890,179702.9,930650,46660,43202.9,338450,77230,136500,592200
116910,171001.3,930650,42570,37824.1,338450,74340,133177.2,592200
110070,160632.1,930650,38790,30710.4,338450,71280,129921.7,592200
103020,150684.7,930650,34990,24925.7,338450,68030,125759,592200
96150,143347.6,930650,31230,21746.7,338450,64920,121600.9,592200
89180,140865.6,930650,27410,21724.8,338450,61770,119140.8,592200
83580,138770.2,930650,25430,20063.9,338450,58150,118706.3,592200
78020,136510.7,930650,23490,20238.5,338450,54530,116272.2,592200
72390,128672.2,930650,21460,18443.4,338450,50930,110228.8,592200
66700,118412.4,930650,19480,15309.7,338450,47220,103102.7,592200
61310,114319.8,930650,17660,14231.7,338450,43650,100088.1,592200
55770,109602.9,930650,15830,13559.1,338450,39940,96043.8,592200
50280,101605.1,930650,14030,11661.9,338450,36250,89943.2,592200
44780,96346.7,930650,12210,10364,338450,32570,85982.7,592200
39470,93989.9,930650,10410,9852.1,338450,29060,84137.8,592200
34240,93525.5,930650,8580,10025.1,338450,25660,83500.4,592200
28850,88225.3,930650,6780,8898.1,338450,22070,79327.2,592200
23540,86127.7,930650,4950,7675.5,338450,18590,78452.2,592200
21730,81992.1,930650,4530,7244.6,338450,17200,74747.5,592200
19860,77928.6,930650,4110,6168.2,338450,15750,71760.4,592200
18010,76126.2,930650,3670,5761.2,338450,14340,70365,592200
16140,75173.9,930650,3230,5582.9,338450,12910,69591,592200
14420,74591.8,930650,2860,5343.9,338450,11560,69247.9,592200
12660,74587.6,930650,2480,5301,338450,10180,69286.6,592200
10900,73979.1,930650,2090,5401,338450,8810,68578.1,592200
9180,74278.1,930650,1730,5401,338450,7450,68877.1,592200
7780,74239.7,930650,1440,5458.1,338450,6340,68781.6,592200
6330,74900.7,930650,1110,5501,338450,5220,69399.7,592200
4860,76176.4,930650,800,5558.1,338450,4060,70618.3,592200
3500,76535,930650,460,5576,338450,3040,70959,592200
3740,75833,930650,500,5501,338450,3240,70332,592200
3970,75932.8,930650,510,5501,338450,3460,70431.8,592200
4200,75762.7,930650,520,5501,338450,3680,70261.7,592200
4480,75193.5,930650,570,5501,338450,3910,69692.5,592200
5090,75042.8,930650,750,5460.2,338450,4340,69582.6,592200
5680,74960,930650,920,5603.4,338450,4760,69356.6,592200
6240,77001.2,930650,1080,5981.2,338450,5160,71020,592200
6850,77712.9,930650,1260,5792.5,338450,5590,71920.4,592200
7180,78331.8,930650,1320,5793,338450,5860,72538.8,592200
7530,77832.7,930650,1370,5682,338450,6160,72150.7,592200
7870,77367.3,930650,1410,5509.3,338450,6460,71858,592200
8150,78111.5,930650,1450,5629.5,338450,6700,72482,592200
8180,77951.9,930650,1420,5543.9,338450,6760,72408,592200
8160,77428.9,930650,1410,5538.5,338450,6750,71890.4,592200
8120,76399,930650,1390,5501,338450,6730,70898,592200
8150,75818.1,930650,1390,5501,338450,6760,70317.1,592200
8070,76044,930650,1410,5529.6,338450,6660,70514.4,592200
8110,72036.3,930650,1450,5413.5,338450,6660,66622.8,592200
8180,72759,930650,1490,5458.1,338450,6690,67300.9,592200
8210,72593.5,930650,1540,5451,338450,6670,67142.5,592200
8720,73150.3,930650,1950,5515.3,338450,6770,67635,592200
9150,76810,930650,2330,5713.5,338450,6820,71096.5,592200
9650,76393.2,930650,2720,5758.1,338450,6930,70635.1,592200
10160,74336.7,930650,3110,5663.5,338450,7050,68673.2,592200
12900,73539.9,930650,4770,5951.7,338450,8130,67588.2,592200
15550,72515.7,930650,6400,6087.8,338450,9150,66427.9,592200
18290,73682.8,930650,8040,6315.2,338450,10250,67367.6,592200
20970,81676.7,930650,9680,7126,338450,11290,74550.7,592200
23390,80986.9,930650,10970,7401,338450,12420,73585.9,592200
25840,81611.4,930650,12250,7663.5,338450,13590,73947.9,592200
28230,79056.6,930650,13540,7586.6,338450,14690,71470,592200
30640,86172.1,930650,14820,8263.5,338450,15820,77908.6,592200
34100,83393.6,930650,17060,8400.9,338450,17040,74992.7,592200
37620,82094,930650,19330,8563.5,338450,18290,73530.5,592200
41070,83740.5,930650,21570,8958.2,338450,19500,74782.3,592200
44450,83324.3,930650,23800,9076,338450,20650,74248.3,592200
52550,82514.9,930650,30260,9643.9,338450,22290,72871,592200
60730,80105.8,930650,36760,10201,338450,23970,69904.8,592200
68820,82265.7,930650,43220,13622.6,338450,25600,68643.1,592200
76890,87868.6,930650,49680,19251.1,338450,27210,68617.5,592200
84210,93293.7,930650,55690,25954.3,338450,28520,67339.4,592200
91560,94790.3,930650,61700,30479.4,338450,29860,64310.9,592200
98830,101458.2,930650,67720,36851.7,338450,31110,64606.5,592200
106100,109379.1,930650,73710,44445.3,338450,32390,64933.8,592200
111840,112586,930650,78360,47732.6,338450,33480,64853.4,592200
117550,114191.7,930650,83010,49051.1,338450,34540,65140.6,592200
123280,124947.8,930650,87620,55963.1,338450,35660,68984.7,592200
128990,140082.2,930650,92270,65315.6,338450,36720,74766.6,592200
127840,148501.4,930650,90820,67326.7,338450,37020,81174.7,592200
126670,162367.2,930650,89340,73227.1,338450,37330,89140.1,592200
125530,180253.2,930650,87890,84049.4,338450,37640,96203.8,592200
77320,172843.3,930650,52950,72858.9,338450,24370,99984.4,592200
77230,162884.7,930650,53090,65801.1,338450,24140,97083.6,592200
77130,173737.9,930650,53250,65974.3,338450,23880,107763.6,592200
77080,168894.2,930650,53430,63218.6,338450,23650,105675.6,592200
77000,168189.7,930650,53560,63676.2,338450,23440,104513.5,592200
76200,175828.9,930650,53070,69656.5,338450,23130,106172.4,592200
75360,180117.8,930650,52590,70255.4,338450,22770,109862.4,592200
74620,168990.5,930650,52100,63050.3,338450,22520,105940.2,592200
73810,162568.2,930650,51600,60487.5,338450,22210,102080.7,592200
72360,169225,930650,50570,66408.1,338450,21790,102816.9,592200
70890,171582.2,930650,49500,68397.8,338450,21390,103184.4,592200
69410,175991.3,930650,48490,71179.8,338450,20920,104811.5,592200
67960,151090.8,930650,47450,55278.1,338450,20510,95812.7,592200
66440,141983.7,930650,46360,50056.9,338450,20080,91926.8,592200
64920,157730,930650,45310,59099.4,338450,19610,98630.6,592200
63430,148552,930650,44250,54555.7,338450,19180,93996.3,592200
61890,154807.7,930650,43180,59265.3,338450,18710,95542.4,592200
60600,155899.9,930650,42200,58619.1,338450,18400,97280.8,592200
59300,145296.8,930650,41200,51629.4,338450,18100,93667.4,592200
58000,142327.1,930650,40200,51512.8,338450,17800,90814.3,592200
56680,148827.9,930650,39220,56262.1,338450,17460,92565.8,592200
55500,134559.2,930650,38190,45630.2,338450,17310,88929,592200
54230,128695,930650,37120,40350.3,338450,17110,88344.7,592200
53040,129101.9,930650,36080,39993.2,338450,16960,89108.7,592200
51830,114581.7,930650,35020,38974.8,338450,16810,75606.9,592200
50860,117079.3,930650,34090,42793.7,338450,16770,74285.6,592200
49800,142721.2,930650,33120,50541,338450,16680,92180.2,592200
48820,139066.9,930650,32170,46929.9,338450,16650,92137,592200
47780,125012.8,930650,31230,38156.8,338450,16550,86856,592200
46560,117643.4,930650,29880,34669,338450,16680,82974.4,592200
45460,115801.7,930650,28570,33687.3,338450,16890,82114.4,592200
44250,115596.6,930650,27280,32174.6,338450,16970,83422,592200
43060,112028.5,930650,25930,30403.8,338450,17130,81624.7,592200
43800,111821.5,930650,26740,31622.2,338450,17060,80199.3,592200
44480,105903.7,930650,27530,29334.1,338450,16950,76569.6,592200
45180,106207.3,930650,28340,30429.1,338450,16840,75778.2,592200
45970,101517.8,930650,29170,28719.2,338450,16800,72798.6,592200
45510,92566.6,930650,30110,25104.3,338450,15400,67462.3,592200
45020,98006.6,930650,31070,28637.5,338450,13950,69369.1,592200
44520,96448.8,930650,32020,28113.7,338450,12500,68335.1,592200
44070,94050.9,930650,32970,27236.1,338450,11100,66814.8,592200
45490,99711.3,930650,34430,31572.2,338450,11060,68139.1,592200
46970,101802.3,930650,35930,31712.7,338450,11040,70089.6,592200
48430,115465.4,930650,37400,36710.2,338450,11030,78755.2,592200
49870,120718.1,930650,38870,43940.1,338450,11000,76778,592200
55250,131801.4,930650,42180,53209.7,338450,13070,78591.7,592200
60550,134273.6,930650,45460,59986.1,338450,15090,74287.5,592200
65910,144350,930650,48740,60570.7,338450,17170,83779.3,592200
71270,136906.3,930650,52060,55408.2,338450,19210,81498.1,592200
77030,131787.6,930650,55610,52637.4,338450,21420,79150.2,592200
82780,146597.9,930650,59180,61755.2,338450,23600,84842.7,592200
88500,138310.7,930650,62730,56766.9,338450,25770,81543.8,592200
94340,145652.3,930650,66310,60583.5,338450,28030,85068.8,592200
99890,145108.2,930650,69800,61292.2,338450,30090,83816,592200
105480,131104.3,930650,73300,57564.9,338450,32180,73539.4,592200
111130,137743.2,930650,76800,55354.9,338450,34330,82388.3,592200
116690,140793.8,930650,80300,57419.9,338450,36390,83373.9,592200
126610,149425.4,930650,86120,63918.8,338450,40490,85506.6,592200
136490,153924,930650,91930,66808.3,338450,44560,87115.7,592200
146360,187098.3,930650,97760,86103.3,338450,48600,100995,592200
156290,200827.6,930650,103570,92405.5,338450,52720,108422.1,592200
166580,196499.4,930650,109800,90523.1,338450,56780,105976.3,592200
176940,216232.6,930650,116060,103480.1,338450,60880,112752.5,592200
187230,233088,930650,122270,114769.5,338450,64960,118318.5,592200
197580,285852.2,930650,128490,148279.9,338450,69090,137572.3,592200
208070,317311.4,930650,134660,168821.8,338450,73410,148489.6,592200
218580,305292.6,930650,140810,160890.2,338450,77770,144402.4,592200
229020,317212.5,930650,146940,170969.8,338450,82080,146242.7,592200
239430,361002.4,930650,153060,203309.6,338450,86370,157692.8,592200
242990,381033.3,930650,156000,211680,338450,86990,169353.3,592200
246560,367191.4,930650,158970,209373.7,338450,87590,157817.7,592200
250090,371381.6,930650,161920,214928.1,338450,88170,156453.5,592200
253630,348136,930650,164860,207663.5,338450,88770,140472.5,592200
256000,354931.2,930650,166950,212453.2,338450,89050,142478,592200
258430,377792.7,930650,169040,224231.2,338450,89390,153561.5,592200
260770,376029.6,930650,171090,217024.9,338450,89680,159004.7,592200
263280,349294.1,930650,173180,201679,338450,90100,147615.1,592200
264440,321563.5,930650,174590,195651.4,338450,89850,125912.1,592200
265560,299026,930650,175990,190315.6,338450,89570,108710.4,592200
266850,304156.8,930650,177420,197518.1,338450,89430,106638.7,592200
267980,314572.8,930650,178820,205589.9,338450,89160,108982.9,592200
270950,294962.2,930650,179350,194397.2,338450,91600,100565,592200
273860,327451.6,930650,179890,206526.3,338450,93970,120925.3,592200
276780,364165.4,930650,180410,213116.8,338450,96370,151048.6,592200
279710,372160.1,930650,180920,215452.7,338450,98790,156707.4,592200
283160,371811.4,930650,181440,218418.4,338450,101720,153393,592200
286530,346201.1,930650,181930,205737.8,338450,104600,140463.3,592200
290060,307832.9,930650,182460,191260.6,338450,107600,116572.3,592200
293440,308885.3,930650,182950,191349.9,338450,110490,117535.4,592200
296580,331381.9,930650,183200,194424.7,338450,113380,136957.2,592200
299700,322941.8,930650,183490,194873.9,338450,116210,128067.9,592200
302850,334706.6,930650,183750,192826,338450,119100,141880.6,592200
305920,336578.5,930650,184010,202264.3,338450,121910,134314.2,592200
311130,347000.2,930650,185310,209279.8,338450,125820,137720.4,592200
316320,355391.8,930650,186620,212194.5,338450,129700,143197.3,592200
321470,357396.6,930650,187910,216018.7,338450,133560,141377.9,592200
304020,346917.7,930650,184430,215137.9,338450,119590,131779.8,592200
306790,351913.5,930650,184980,217334.9,338450,121810,134578.6,592200
309540,344207.9,930650,185530,213858.3,338450,124010,130349.6,592200
312290,343394.7,930650,186100,212889.3,338450,126190,130505.4,592200
315010,353342.1,930650,186660,212807.7,338450,128350,140534.4,592200
317980,352701.4,930650,187180,214417,338450,130800,138284.4,592200
320910,343106.9,930650,187660,204895.6,338450,133250,138211.3,592200
323900,352882.3,930650,188170,212201.6,338450,135730,140680.7,592200
326820,372323,930650,188670,221673.9,338450,138150,150649.1,592200
325180,376273.9,930650,186790,223946.5,338450,138390,152327.4,592200
323460,387880.3,930650,184870,226463.3,338450,138590,161417,592200
321850,396084,930650,183000,228018.8,338450,138850,168065.2,592200
320130,387615.1,930650,181100,220307.4,338450,139030,167307.7,592200
317660,368860.4,930650,178540,209917.3,338450,139120,158943.1,592200
315170,391482.6,930650,175980,222060.4,338450,139190,169422.2,592200
312770,364384.7,930650,173440,204134.6,338450,139330,160250.1,592200
310250,366732.4,930650,170890,205811,338450,139360,160921.4,592200
307530,348152.2,930650,168170,195726,338450,139360,152426.2,592200
304740,338382.1,930650,165420,190076.1,338450,139320,148306,592200
302000,329604.4,930650,162710,185778.2,338450,139290,143826.2,592200
299210,331849.5,930650,159980,182140.8,338450,139230,149708.7,592200
293240,332188.3,930650,155390,179203.9,338450,137850,152984.4,592200
287220,329310.7,930650,150800,178324.5,338450,136420,150986.2,592200
281310,302329.8,930650,146210,163646.8,338450,135100,138683,592200
275350,288140.3,930650,141660,152516.1,338450,133690,135624.2,592200
269600,282696.1,930650,137480,149264.3,338450,132120,133431.8,592200
263810,279469.7,930650,133340,143073.2,338450,130470,136396.5,592200
258140,292588.8,930650,129210,146433.8,338450,128930,146155,592200
252340,284892.9,930650,125060,140768.9,338450,127280,144124,592200
247080,297231.2,930650,121340,148621,338450,125740,148610.2,592200
241770,283401.8,930650,117610,136254.4,338450,124160,147147.4,592200
236540,257571,930650,113910,120357.5,338450,122630,137213.5,592200
231210,271741.8,930650,110160,130512.1,338450,121050,141229.7,592200
225390,252875.1,930650,106920,119579.7,338450,118470,133295.4,592200
219540,247126.5,930650,103680,112620.1,338450,115860,134506.4,592200
213710,231008,930650,100440,102366.5,338450,113270,128641.5,592200
207850,222992.2,930650,97200,105578.3,338450,110650,117413.9,592200
202670,228315.8,930650,94490,106241.2,338450,108180,122074.6,592200
197480,226640.1,930650,91770,99675.3,338450,105710,126964.8,592200
192280,192934.4,930650,89060,87681.8,338450,103220,105252.6,592200
187060,166648,930650,86350,75702.4,338450,100710,90945.6,592200
181920,156552.7,930650,83610,74315.3,338450,98310,82237.4,592200
176750,175998.9,930650,80880,84160.8,338450,95870,91838.1,592200
171710,192959.1,930650,78150,88948.9,338450,93560,104010.2,592200
166560,197496.6,930650,75400,89908,338450,91160,107588.6,592200
165170,209654,930650,75480,101889.6,338450,89690,107764.4,592200
163650,222365.3,930650,75550,111165.2,338450,88100,111200.1,592200
162180,222266.4,930650,75630,114401.4,338450,86550,107865,592200
160700,183671.2,930650,75690,92270.2,338450,85010,91401,592200
159100,177553.7,930650,75540,84675.8,338450,83560,92877.9,592200
157480,189039.9,930650,75390,95210.5,338450,82090,93829.4,592200
155800,192688.3,930650,75240,102423.8,338450,80560,90264.5,592200
154160,203450.5,930650,75060,103959.9,338450,79100,99490.6,592200
152270,194843.1,930650,74570,99580.8,338450,77700,95262.3,592200
150410,215378,930650,74050,94509.8,338450,76360,120868.2,592200
148550,237296.7,930650,73540,83727.1,338450,75010,153569.6,592200
146670,253090.5,930650,73050,93273.8,338450,73620,159816.7,592200
144750,234591,930650,72940,81846.5,338450,71810,152744.5,592200
142810,223913.7,930650,72840,75854.9,338450,69970,148058.8,592200
140820,229822.8,930650,72710,79421.5,338450,68110,150401.3,592200
138920,240556.2,930650,72610,87848.4,338450,66310,152707.8,592200
137080,225864.8,930650,72640,84552.4,338450,64440,141312.4,592200
135160,239154.5,930650,72660,88725.3,338450,62500,150429.2,592200
133320,233345.9,930650,72680,87184,338450,60640,146161.9,592200
131410,228219.7,930650,72690,86329,338450,58720,141890.7,592200
129100,240505.7,930650,72370,98144,338450,56730,142361.7,592200
126810,256722.9,930650,72040,111383.1,338450,54770,145339.8,592200
124450,263772.8,930650,71710,116642,338450,52740,147130.8,592200
122140,263334.8,930650,71370,116771.9,338450,50770,146562.9,592200
117840,256019.1,930650,69660,111812.2,338450,48180,144206.9,592200
113430,253480.4,930650,67950,110527.9,338450,45480,142952.5,592200
109150,280833.7,930650,66250,129611.1,338450,42900,151222.6,592200
104740,300482.5,930650,64540,145134.6,338450,40200,155347.9,592200
100330,266454.8,930650,62880,125941.6,338450,37450,140513.2,592200
95830,243161.3,930650,61200,112679.5,338450,34630,130481.8,592200
91420,267720.4,930650,59540,127239.1,338450,31880,140481.3,592200
87010,286416,930650,57870,141970.2,338450,29140,144445.8,592200
82750,290567,930650,56440,146040.7,338450,26310,144526.3,592200
78580,297435.3,930650,55030,150436.2,338450,23550,146999.1,592200
74340,305150,930650,53590,156067,338450,20750,149083,592200
70170,275977.9,930650,52170,138779.1,338450,18000,137198.8,592200
70750,253019.6,930650,52570,125406,338450,18180,127613.6,592200
71390,230804.6,930650,52970,111382.3,338450,18420,119422.3,592200
72020,211633,930650,53380,99359,338450,18640,112274,592200
72620,195554.5,930650,53780,88393.2,338450,18840,107161.3,592200
72640,205357.6,930650,53510,94018.2,338450,19130,111339.4,592200
72690,214009.4,930650,53240,99192,338450,19450,114817.4,592200
72750,202577.4,930650,52970,90699.9,338450,19780,111877.5,592200
72800,202679.7,930650,52710,90778.8,338450,20090,111900.9,592200
72810,216716.8,930650,52430,99745.5,338450,20380,116971.3,592200
72810,193446,930650,52150,84918.4,338450,20660,108527.6,592200
72920,180830.8,930650,51850,77044,338450,21070,103786.8,592200
72910,171880,930650,51570,70655.6,338450,21340,101224.4,592200
69840,166448.2,930650,49050,68489.1,338450,20790,97959.1,592200
66740,164475.8,930650,46500,67194.4,338450,20240,97281.4,592200
63610,156102.8,930650,43980,61441.6,338450,19630,94661.2,592200
52040,155289.9,930650,42550,61443.6,338450,9490,93846.3,592200
50290,169684.1,930650,41170,72302.2,338450,9120,97381.9,592200
48670,167638.9,930650,39770,70237,338450,8900,97401.9,592200
47030,179149.4,930650,38390,78186.6,338450,8640,100962.8,592200
45350,171564.1,930650,37010,73707.3,338450,8340,97856.8,592200
43820,160467.7,930650,35660,66083.6,338450,8160,94384.1,592200
42270,157071.3,930650,34310,62578.1,338450,7960,94493.2,592200
40710,161865.3,930650,32940,64455.9,338450,7770,97409.4,592200
39220,168515.4,930650,31610,67385.2,338450,7610,101130.2,592200
40280,165585.7,930650,32270,64517.7,338450,8010,101068,592200
41400,152579.2,930650,32960,56839.2,338450,8440,95740,592200
42460,146349.4,930650,33590,52683.4,338450,8870,93666,592200
43560,124396.2,930650,34260,41345.5,338450,9300,83050.7,592200
44110,103409.1,930650,34390,28456.4,338450,9720,74952.7,592200
44740,115001.1,930650,34580,33532.2,338450,10160,81468.9,592200
45300,121087.7,930650,34700,35080.6,338450,10600,86007.1,592200
45940,121799.2,930650,34880,33083,338450,11060,88716.2,592200
46630,118158.2,930650,35260,31081.8,338450,11370,87076.4,592200
47460,130304.8,930650,35630,36528.7,338450,11830,93776.1,592200
48200,145040.4,930650,35980,44052,338450,12220,100988.4,592200
49030,141947.9,930650,36370,43380.4,338450,12660,98567.5,592200
52200,141966.2,930650,37940,43233.2,338450,14260,98733,592200
55380,131749.5,930650,39530,36641.7,338450,15850,95107.8,592200
58550,130629.6,930650,41120,32586,338450,17430,98043.6,592200
61690,143710.1,930650,42670,36959,338450,19020,106751.1,592200
64640,145100.4,930650,44110,36467.9,338450,20530,108632.5,592200
67550,146988.5,930650,45510,35842.5,338450,22040,111146,592200
70560,170236.2,930650,46920,49322,338450,23640,120914.2,592200
73420,179837.3,930650,48320,50732.1,338450,25100,129105.2,592200
77130,197338.6,930650,50360,57049.5,338450,26770,140289.1,592200
80890,219158.5,930650,52390,67186.7,338450,28500,151971.8,592200
84540,225706,930650,54450,75053.3,338450,30090,150652.7,592200
88260,219415,930650,56500,74566.3,338450,31760,144848.7,592200
92660,217746.2,930650,58990,77325.2,338450,33670,140421,592200
97140,210296.9,930650,61530,77534.9,338450,35610,132762,592200
101620,180626.7,930650,64060,68429.9,338450,37560,112196.8,592200
106150,163791.9,930650,66610,61759.2,338450,39540,102032.7,592200
109640,174582.7,930650,68440,69162.8,338450,41200,105419.9,592200
113250,191242.2,930650,70330,80362.3,338450,42920,110879.9,592200
116740,230048,930650,72180,101827.5,338450,44560,128220.5,592200
120340,255490.2,930650,74050,111366.1,338450,46290,144124.1,592200
124480,264752.8,930650,76280,116741.5,338450,48200,148011.3,592200
128600,269547.7,930650,78550,118939.3,338450,50050,150608.4,592200
132690,276352,930650,80800,126654.5,338450,51890,149697.5,592200
136870,279420.8,930650,83070,129391.9,338450,53800,150028.9,592200
140010,327372.8,930650,85850,153215,338450,54160,174157.8,592200
143220,341076,930650,88680,161015.4,338450,54540,180060.6,592200
146350,313081.2,930650,91460,153290.2,338450,54890,159791,592200
149530,313388.7,930650,94260,157654.8,338450,55270,155733.9,592200
152490,327836.5,930650,97030,159020.5,338450,55460,168816,592200
155540,369347.6,930650,99820,184582.8,338450,55720,184764.8,592200
158540,365294.7,930650,102570,183507.3,338450,55970,181787.4,592200
161580,385462.7,930650,105350,198030.9,338450,56230,187431.8,592200
164440,407193.1,930650,108010,208529.7,338450,56430,198663.4,592200
167360,420124.5,930650,110660,211623.6,338450,56700,208500.9,592200
170190,413930.3,930650,113310,215074.6,338450,56880,198855.7,592200
173080,398484.5,930650,115970,213194.1,338450,57110,185290.4,592200
175060,399886.7,930650,117870,215895.6,338450,57190,183991.1,592200
177120,380475,930650,119790,213009.7,338450,57330,167465.3,592200
179150,387361.9,930650,121690,211595.3,338450,57460,175766.6,592200
181140,376099.4,930650,123590,212861.3,338450,57550,163238.1,592200
183600,390369,930650,125870,223463.1,338450,57730,166905.9,592200
186040,389323,930650,128150,222566.2,338450,57890,166756.8,592200
188510,382641,930650,130440,216871.9,338450,58070,165769.1,592200
190910,378946.8,930650,132710,216714.9,338450,58200,162231.9,592200
193000,391352.1,930650,134730,218409.5,338450,58270,172942.6,592200
195170,371447.9,930650,136740,217872.6,338450,58430,153575.3,592200
197280,369763.8,930650,138760,215342.4,338450,58520,154421.4,592200
199410,370012,930650,140780,217101.6,338450,58630,152910.4,592200
196060,368896.9,930650,138880,218609.4,338450,57180,150287.5,592200
192690,378201.4,930650,136980,214775.3,338450,55710,163426.1,592200
189380,361203.9,930650,135120,214731,338450,54260,146472.9,592200
186090,356979.1,930650,133230,212401.9,338450,52860,144577.2,592200
182640,373011.2,930650,131330,204512.3,338450,51310,168498.9,592200
179220,373349.9,930650,129420,201273.5,338450,49800,172076.4,592200
175720,370960.8,930650,127500,201661.2,338450,48220,169299.6,592200
172270,337574.8,930650,125570,191811.1,338450,46700,145763.7,592200
169020,319270.8,930650,123690,173708,338450,45330,145562.8,592200
165790,320115.9,930650,121780,176323.6,338450,44010,143792.3,592200
162490,312930.2,930650,119880,172900.3,338450,42610,140029.9,592200
159220,271006,930650,117970,156850.5,338450,41250,114155.5,592200
155460,275806.6,930650,114670,150032.9,338450,40790,125773.7,592200
151590,273762.9,930650,111350,147629.9,338450,40240,126133,592200
147790,246207.8,930650,108060,127544.3,338450,39730,118663.5,592200
143960,240326.5,930650,104760,123892.5,338450,39200,116434,592200
140290,219326.2,930650,101630,109049.2,338450,38660,110277,592200
136630,203758.4,930650,98520,98622.7,338450,38110,105135.7,592200
132960,200803.8,930650,95380,94704.7,338450,37580,106099.1,592200
129280,203336.4,930650,92250,94146.4,338450,37030,109190,592200
126060,188751.4,930650,89490,84022.8,338450,36570,104728.6,592200
122800,185497,930650,86710,81422.1,338450,36090,104074.9,592200
119570,191555.6,930650,83980,86200.9,338450,35590,105354.7,592200
116410,178365.4,930650,81220,77952.2,338450,35190,100413.2,592200
112100,176655.1,930650,77320,73957,338450,34780,102698.1,592200
107890,179995.7,930650,73460,73553.9,338450,34430,106441.8,592200
103670,193171.3,930650,69580,83099.8,338450,34090,110071.5,592200
92110,63969.4,930650,67600,3375.7,338450,24510,60593.7,592200
88680,62505.1,930650,65350,2523.8,338450,23330,59981.3,592200
85330,60316.1,930650,63110,2540.1,338450,22220,57776,592200
81950,136326.4,930650,60880,48615.3,338450,21070,87711.1,592200
78570,137340.1,930650,58650,47762.4,338450,19920,89577.7,592200
76690,136314.6,930650,57940,47433.6,338450,18750,88881,592200
74850,134209.4,930650,57230,47582.3,338450,17620,86627.1,592200
72950,127683.1,930650,56500,45067.3,338450,16450,82615.8,592200
71140,125737.6,930650,55800,45518.1,338450,15340,80219.5,592200
70010,111777.7,930650,54280,35902.9,338450,15730,75874.8,592200
68770,110236.2,930650,52750,33426.9,338450,16020,76809.3,592200
67620,105946.2,930650,51220,30789.3,338450,16400,75156.9,592200
66390,105148.4,930650,49670,31146.4,338450,16720,74002,592200
64790,100694.9,930650,47740,27263.9,338450,17050,73431,592200
63170,93004.6,930650,45850,22604.6,338450,17320,70400,592200
61510,92577.2,930650,43910,22163.2,338450,17600,70414,592200
59840,86426.2,930650,41980,18191.5,338450,17860,68234.7,592200
58870,87040.3,930650,40600,19076.9,338450,18270,67963.4,592200
57840,83790.3,930650,39260,17296.1,338450,18580,66494.2,592200
56850,82143.5,930650,37880,16184.5,338450,18970,65959,592200
55850,89771.5,930650,36510,20638.3,338450,19340,69133.2,592200
56920,88126.8,930650,37310,19503,338450,19610,68623.8,592200
58020,88992.5,930650,38110,20216.6,338450,19910,68775.9,592200
59060,118624.7,930650,38920,39703.3,338450,20140,78921.4,592200
60150,95521.5,930650,39710,23710.6,338450,20440,71810.9,592200
60650,97752.1,930650,39990,26490.8,338450,20660,71261.3,592200
61170,95108.9,930650,40250,23486.3,338450,20920,71622.6,592200
61690,89023.5,930650,40530,18590.7,338450,21160,70432.8,592200
62180,94890.2,930650,40790,20638.5,338450,21390,74251.7,592200
63460,89536.7,930650,41900,15480.7,338450,21560,74056,592200
64710,94830.2,930650,43010,15294.9,338450,21700,79535.3,592200
65900,107086.7,930650,44140,20200.4,338450,21760,86886.3,592200
67180,115356.7,930650,45230,22639.1,338450,21950,92717.6,592200
68400,124556.5,930650,46670,26896.9,338450,21730,97659.6,592200
69550,124326.9,930650,48100,27190.4,338450,21450,97136.5,592200
70760,128014.8,930650,49540,28403.6,338450,21220,99611.2,592200
71930,116658.2,930650,50970,25945.6,338450,20960,90712.6,592200
73030,97188.9,930650,52620,20258.3,338450,20410,76930.6,592200
74100,87348.1,930650,54280,17462,338450,19820,69886.1,592200
75180,84347.4,930650,55930,18843.3,338450,19250,65504.1,592200
76270,84039.3,930650,57600,20004,338450,18670,64035.3,592200
77220,86507.9,930650,58730,22147.5,338450,18490,64360.4,592200
78150,87790.8,930650,59850,22579.3,338450,18300,65211.5,592200
79110,95953.2,930650,60960,27163.1,338450,18150,68790.1,592200
80100,106124,930650,62100,32583.1,338450,18000,73540.9,592200
85280,110128.5,930650,62980,34073.8,338450,22300,76054.7,592200
90450,105406.9,930650,63850,30225.8,338450,26600,75181.1,592200
95590,119863.5,930650,64720,40385.8,338450,30870,79477.7,592200
100800,126250.4,930650,65570,44645.1,338450,35230,81605.3,592200
105400,122425.4,930650,65690,48201.1,338450,39710,74224.3,592200
110130,141273.9,930650,65790,51101.3,338450,44340,90172.6,592200
114790,139173.7,930650,65920,47322.7,338450,48870,91851,592200
119410,131003.1,930650,66030,40242.5,338450,53380,90760.6,592200
124040,122836.6,930650,66040,33049.1,338450,58000,89787.5,592200
128630,122914.1,930650,66060,30407,338450,62570,92507.1,592200
133280,116222.7,930650,66100,26244,338450,67180,89978.7,592200
137900,114513.5,930650,66090,25672.3,338450,71810,88841.2,592200
144670,117241.3,930650,70090,27275.5,338450,74580,89965.8,592200
151410,116007.4,930650,74100,29437.3,338450,77310,86570.1,592200
158180,105193.7,930650,78090,29981,338450,80090,75212.7,592200
164990,123891.5,930650,82120,35159,338450,82870,88732.5,592200
173330,142024.3,930650,87630,46865.2,338450,85700,95159.1,592200
181740,170095,930650,93160,64143.8,338450,88580,105951.2,592200
190030,192703.1,930650,98650,78113.1,338450,91380,114590,592200
198450,205179.5,930650,104170,86384.9,338450,94280,118794.6,592200
205060,200936.1,930650,108420,87896.2,338450,96640,113039.9,592200
211670,207370.1,930650,112680,92901.4,338450,98990,114468.7,592200
218320,215496.2,930650,116930,99036.9,338450,101390,116459.3,592200
224930,240068,930650,121180,113801.3,338450,103750,126266.7,592200
222090,294708.3,930650,121910,149569.7,338450,100180,145138.6,592200
219340,288648.5,930650,122660,150108.3,338450,96680,138540.2,592200
216570,252741.8,930650,123370,134645.9,338450,93200,118095.9,592200
213820,224308.8,930650,124110,112538.8,338450,89710,111770,592200
211110,222664,930650,125750,114766.6,338450,85360,107897.4,592200
208460,238696,930650,127370,135031.7,338450,81090,103664.3,592200
205800,279433.3,930650,129020,152787.1,338450,76780,126646.2,592200
203090,276226.5,930650,130630,154149.5,338450,72460,122077,592200
200680,294352.8,930650,132590,167320.4,338450,68090,127032.4,592200
198130,278436,930650,134510,167529.3,338450,63620,110906.7,592200
195520,271566.5,930650,136410,159333.3,338450,59110,112233.2,592200
193130,255450.9,930650,138360,152936.2,338450,54770,102514.7,592200
189790,251197.2,930650,135510,142843.3,338450,54280,108353.9,592200
186520,257938.9,930650,132700,146621.9,338450,53820,111317,592200
183200,261309,930650,129860,147696.2,338450,53340,113612.8,592200
179920,263061.3,930650,127040,148371,338450,52880,114690.3,592200
176110,257728.9,930650,123660,144970.7,338450,52450,112758.2,592200
172310,261998.9,930650,120290,147269,338450,52020,114729.9,592200
168610,266512,930650,116930,150067.8,338450,51680,116444.2,592200
164770,264002.9,930650,113560,148112.1,338450,51210,115890.8,592200
162320,257663.1,930650,111550,143185,338450,50770,114478.1,592200
159860,274524,930650,109540,153026.3,338450,50320,121497.7,592200
157390,303117.8,930650,107510,169374,338450,49880,133743.8,592200
154950,323852.9,930650,105480,181875.6,338450,49470,141977.3,592200
153960,336777.5,930650,101550,189027.8,338450,52410,147749.7,592200
152910,346422.2,930650,97560,192713.9,338450,55350,153708.3,592200
151980,334779.6,930650,93620,182801.9,338450,58360,151977.7,592200
122130,207194.4,930650,80750,98714.5,338450,41380,108479.9,592200
118530,254992.9,930650,76390,130100.1,338450,42140,124892.8,592200
114960,209746.5,930650,72040,98853.7,338450,42920,110892.8,592200
111390,168335.1,930650,67680,69502.4,338450,43710,98832.7,592200
107750,119533.9,930650,63300,36911.8,338450,44450,82622.1,592200
105290,124737,930650,60420,39679.4,338450,44870,85057.6,592200
102940,163627.8,930650,57580,62715.3,338450,45360,100912.5,592200
100440,174699.3,930650,54730,66041.9,338450,45710,108657.4,592200
98070,169817,930650,51890,61921.1,338450,46180,107895.9,592200
101730,171568.7,930650,53940,64382.6,338450,47790,107186.1,592200
105440,155059.2,930650,56030,52145.6,338450,49410,102913.6,592200
109170,147320.4,930650,58080,46433,338450,51090,100887.4,592200
112850,142630.3,930650,60170,45033.4,338450,52680,97596.9,592200
116600,156533.2,930650,62230,54261.1,338450,54370,102272.1,592200
120350,172313.9,930650,64320,60887.3,338450,56030,111426.6,592200
124050,188400.3,930650,66390,71107.1,338450,57660,117293.2,592200
127800,190526.6,930650,68490,74860.2,338450,59310,115666.4,592200
133780,187901.2,930650,72830,73081.6,338450,60950,114819.6,592200
139770,175112.4,930650,77140,69126.1,338450,62630,105986.3,592200
145730,189228.6,930650,81460,70633.1,338450,64270,118595.5,592200
151720,216160.5,930650,85780,79230.2,338450,65940,136930.3,592200
157530,218021.3,930650,89660,75202,338450,67870,142819.3,592200
163380,226076,930650,93560,82637.3,338450,69820,143438.7,592200
169170,252238.6,930650,97420,97792.8,338450,71750,154445.8,592200
174960,238952.5,930650,101320,92771.5,338450,73640,146181,592200
181020,195057.9,930650,104640,73669.5,338450,76380,121388.4,592200
187020,200870.2,930650,107980,84798.5,338450,79040,116071.7,592200
193060,221394.7,930650,111300,96956,338450,81760,124438.7,592200
199030,240404.7,930650,114620,105486.3,338450,84410,134918.4,592200
202680,231551.4,930650,116140,99482.6,338450,86540,132068.8,592200
206310,264917.5,930650,117600,118458.9,338450,88710,146458.6,592200
209980,279675.4,930650,119090,116471.6,338450,90890,163203.8,592200
213690,229775.5,930650,120600,87163.7,338450,93090,142611.8,592200
215190,247133.4,930650,119320,98054.4,338450,95870,149079,592200
216780,260712.8,930650,118040,104657.9,338450,98740,156054.9,592200
218370,230755,930650,116760,87209.5,338450,101610,143545.5,592200
219870,222328.9,930650,115480,83655.8,338450,104390,138673.1,592200
222090,231611.8,930650,114750,89247.2,338450,107340,142364.6,592200
224340,226267.6,930650,113990,83909.8,338450,110350,142357.8,592200
226550,217281,930650,113240,78374.7,338450,113310,138906.3,592200
228840,210107.2,930650,112540,80523.1,338450,116300,129584.1,592200
230440,231519.2,930650,111410,92179,338450,119030,139340.2,592200
232010,230574.9,930650,110290,95718.4,338450,121720,134856.5,592200
233660,202927.5,930650,109180,87817.7,338450,124480,115109.8,592200
235280,243703.4,930650,108080,97205,338450,127200,146498.4,592200
238480,309668.6,930650,105590,129841.4,338450,132890,179827.2,592200
241690,284498.9,930650,103130,114949.1,338450,138560,169549.8,592200
244920,280562.4,930650,100650,113467.6,338450,144270,167094.8,592200
248130,296024.1,930650,98170,114367.2,338450,149960,181656.9,592200
252110,277828.6,930650,95960,99336.5,338450,156150,178492.1,592200
256060,297973.5,930650,93790,108151.3,338450,162270,189822.2,592200
260050,338146.4,930650,91610,127396.6,338450,168440,210749.8,592200
264010,314489.1,930650,89440,109433.3,338450,174570,205055.8,592200
266550,288584.3,930650,87690,81972.7,338450,178860,206611.6,592200
269070,280883.8,930650,85950,68291.6,338450,183120,212592.2,592200
271660,288982,930650,84230,71022.7,338450,187430,217959.3,592200
274240,281751,930650,82480,78128.6,338450,191760,203622.4,592200
268480,271780.2,930650,79250,73029.1,338450,189230,198751.1,592200
262740,276709.8,930650,76020,77203.3,338450,186720,199506.5,592200
256970,285186.4,930650,72760,82608.4,338450,184210,202578,592200
251250,310924.5,930650,69540,91730.8,338450,181710,219193.7,592200
246160,305906.2,930650,66690,87389.8,338450,179470,218516.4,592200
241080,310507.3,930650,63820,87174.7,338450,177260,223332.6,592200
236140,295765.4,930650,61000,82529.4,338450,175140,213236,592200
231050,309975.2,930650,58110,93325.1,338450,172940,216650.1,592200
225620,286855,930650,55400,82198.2,338450,170220,204656.8,592200
220190,264981.3,930650,52700,70440.3,338450,167490,194541,592200
214720,269484.7,930650,49990,61795.6,338450,164730,207689.1,592200
209370,260265.1,930650,47290,59962.3,338450,162080,200302.8,592200
203070,274176.7,930650,45630,62569.1,338450,157440,211607.6,592200
196750,274437.7,930650,43960,54852.7,338450,152790,219585,592200
190430,250276.8,930650,42320,45750,338450,148110,204526.8,592200
184150,256214.3,930650,40640,51818,338450,143510,204396.3,592200
177490,304514.2,930650,38820,74139.6,338450,138670,230374.6,592200
170900,318355.6,930650,37020,79945.5,338450,133880,238410.1,592200
164210,279809.9,930650,35200,60050.2,338450,129010,219759.7,592200
157600,272548.1,930650,33380,53720.1,338450,124220,218828,592200
150840,258586.5,930650,31640,45609.9,338450,119200,212976.6,592200
144170,242081.6,930650,29880,38258,338450,114290,203823.6,592200
137420,214144.7,930650,28130,30622,338450,109290,183522.7,592200
130680,196659.4,930650,26370,21702.9,338450,104310,174956.5,592200
127670,173649.2,930650,25710,14971,338450,101960,158678.2,592200
124620,159628.5,930650,25070,12829.8,338450,99550,146798.7,592200
121600,157852.9,930650,24410,14315.6,338450,97190,143537.3,592200
118580,163418.7,930650,23750,17233.1,338450,94830,146185.6,592200
115880,158617.2,930650,23180,15925.1,338450,92700,142692.1,592200
113100,160891.3,930650,22610,16692,338450,90490,144199.3,592200
110330,161270.4,930650,22040,16352.3,338450,88290,144918.1,592200
107530,151352.1,930650,21460,11563.4,338450,86070,139788.7,592200
104940,148121.2,930650,21010,12060.3,338450,83930,136060.9,592200
102260,147399.9,930650,20560,11075.1,338450,81700,136324.8,592200
99640,143877.7,930650,20130,13467.5,338450,79510,130410.2,592200
97030,143367.4,930650,19680,13973.5,338450,77350,129393.9,592200
97530,140844.3,930650,19930,14490.2,338450,77600,126354.1,592200
98080,136466.2,930650,20210,13095.4,338450,77870,123370.8,592200
98680,137140.2,930650,20490,13822.4,338450,78190,123317.8,592200
104010,119225.4,930650,19340,12024.6,338450,84670,107200.8,592200
103300,113200.6,930650,19530,10791.9,338450,83770,102408.7,592200
102720,112313,930650,19760,9995.2,338450,82960,102317.8,592200
102110,119313.6,930650,19960,10529.7,338450,82150,108783.9,592200
101470,115688,930650,20140,10952.1,338450,81330,104735.9,592200
101310,148997.5,930650,20150,23232.7,338450,81160,125764.8,592200
101140,156855.3,930650,20140,21080.1,338450,81000,135775.2,592200
100940,150520.2,930650,20130,16747.5,338450,80810,133772.7,592200
100740,165122.5,930650,20140,25113.1,338450,80600,140009.4,592200
102690,155546.3,930650,20810,20138.3,338450,81880,135408,592200
104650,152845.7,930650,21540,20441.6,338450,83110,132404.1,592200
106570,158366.8,930650,22210,24882.6,338450,84360,133484.2,592200
108490,161928.8,930650,22910,27062.2,338450,85580,134866.6,592200
109720,154900.8,930650,23420,23192.3,338450,86300,131708.5,592200
110910,149763.2,930650,23910,21080.7,338450,87000,128682.5,592200
112170,137475.1,930650,24400,15276.8,338450,87770,122198.3,592200
113360,136991.3,930650,24910,15386.7,338450,88450,121604.6,592200
113690,133045.7,930650,25210,13687,338450,88480,119358.7,592200
113950,132146.7,930650,25490,13197.1,338450,88460,118949.6,592200
114210,134063.7,930650,25820,13812.2,338450,88390,120251.5,592200
114490,144591.1,930650,26120,16688.6,338450,88370,127902.5,592200
115800,153401.3,930650,26950,20196.4,338450,88850,133204.9,592200
117030,145331.9,930650,27780,17101.8,338450,89250,128230.1,592200
118270,160068,930650,28600,27067.7,338450,89670,133000.3,592200
119540,182296.5,930650,29420,38988.6,338450,90120,143307.9,592200
120930,182927.4,930650,30380,40878.8,338450,90550,142048.6,592200
122220,171951.3,930650,31350,34917.3,338450,90870,137034,592200
123570,166136.8,930650,32290,29326.1,338450,91280,136810.7,592200
124950,165692.4,930650,33280,28333.2,338450,91670,137359.2,592200
126500,163750.6,930650,34280,26796.8,338450,92220,136953.8,592200
128110,158257.8,930650,35260,22449.4,338450,92850,135808.4,592200
129670,156584.8,930650,36270,20951.7,338450,93400,135633.1,592200
131240,161921.3,930650,37270,22732.3,338450,93970,139189,592200
133690,169384.6,930650,38020,26366.9,338450,95670,143017.7,592200
136190,174096.4,930650,38800,29398.2,338450,97390,144698.2,592200
138660,174381.3,930650,39560,28318.8,338450,99100,146062.5,592200
141000,175895.2,930650,40330,30110.4,338450,100670,145784.8,592200
143260,174125.2,930650,40670,29497.1,338450,102590,144628.1,592200
145410,172165.8,930650,40990,30349.3,338450,104420,141816.5,592200
147670,161983.8,930650,41320,27648.4,338450,106350,134335.4,592200
149820,152468.2,930650,41640,23428.5,338450,108180,129039.7,592200
151720,148877.3,930650,41800,21072.4,338450,109920,127804.9,592200
153580,147341.7,930650,41960,20280.2,338450,111620,127061.5,592200
155480,157005.8,930650,42090,23246,338450,113390,133759.8,592200
157420,157372.5,930650,42270,21439.5,338450,115150,135933,592200
161980,169406.3,930650,44150,21826,338450,117830,147580.3,592200
166670,172978.8,930650,46060,21931.2,338450,120610,151047.6,592200
171310,178205.6,930650,47950,24431.9,338450,123360,153773.7,592200
175990,186139.8,930650,49870,24194.6,338450,126120,161945.2,592200
181150,184127.9,930650,52140,25930.5,338450,129010,158197.4,592200
186380,184523.7,930650,54370,24499.3,338450,132010,160024.4,592200
191590,185645.2,930650,56650,24107.1,338450,134940,161538.1,592200
196750,208009.2,930650,58890,32680.3,338450,137860,175328.9,592200
202040,215159.7,930650,61120,36280.5,338450,140920,178879.2,592200
207320,218840.2,930650,63340,48538.5,338450,143980,170301.7,592200
212610,245651.4,930650,65590,64299.1,338450,147020,181352.3,592200
217830,241785.5,930650,67800,58121.5,338450,150030,183664,592200
222690,239360.9,930650,70250,56002.4,338450,152440,183358.5,592200
227460,254630.8,930650,72710,62700.4,338450,154750,191930.4,592200
232240,273010.5,930650,75130,73746.6,338450,157110,199263.9,592200
237000,289928.2,930650,77580,87254.3,338450,159420,202673.9,592200
242180,292998,930650,80430,82651.4,338450,161750,210346.6,592200
247190,308256.6,930650,83240,94039.2,338450,163950,214217.4,592200
252340,295723.7,930650,86110,85805.9,338450,166230,209917.8,592200
257480,310405.6,930650,88930,92335.3,338450,168550,218070.3,592200
263510,335752.2,930650,92130,101162,338450,171380,234590.2,592200
269460,319081.5,930650,95290,93983.4,338450,174170,225098.1,592200
275510,331928.3,930650,98470,102072.3,338450,177040,229856,592200
281490,362542.8,930650,101650,114477.1,338450,179840,248065.7,592200
284750,387762.1,930650,103830,122549.7,338450,180920,265212.4,592200
288050,392916.1,930650,106010,131686.3,338450,182040,261229.8,592200
291290,423635.5,930650,108200,149058.7,338450,183090,274576.8,592200
294580,450780.5,930650,110390,156798.2,338450,184190,293982.3,592200
297620,442990.5,930650,112770,152245.8,338450,184850,290744.7,592200
300630,418382.4,930650,115160,138755.4,338450,185470,279627,592200
303670,422144.2,930650,117570,145855.8,338450,186100,276288.4,592200
306700,452142.6,930650,119950,170805.6,338450,186750,281337,592200
310360,423267.9,930650,122620,155288,338450,187740,267979.9,592200
313960,405872.7,930650,125250,151995.3,338450,188710,253877.4,592200
317610,406939,930650,127890,158910.4,338450,189720,248028.6,592200
321290,417469.8,930650,130540,160675.9,338450,190750,256793.9,592200
320800,396868.8,930650,129890,153751.8,338450,190910,243117,592200
320320,376474.6,930650,129230,148311.2,338450,191090,228163.4,592200
319830,350040.9,930650,128570,139163.7,338450,191260,210877.2,592200
319370,349777.9,930650,127950,145148.4,338450,191420,204629.5,592200
316410,356448.1,930650,126580,151364.3,338450,189830,205083.8,592200
313470,354939,930650,125240,146782.8,338450,188230,208156.2,592200
310600,367496.1,930650,123880,154271.2,338450,186720,213224.9,592200
307700,342028.1,930650,122560,135592.8,338450,185140,206435.3,592200
304420,341347.6,930650,120930,132182,338450,183490,209165.6,592200
301170,324238.2,930650,119320,125260.5,338450,181850,198977.7,592200
297870,299949.9,930650,117690,110380.9,338450,180180,189569,592200
294730,279888.7,930650,116090,101226.5,338450,178640,178662.2,592200
285630,265719.4,930650,112560,93901.6,338450,173070,171817.8,592200
276440,258204.7,930650,109030,86534.2,338450,167410,171670.5,592200
267390,257798.4,930650,105500,84303.3,338450,161890,173495.1,592200
255880,262303.3,930650,95070,87748.4,338450,160810,174554.9,592200
249200,260040.5,930650,90850,77759.7,338450,158350,182280.8,592200
242410,266577.6,930650,86640,75569.4,338450,155770,191008.2,592200
235750,256677.3,930650,82420,73084,338450,153330,183593.3,592200
229000,248338.2,930650,78210,72479.7,338450,150790,175858.5,592200
222330,230195.5,930650,74330,61528.6,338450,148000,168666.9,592200
215560,202381.2,930650,70460,45592.8,338450,145100,156788.4,592200
208880,194841.6,930650,66590,38862.7,338450,142290,155978.9,592200
202190,194069.7,930650,62740,37345.3,338450,139450,156724.4,592200
194060,203721.9,930650,59710,41915.2,338450,134350,161806.7,592200
185970,204013.6,930650,56700,42111.1,338450,129270,161902.5,592200
177860,211480.6,930650,53690,46981.7,338450,124170,164498.9,592200
169800,207764.8,930650,50690,45993.4,338450,119110,161771.4,592200
161880,194690.5,930650,47660,42435.1,338450,114220,152255.4,592200
154020,180493,930650,44610,36523.9,338450,109410,143969.1,592200
146140,173605.9,930650,41590,33049.9,338450,104550,140556,592200
138360,168611,930650,38560,32017.9,338450,99800,136593.1,592200
130770,165680.1,930650,35710,29395,338450,95060,136285.1,592200
123200,162895.1,930650,32820,28980.3,338450,90380,133914.8,592200
115580,161888.5,930650,29920,29821.5,338450,85660,132067,592200
108020,165737.2,930650,27050,31661.7,338450,80970,134075.5,592200
103430,168402.7,930650,25640,30789.3,338450,77790,137613.4,592200
98820,164454.4,930650,24240,30327.1,338450,74580,134127.3,592200
94290,158501.9,930650,22840,28508.8,338450,71450,129993.1,592200
89690,149036.7,930650,21430,23856.2,338450,68260,125180.5,592200
84770,152059.6,930650,19960,24518.1,338450,64810,127541.5,592200
79940,142492.2,930650,18480,21909.5,338450,61460,120582.7,592200
74990,127181.7,930650,17010,15519.8,338450,57980,111661.9,592200
70140,117653,930650,15530,12544.2,338450,54610,105108.8,592200
65220,109829.4,930650,14120,11037.1,338450,51100,98792.3,592200
60270,106024.8,930650,12720,10264,338450,47550,95760.8,592200
55330,103243.7,930650,11320,9183,338450,44010,94060.7,592200
50370,101394,930650,9900,8440.5,338450,40470,92953.5,592200
47190,96280.9,930650,9200,6738.3,338450,37990,89542.6,592200
43930,86651.2,930650,8470,5552.5,338450,35460,81098.7,592200
40680,84776.7,930650,7760,5541.3,338450,32920,79235.4,592200
37520,81815.3,930650,7040,5076.1,338450,30480,76739.2,592200
34910,80248.3,930650,6640,4682.8,338450,28270,75565.5,592200
32300,78005.9,930650,6260,4401,338450,26040,73604.9,592200
29670,76142.6,930650,5880,4415.2,338450,23790,71727.4,592200
27040,74976.6,930650,5490,4388.5,338450,21550,70588.1,592200
23960,74098.5,930650,4630,4401,338450,19330,69697.5,592200
20770,74187.3,930650,3770,4413.5,338450,17000,69773.8,592200
17660,74271.1,930650,2890,4501,338450,14770,69770.1,592200
14580,74274.5,930650,2050,4588.5,338450,12530,69686,592200
13750,74724.3,930650,2010,4801,338450,11740,69923.3,592200
12900,74392.2,930650,2000,4788.5,338450,10900,69603.7,592200
12010,73853.2,930650,1950,4801,338450,10060,69052.2,592200
11170,74245.5,930650,1920,4801,338450,9250,69444.5,592200
10690,73919.6,930650,2320,4858.1,338450,8370,69061.5,592200
10200,75184.3,930650,2700,4951,338450,7500,70233.3,592200
9730,74663,930650,3110,4958.2,338450,6620,69704.8,592200
9240,73429.8,930650,3480,4913.6,338450,5760,68516.2,592200
8360,73133.1,930650,3460,4986.8,338450,4900,68146.3,592200
7460,73291.4,930650,3400,5058.1,338450,4060,68233.3,592200
6540,74048.6,930650,3360,5215.3,338450,3180,68833.3,592200
5670,73736.8,930650,3340,5288.5,338450,2330,68448.3,592200
5860,73784.9,930650,3530,5579.8,338450,2330,68205.1,592200
6080,72942.4,930650,3680,5237.8,338450,2400,67704.6,592200
6320,73017.1,930650,3860,5286.7,338450,2460,67730.4,592200
6460,72894.4,930650,4030,5188.5,338450,2430,67705.9,592200
7070,72432.5,930650,4590,5115.3,338450,2480,67317.2,592200
7720,71975.4,930650,5150,5197.2,338450,2570,66778.2,592200
8290,77007.8,930650,5700,8670.9,338450,2590,68336.9,592200
8940,78842,930650,6270,9611,338450,2670,69231,592200
9450,80458.4,930650,6730,10517.8,338450,2720,69940.6,592200
10010,85785.7,930650,7190,13400.1,338450,2820,72385.6,592200
10590,90098.6,930650,7670,15818.3,338450,2920,74280.3,592200
11180,93472.4,930650,8130,17475.8,338450,3050,75996.6,592200
15260,99382.3,930650,11170,21219.5,338450,4090,78162.8,592200
19260,102086,930650,14220,23658,338450,5040,78428,592200
23390,108602.6,930650,17280,27126.1,338450,6110,81476.5,592200
27410,108512.2,930650,20320,29089.8,338450,7090,79422.4,592200
32730,105918.8,930650,24540,29397.9,338450,8190,76520.9,592200
38090,111637,930650,28780,33932.8,338450,9310,77704.2,592200
43350,121820.4,930650,33020,40517.6,338450,10330,81302.8,592200
48700,132010.4,930650,37230,46426.8,338450,11470,85583.6,592200
52290,140248.3,930650,40070,51466.5,338450,12220,88781.8,592200
55930,143763.4,930650,42900,53533.7,338450,13030,90229.7,592200
59560,147691.4,930650,45740,55683.5,338450,13820,92007.9,592200
63230,160123.5,930650,48580,65554.4,338450,14650,94569.1,592200
76080,177674.8,930650,57350,79175.7,338450,18730,98499.1,592200
88910,205283.9,930650,66140,97251.6,338450,22770,108032.3,592200
101730,227918.5,930650,74900,113009.3,338450,26830,114909.2,592200
114540,252099.5,930650,83670,129678.4,338450,30870,122421.1,592200
126380,267326,930650,91340,141766.3,338450,35040,125559.7,592200
138250,278369.1,930650,98990,147919,338450,39260,130450.1,592200
150100,284247.3,930650,106660,153295.6,338450,43440,130951.7,592200
161960,328714.6,930650,114320,183942.6,338450,47640,144772,592200
175560,353810.2,930650,123170,199090,338450,52390,154720.2,592200
189240,351032.4,930650,132060,195455.4,338450,57180,155577,592200
202940,359690.5,930650,140940,200087.3,338450,62000,159603.2,592200
216590,368225.3,930650,149820,204181.2,338450,66770,164044.1,592200
227540,394657.9,930650,154300,219116.7,338450,73240,175541.2,592200
238520,405879,930650,158740,218859.2,338450,79780,187019.8,592200
249470,412831.6,930650,163230,223973.1,338450,86240,188858.5,592200
250750,390497.7,930650,164650,206951.2,338450,86100,183546.5,592200
258380,390716.9,930650,167830,202985.7,338450,90550,187731.2,592200
265980,392169,930650,171020,202297.4,338450,94960,189871.6,592200
273630,373069.9,930650,174200,200798.5,338450,99430,172271.4,592200
281290,384179.6,930650,177370,204945.7,338450,103920,179233.9,592200
288630,398090.5,930650,180480,213943.4,338450,108150,184147.1,592200
296000,410264.3,930650,183600,219217.1,338450,112400,191047.2,592200
303390,396554.9,930650,186720,214124.4,338450,116670,182430.5,592200
310750,404610.6,930650,189840,217417.6,338450,120910,187193,592200
316710,411003.4,930650,191450,221081,338450,125260,189922.4,592200
322620,407324.1,930650,193070,220983.7,338450,129550,186340.4,592200
328710,406251.7,930650,194690,218449.1,338450,134020,187802.6,592200
334570,423820.4,930650,196290,224066.9,338450,138280,199753.5,592200
340160,434684.1,930650,198280,230687.1,338450,141880,203997,592200
345670,439716.3,930650,200280,233897.2,338450,145390,205819.1,592200
351240,450415.3,930650,202290,238560.8,338450,148950,211854.5,592200
356850,463724.5,930650,204300,243953.5,338450,152550,219771,592200
360900,483055.5,930650,205300,251483.5,338450,155600,231572,592200
365020,491484,930650,206300,251774.1,338450,158720,239709.9,592200
369060,492898.3,930650,207300,252997.5,338450,161760,239900.8,592200
373120,507367.8,930650,208290,258795.8,338450,164830,248572,592200
372400,519861.6,930650,204420,262661.4,338450,167980,257200.2,592200
371630,520653.3,930650,200560,263158.5,338450,171070,257494.8,592200
370980,515816.2,930650,196730,257918.3,338450,174250,257897.9,592200
370150,524963.5,930650,192830,261004.9,338450,177320,263958.6,592200
369610,545306.4,930650,189390,266286.7,338450,180220,279019.7,592200
369030,528841.7,930650,185920,255864.2,338450,183110,272977.5,592200
368450,534405.1,930650,182470,262302.3,338450,185980,272102.8,592200
367880,488632.2,930650,179020,232059.9,338450,188860,256572.3,592200
369100,487776.9,930650,178060,231624.9,338450,191040,256152,592200
370260,460211.3,930650,177110,215692.9,338450,193150,244518.4,592200
371460,419965.6,930650,176150,194625.6,338450,195310,225340,592200
372710,400661,930650,175200,187433.6,338450,197510,213227.4,592200
366650,357602.5,930650,170780,162799.9,338450,195870,194802.6,592200
360570,335129.6,930650,166350,151361.7,338450,194220,183767.9,592200
354510,351195.2,930650,161920,159812.9,338450,192590,191382.3,592200
348400,378796.8,930650,157510,171634.2,338450,190890,207162.6,592200
340990,406157.4,930650,152600,184990,338450,188390,221167.4,592200
333520,410079.3,930650,147680,185977.4,338450,185840,224101.9,592200
326060,387314.7,930650,142740,166059.6,338450,183320,221255.1,592200
318640,313015.5,930650,137850,107093.9,338450,180790,205921.6,592200
314510,265017.3,930650,132990,68769.1,338450,181520,196248.2,592200
310360,307171.2,930650,128180,82169.1,338450,182180,225002.1,592200
306210,311374.3,930650,123330,80216.2,338450,182880,231158.1,592200
302080,307198.5,930650,118510,85621.1,338450,183570,221577.4,592200
300340,311013.6,930650,118510,89963.8,338450,181830,221049.8,592200
298540,319473,930650,118500,87139.8,338450,180040,232333.2,592200
296780,298711.9,930650,118490,74608.5,338450,178290,224103.4,592200
295020,291270.4,930650,118490,79236,338450,176530,212034.4,592200
292060,295162.3,930650,117900,84882.1,338450,174160,210280.2,592200
289050,271898,930650,117280,75551,338450,171770,196347,592200
286090,268932.2,930650,116700,77027.3,338450,169390,191904.9,592200
283170,253093.1,930650,116100,69722.5,338450,167070,183370.6,592200
280660,247172.4,930650,115300,61163.3,338450,165360,186009.1,592200
278200,253862,930650,114520,68399.3,338450,163680,185462.7,592200
275770,262551.7,930650,113720,66704.1,338450,162050,195847.6,592200
273160,234186.9,930650,112940,59804.2,338450,160220,174382.7,592200
267200,247603,930650,110560,66998.1,338450,156640,180604.9,592200
261100,254687.2,930650,108160,73196.1,338450,152940,181491.1,592200
255030,281159.7,930650,105790,83713.3,338450,149240,197446.4,592200
248940,279957.7,930650,103390,83340.5,338450,145550,196617.2,592200
241210,259077.5,930650,100710,79802.7,338450,140500,179274.8,592200
233400,261698.3,930650,97990,82573.8,338450,135410,179124.5,592200
225570,267685.7,930650,95280,88526.7,338450,130290,179159,592200
217770,259048,930650,92570,86242.7,338450,125200,172805.3,592200
213560,258737.7,930650,92920,91578.4,338450,120640,167159.3,592200
209320,269560.3,930650,93270,98159.6,338450,116050,171400.7,592200
205130,281703.2,930650,93620,113526.7,338450,111510,168176.5,592200
200950,293655.4,930650,93970,130016.8,338450,106980,163638.6,592200
194350,297839.1,930650,93900,147673,338450,100450,150166.1,592200
187750,252126.6,930650,93810,130762.3,338450,93940,121364.3,592200
181120,247043.1,930650,93750,136147.6,338450,87370,110895.5,592200
174470,314906,930650,93680,182423,338450,80790,132483,592200
166010,308058.2,930650,91630,173934.6,338450,74380,134123.6,592200
157440,250141,930650,89560,133553.2,338450,67880,116587.8,592200
148800,263190.2,930650,87470,137923.7,338450,61330,125266.5,592200
140270,311289.6,930650,85410,178426.5,338450,54860,132863.1,592200
132620,288201.5,930650,83830,162317.7,338450,48790,125883.8,592200
124890,255203.7,930650,82220,140998.8,338450,42670,114204.9,592200
117260,229488,930650,80620,125759.9,338450,36640,103728.1,592200
109610,176222.3,930650,79030,89707.1,338450,30580,86515.2,592200
107710,124605.4,930650,78120,55869.6,338450,29590,68735.8,592200
105850,106110.2,930650,77210,43040.2,338450,28640,63070,592200
103920,104525.6,930650,76300,43110.2,338450,27620,61415.4,592200
102170,91393,930650,75450,34570.8,338450,26720,56822.2,592200
99060,92050.4,930650,73210,34387.9,338450,25850,57662.5,592200
95890,93061,930650,71010,33247.9,338450,24880,59813.1,592200
92840,98871.5,930650,68800,34925.9,338450,24040,63945.6,592200
89750,101316.2,930650,66580,34255.1,338450,23170,67061.1,592200
87640,122920.6,930650,64940,46425.7,338450,22700,76494.9,592200
85470,133996.2,930650,63290,50980.6,338450,22180,83015.6,592200
83360,148197,930650,61620,58593.2,338450,21740,89603.8,592200
81210,153503.9,930650,59980,59282.5,338450,21230,94221.4,592200
79600,151030.6,930650,58100,54837,338450,21500,96193.6,592200
78000,158130.5,930650,56230,54287.8,338450,21770,103842.7,592200
76380,175719.8,930650,54390,58897.4,338450,21990,116822.4,592200
74930,164080.1,930650,50910,48932.8,338450,24020,115147.3,592200
74470,163483.6,930650,49880,50618.3,338450,24590,112865.3,592200
74020,161787.6,930650,48860,53207.6,338450,25160,108580,592200
73650,175434.9,930650,47830,63004.7,338450,25820,112430.2,592200
73180,172835.1,930650,46820,61335.7,338450,26360,111499.4,592200
73380,174436,930650,46470,58579.6,338450,26910,115856.4,592200
73540,187028.3,930650,46110,63996.6,338450,27430,123031.7,592200
73760,169139.6,930650,45780,57430.8,338450,27980,111708.8,592200
73920,160754.6,930650,45420,52846.7,338450,28500,107907.9,592200
74550,140467.4,930650,45850,38327.5,338450,28700,102139.9,592200
75140,134449.5,930650,46250,33019.6,338450,28890,101429.9,592200
75690,139611.8,930650,46650,30310.2,338450,29040,109301.6,592200
76260,142551.8,930650,47040,28374.2,338450,29220,114177.6,592200
77040,139503.6,930650,47690,27280.9,338450,29350,112222.7,592200
77840,132374.6,930650,48310,23296,338450,29530,109078.6,592200
78560,131765.4,930650,48930,27496.6,338450,29630,104268.8,592200
79310,131412.2,930650,49550,32725.9,338450,29760,98686.3,592200
79580,132264.2,930650,49570,35335.3,338450,30010,96928.9,592200
79880,144142.7,930650,49590,40675.3,338450,30290,103467.4,592200
80220,154331.9,930650,49620,45960.7,338450,30600,108371.2,592200
80510,160650.8,930650,49660,47805.9,338450,30850,112844.9,592200
81410,148050.3,930650,48430,38063.9,338450,32980,109986.4,592200
82320,139179.7,930650,47200,35712.6,338450,35120,103467.1,592200
83210,143807.8,930650,45970,37437.7,338450,37240,106370.1,592200
84120,156867.5,930650,44730,47539.9,338450,39390,109327.6,592200
85090,156101.7,930650,43720,43444.9,338450,41370,112656.8,592200
86040,170394.6,930650,42710,46697.9,338450,43330,123696.7,592200
87060,173559.8,930650,41680,45232.8,338450,45380,128327,592200
87970,175882.2,930650,40660,47169.8,338450,47310,128712.4,592200
89170,169943.4,930650,39640,42386.3,338450,49530,127557.1,592200
90400,161032.4,930650,38640,36041.8,338450,51760,124990.6,592200
91550,156760.9,930650,37610,30332.2,338450,53940,126428.7,592200
92790,153760.2,930650,36620,27158.9,338450,56170,126601.3,592200
94870,147960.4,930650,37750,28022.8,338450,57120,119937.6,592200
96940,150050.8,930650,38900,31785.5,338450,58040,118265.3,592200
99010,142209.9,930650,40030,30779.7,338450,58980,111430.2,592200
101080,136539.8,930650,41160,29358.7,338450,59920,107181.1,592200
103360,138538.1,930650,42470,31441,338450,60890,107097.1,592200
105680,135568,930650,43770,31827.4,338450,61910,103740.6,592200
107970,136092.3,930650,45090,31057.6,338450,62880,105034.7,592200
110300,146635.6,930650,46420,33338.5,338450,63880,113297.1,592200
114180,163368.3,930650,47950,35591.9,338450,66230,127776.4,592200
118110,174449.6,930650,49480,39768.5,338450,68630,134681.1,592200
122060,190368,930650,51010,47696.7,338450,71050,142671.3,592200
125990,197429.7,930650,52530,56188.6,338450,73460,141241.1,592200
134970,195702.9,930650,56220,57499,338450,78750,138203.9,592200
144000,196373.3,930650,59910,55793,338450,84090,140580.3,592200
153040,190494.6,930650,63630,54391.1,338450,89410,136103.5,592200
162020,182732.1,930650,67310,48173.3,338450,94710,134558.8,592200
172200,192435.7,930650,72020,55283.4,338450,100180,137152.3,592200
182380,199980.6,930650,76720,60421.6,338450,105660,139559,592200
192600,209161.3,930650,81420,64285.9,338450,111180,144875.4,592200
202770,203766.6,930650,86110,61056.1,338450,116660,142710.5,592200
211780,220313.6,930650,89720,68559.2,338450,122060,151754.4,592200
220830,223150.4,930650,93380,73671.8,338450,127450,149478.6,592200
229820,188080.4,930650,97000,61226.7,338450,132820,126853.7,592200
238770,192266.2,930650,100610,61151.8,338450,138160,131114.4,592200
248130,207421.2,930650,104950,73574.9,338450,143180,133846.3,592200
257450,208065.9,930650,109300,73222.9,338450,148150,134843,592200
266840,215448,930650,113640,80015,338450,153200,135433,592200
276210,231009.6,930650,118000,87123.1,338450,158210,143886.5,592200
285600,231610,930650,122380,87790.7,338450,163220,143819.3,592200
295000,243849.2,930650,126770,90530.1,338450,168230,153319.1,592200
304390,250790.9,930650,131170,90736.4,338450,173220,160054.5,592200
313750,247984.1,930650,135540,92334.7,338450,178210,155649.4,592200
322640,263714.3,930650,139110,98405.9,338450,183530,165308.4,592200
331500,279281.1,930650,142670,104967.3,338450,188830,174313.8,592200
340350,275353,930650,146220,108958.8,338450,194130,166394.2,592200
349200,296473,930650,149760,117127,338450,199440,179346,592200
355290,301260,930650,153170,121526.7,338450,202120,179733.3,592200
361430,309728.2,930650,156600,128636.5,338450,204830,181091.7,592200
367530,311945.7,930650,160030,137493,338450,207500,174452.7,592200
373690,322852.8,930650,163450,143362.9,338450,210240,179489.9,592200
378130,319719.7,930650,166280,138574.1,338450,211850,181145.6,592200
382470,305549.3,930650,169110,135666.3,338450,213360,169883,592200
386920,314475.6,930650,171950,141887.9,338450,214970,172587.7,592200
391290,314712,930650,174790,146669.9,338450,216500,168042.1,592200
394120,313034.6,930650,176970,145893.5,338450,217150,167141.1,592200
396930,314129,930650,179130,152508.4,338450,217800,161620.6,592200
399830,329928.9,930650,181310,162890,338450,218520,167038.9,592200
402600,326506.7,930650,183490,162885,338450,219110,163621.7,592200
405900,318106.8,930650,184760,161583.4,338450,221140,156523.4,592200
409180,315349.5,930650,186040,160729.3,338450,223140,154620.2,592200
412360,319338.7,930650,187290,166611.4,338450,225070,152727.3,592200
415550,312693.7,930650,188560,167962.9,338450,226990,144730.8,592200
419800,316455.3,930650,190130,171551.1,338450,229670,144904.2,592200
423950,313805.9,930650,191710,168878,338450,232240,144927.9,592200
428200,305426.2,930650,193320,161146.1,338450,234880,144280.1,592200
432380,307528.4,930650,194900,160627.2,338450,237480,146901.2,592200
437030,322115.3,930650,196610,171575.3,338450,240420,150540,592200
441720,320900.6,930650,198330,172869.4,338450,243390,148031.2,592200
446360,306875.7,930650,200050,164728.1,338450,246310,142147.6,592200
450990,308345.6,930650,201760,169018.9,338450,249230,139326.7,592200
449260,308588.3,930650,200510,167989.2,338450,248750,140599.1,592200
447500,319113.4,930650,199270,172107.5,338450,248230,147005.9,592200
445740,333599.1,930650,198020,180803.3,338450,247720,152795.8,592200
360380,318927.9,930650,178950,170936.7,338450,181430,147991.2,592200
361160,296518.5,930650,177910,154581.8,338450,183250,141936.7,592200
361990,285684.1,930650,176880,145909.5,338450,185110,139774.6,592200
362750,287781.8,930650,175820,145139.2,338450,186930,142642.6,592200
363610,278026.1,930650,174810,137778.1,338450,188800,140248,592200
364090,278931.3,930650,174030,141619,338450,190060,137312.3,592200
364650,286673.4,930650,173280,144521.3,338450,191370,142152.1,592200
365160,291433.3,930650,172510,144794.3,338450,192650,146639,592200
365760,290558.5,930650,171780,147550.3,338450,193980,143008.2,592200
362620,280604.3,930650,169820,142803.3,338450,192800,137801,592200
359530,252002.3,930650,167880,122583,338450,191650,129419.3,592200
356440,235871.4,930650,165920,111919.5,338450,190520,123951.9,592200
353360,226085.9,930650,163990,105101.4,338450,189370,120984.5,592200
350720,232933.1,930650,162340,109001.7,338450,188380,123931.4,592200
348060,231733.1,930650,160710,107438.3,338450,187350,124294.8,592200
345460,242467.5,930650,159090,114112.7,338450,186370,128354.8,592200
342800,225487.9,930650,157430,101366.3,338450,185370,124121.6,592200
340020,210739.9,930650,155430,89416.4,338450,184590,121323.5,592200
337220,211415.1,930650,153400,86304.2,338450,183820,125110.9,592200
334380,216810.1,930650,151380,86694.5,338450,183000,130115.6,592200
331580,220385.6,930650,149370,86745.8,338450,182210,133639.8,592200
329130,226118.5,930650,147980,88294.6,338450,181150,137823.9,592200
326640,222306.2,930650,146610,85269.3,338450,180030,137036.9,592200
324180,226197.2,930650,145250,83747.8,338450,178930,142449.4,592200
321710,234776.7,930650,143870,84957.3,338450,177840,149819.4,592200
319060,239896.3,930650,142230,80287.4,338450,176830,159608.9,592200
316430,234763.1,930650,140580,76432.3,338450,175850,158330.8,592200
313750,221621.8,930650,138920,71155.5,338450,174830,150466.3,592200
311150,220304.2,930650,137270,72334.6,338450,173880,147969.6,592200
308030,221372.1,930650,135310,69132.3,338450,172720,152239.8,592200
304920,221199.5,930650,133380,71807.5,338450,171540,149392,592200
301900,212536.5,930650,131470,71788.9,338450,170430,140747.6,592200
298740,211331,930650,129490,71438.3,338450,169250,139892.7,592200
288960,199785.4,930650,125330,67138.4,338450,163630,132647,592200
279170,196960.6,930650,121160,65041.5,338450,158010,131919.1,592200
269340,185160.1,930650,116980,60747.1,338450,152360,124413,592200
259560,184973.3,930650,112820,57760.7,338450,146740,127212.6,592200
251740,173732.1,930650,108610,48247.9,338450,143130,125484.2,592200
243870,176954.8,930650,104400,48706.8,338450,139470,128248,592200
236090,184202.6,930650,100210,53013.3,338450,135880,131189.3,592200
228270,179517.4,930650,96000,50120,338450,132270,129397.4,592200
222740,166364.6,930650,93340,45375.4,338450,129400,120989.2,592200
217260,146476.7,930650,90710,37116,338450,126550,109360.7,592200
211780,136480.4,930650,88070,32863.7,338450,123710,103616.7,592200
206170,134372.8,930650,85390,34817,338450,120780,99555.8,592200
208500,133210.1,930650,87310,36385.3,338450,121190,96824.8,592200
210790,133719.9,930650,89210,36242.2,338450,121580,97477.7,592200
213120,133924.7,930650,91110,36724.1,338450,122010,97200.6,592200
215410,138797.9,930650,93020,39131.4,338450,122390,99666.5,592200
217220,152971.5,930650,94850,46261.6,338450,122370,106709.9,592200
219020,149086.9,930650,96650,49786.8,338450,122370,99300.1,592200
220790,189117.3,930650,98510,60282.1,338450,122280,128835.2,592200
222640,203736.2,930650,100350,72723.8,338450,122290,131012.4,592200
224330,225917.3,930650,102150,82687.9,338450,122180,143229.4,592200
226010,223414.3,930650,103990,86121.7,338450,122020,137292.6,592200
227650,236597.2,930650,105800,90937.2,338450,121850,145660,592200
229310,231635,930650,107610,97432.4,338450,121700,134202.6,592200
235840,238116.7,930650,111970,99530.9,338450,123870,138585.8,592200
242410,241674.5,930650,116360,99807,338450,126050,141867.5,592200
248870,240207.6,930650,120720,99620.5,338450,128150,140587.1,592200
255490,227486.3,930650,125090,96769,338450,130400,130717.3,592200
262950,224300.4,930650,130080,97023.8,338450,132870,127276.6,592200
270460,218045.9,930650,135060,96633.1,338450,135400,121412.8,592200
277980,237357.7,930650,140050,106302.2,338450,137930,131055.5,592200
285480,249033,930650,145060,114160.7,338450,140420,134872.3,592200
292330,260455.7,930650,149620,115860.1,338450,142710,144595.6,592200
299100,262402.4,930650,154180,112670,338450,144920,149732.4,592200
305930,283474.2,930650,158760,119924.7,338450,147170,163549.5,592200
312670,292622.3,930650,163310,127793.9,338450,149360,164828.4,592200
317470,323821.6,930650,165670,148979.2,338450,151800,174842.4,592200
322290,338366.2,930650,168050,157923.3,338450,154240,180442.9,592200
327010,344222,930650,170400,154338.5,338450,156610,189883.5,592200
331760,325105.6,930650,172760,143082.5,338450,159000,182023.1,592200
335390,316243.4,930650,174520,131676.2,338450,160870,184567.2,592200
339010,302825.5,930650,176290,133357.9,338450,162720,169467.6,592200
342610,299094.3,930650,178040,132816.1,338450,164570,166278.2,592200
346230,277532.3,930650,179800,130788.9,338450,166430,146743.4,592200
350100,274290,930650,182240,135192.9,338450,167860,139097.1,592200
354010,305800.2,930650,184700,157876.1,338450,169310,147924.1,592200
357890,338684.4,930650,187130,177823.8,338450,170760,160860.6,592200
361710,338274.6,930650,189580,179541,338450,172130,158733.6,592200
363100,348047.6,930650,189650,173799.1,338450,173450,174248.5,592200
364460,320834.3,930650,189650,174999.3,338450,174810,145835,592200
365790,333017.9,930650,189700,185957.9,338450,176090,147060,592200
367070,353371.3,930650,189720,196555.3,338450,177350,156816,592200
369100,346187.9,930650,189830,187108.4,338450,179270,159079.5,592200
371120,318724.5,930650,189920,164144.1,338450,181200,154580.4,592200
373170,320724.7,930650,190030,160586.6,338450,183140,160138.1,592200
375200,306750.8,930650,190130,155973,338450,185070,150777.8,592200
376900,305778.3,930650,190850,161394.5,338450,186050,144383.8,592200
378590,305957.6,930650,191560,164537,338450,187030,141420.6,592200
380310,298655.1,930650,192270,163660.1,338450,188040,134995,592200
382020,292077,930650,192980,162006.1,338450,189040,130070.9,592200
379450,282199.1,930650,191780,157461,338450,187670,124738.1,592200
376840,264976.6,930650,190560,146595,338450,186280,118381.6,592200
374220,260116.7,930650,189350,144583.9,338450,184870,115532.8,592200
361580,262286.2,930650,182760,149775,338450,178820,112511.2,592200
357290,231947.7,930650,181360,133006.8,338450,175930,98940.9,592200
353020,220894.2,930650,179970,128258,338450,173050,92636.2,592200
348760,207884.2,930650,178590,122425.8,338450,170170,85458.4,592200
344440,204943.2,930650,177160,122938.9,338450,167280,82004.3,592200
340860,212191.2,930650,175880,129511.5,338450,164980,82679.7,592200
337210,242245,930650,174590,148753.6,338450,162620,93491.4,592200
333590,277747,930650,173290,163495.2,338450,160300,114251.8,592200
329990,276527,930650,171990,162525.9,338450,158000,114001.1,592200
323620,257239.7,930650,170540,150984.5,338450,153080,106255.2,592200
317330,250501.5,930650,169020,145297.8,338450,148310,105203.7,592200
311040,247538.6,930650,167550,145405.5,338450,143490,102133.1,592200
304710,238550,930650,166070,139564.1,338450,138640,98985.9,592200
298750,211698.1,930650,164070,120362.8,338450,134680,91335.3,592200
292750,218329.8,930650,162100,123894.6,338450,130650,94435.2,592200
286850,210922.8,930650,160100,118425.8,338450,126750,92497,592200
280790,219343.7,930650,158110,124952.9,338450,122680,94390.8,592200
274270,235271.2,930650,156360,136373.6,338450,117910,98897.6,592200
267770,252450.7,930650,154590,147430.5,338450,113180,105020.2,592200
261190,270437.2,930650,152810,160453.5,338450,108380,109983.7,592200
254710,283379.4,930650,151050,168578.8,338450,103660,114800.6,592200
252020,248633.6,930650,150720,144600.8,338450,101300,104032.8,592200
249350,252739.6,930650,150410,147421.5,338450,98940,105318.1,592200
246630,286645.6,930650,150070,173756.8,338450,96560,112888.8,592200
243980,294379.4,930650,149730,177030.4,338450,94250,117349,592200
241590,271033.1,930650,149610,161091.4,338450,91980,109941.7,592200
239290,254032.3,930650,149460,152078.4,338450,89830,101953.9,592200
236950,237348.4,930650,149330,141590.2,338450,87620,95758.2,592200
234620,200829.6,930650,149200,116238.1,338450,85420,84591.5,592200
233010,210338.1,930650,149950,123971.4,338450,83060,86366.7,592200
231330,206228.1,930650,150700,122263.2,338450,80630,83964.9,592200
229660,207306.8,930650,151460,124012.1,338450,78200,83294.7,592200
228000,206925.8,930650,152200,125274.1,338450,75800,81651.7,592200
225870,191382.5,930650,151980,114331.4,338450,73890,77051.1,592200
223730,174294.4,930650,151740,102465.6,338450,71990,71828.8,592200
221510,160491.5,930650,151500,92848.2,338450,70010,67643.3,592200
219380,142627.7,930650,151260,78418.2,338450,68120,64209.5,592200
216530,135801.3,930650,150060,75797.4,338450,66470,60003.9,592200
213710,140228.1,930650,148860,77153.2,338450,64850,63074.9,592200
210930,148520.9,930650,147680,84239.8,338450,63250,64281.1,592200
208010,170833.1,930650,146460,102383.2,338450,61550,68449.9,592200
205350,187148.9,930650,145330,114827.2,338450,60020,72321.7,592200
202780,186118.6,930650,144220,113952.1,338450,58560,72166.5,592200
200090,179803.1,930650,143090,108849.6,338450,57000,70953.5,592200
197450,183310.8,930650,141980,111341.5,338450,55470,71969.3,592200
194390,177551.2,930650,140270,106548,338450,54120,71003.2,592200
191360,167200.3,930650,138570,98330,338450,52790,68870.3,592200
188350,156421,930650,136850,88245.1,338450,51500,68175.9,592200
185300,154676.8,930650,135130,85586.2,338450,50170,69090.6,592200
182130,158687.3,930650,133360,89294.5,338450,48770,69392.8,592200
178940,168242.5,930650,131540,95518.3,338450,47400,72724.2,592200
175780,172525.7,930650,129750,98620.2,338450,46030,73905.5,592200
172550,182851.6,930650,127950,105394,338450,44600,77457.6,592200
169900,186094.5,930650,126290,106251.2,338450,43610,79843.3,592200
167220,188594.4,930650,124650,107965,338450,42570,80629.4,592200
164600,196366.6,930650,123000,112440.5,338450,41600,83926.1,592200
161910,201008.6,930650,121350,116261.5,338450,40560,84747.1,592200
158930,205640.9,930650,119240,118398,338450,39690,87242.9,592200
155890,205342.4,930650,117110,118202,338450,38780,87140.4,592200
152930,204116.5,930650,114990,115179,338450,37940,88937.5,592200
149910,213276.8,930650,112840,120416,338450,37070,92860.8,592200
147610,220174.7,930650,111010,124170.6,338450,36600,96004.1,592200
145290,215018.9,930650,109180,119574.2,338450,36110,95444.7,592200
142980,207321.9,930650,107340,113528.8,338450,35640,93793.1,592200
140660,211512.9,930650,105500,114631.1,338450,35160,96881.8,592200
139390,212360.1,930650,104330,115580.3,338450,35060,96779.8,592200
138050,211449.4,930650,103150,114415,338450,34900,97034.4,592200
136720,216941.2,930650,101980,113778.1,338450,34740,103163.1,592200
135480,236235.7,930650,100810,129214.7,338450,34670,107021,592200
137520,246891.3,930650,102210,138682.1,338450,35310,108209.2,592200
139580,254670.9,930650,103620,143044.9,338450,35960,111626,592200
141640,261846.6,930650,105050,147394.1,338450,36590,114452.5,592200
143730,263690.8,930650,106450,147539.9,338450,37280,116150.9,592200
143900,264955.4,930650,106840,148515.9,338450,37060,116439.5,592200
144080,254970.1,930650,107240,138244.4,338450,36840,116725.7,592200
144330,262529.9,930650,107640,140243.1,338450,36690,122286.8,592200
144550,264764.7,930650,108040,140604.4,338450,36510,124160.3,592200
145060,247454.1,930650,108450,124564.6,338450,36610,122889.5,592200
145450,241260.5,930650,108860,118595.5,338450,36590,122665,592200
145990,244253.7,930650,109270,119353.1,338450,36720,124900.6,592200
146370,237433.5,930650,109640,117566.1,338450,36730,119867.4,592200
145470,236609.5,930650,107820,118115,338450,37650,118494.5,592200
144500,243148.2,930650,106000,123452.4,338450,38500,119695.8,592200
143540,239637.8,930650,104160,126868.1,338450,39380,112769.7,592200
142580,260483.3,930650,102330,126542.7,338450,40250,133940.6,592200
141840,256302,930650,100340,124585.5,338450,41500,131716.5,592200
141070,278080.9,930650,98350,133635.5,338450,42720,144445.4,592200
140330,267330.8,930650,96370,133682,338450,43960,133648.8,592200
139530,293441.9,930650,94360,137798.7,338450,45170,155643.2,592200
138810,299666.2,930650,93070,138985,338450,45740,160681.2,592200
138090,300411,930650,91750,134586.7,338450,46340,165824.3,592200
137260,286513.6,930650,90430,122243.4,338450,46830,164270.2,592200
136490,287174.3,930650,89140,124198.5,338450,47350,162975.8,592200
132620,285746.2,930650,86650,116519.5,338450,45970,169226.7,592200
128740,277165.6,930650,84160,110401.2,338450,44580,166764.4,592200
124910,265623.6,930650,81680,101530.4,338450,43230,164093.2,592200
208230,257368.4,930650,104620,97516.1,338450,103610,159852.3,592200
201090,229100.8,930650,100680,83484.8,338450,100410,145616,592200
194010,211979,930650,96730,79126.8,338450,97280,132852.2,592200
186830,201099,930650,92770,83582.2,338450,94060,117516.8,592200
179710,199009.3,930650,88840,75216.6,338450,90870,123792.7,592200
172640,201889.5,930650,84850,72780.1,338450,87790,129109.4,592200
165520,156351,930650,80860,57541.5,338450,84660,98809.5,592200
158460,181383.5,930650,76880,60963,338450,81580,120420.5,592200
151350,186838.7,930650,72890,61634.1,338450,78460,125204.6,592200
145980,176134.1,930650,69570,54744.7,338450,76410,121389.4,592200
140550,173008.5,930650,66230,55154.8,338450,74320,117853.7,592200
135140,171288.6,930650,62880,54777.7,338450,72260,116510.9,592200
129800,161974,930650,59510,48657.3,338450,70290,113316.7,592200
125080,157033.9,930650,56980,45536.5,338450,68100,111497.4,592200
120340,146938.5,930650,54450,41005.8,338450,65890,105932.7,592200
115660,133177.9,930650,51930,32912.2,338450,63730,100265.7,592200
110900,131874.7,930650,49380,32684.5,338450,61520,99190.2,592200
106410,136282.1,930650,46930,36080.7,338450,59480,100201.4,592200
101890,139966.8,930650,44460,38428.6,338450,57430,101538.2,592200
97410,140581.7,930650,42010,38430.4,338450,55400,102151.3,592200
92890,133007.1,930650,39570,32643.2,338450,53320,100363.9,592200
89710,139465.8,930650,38350,41068.7,338450,51360,98397.1,592200
86430,146359.9,930650,37170,43448,338450,49260,102911.9,592200
83250,145066.7,930650,35980,43312.6,338450,47270,101754.1,592200
80070,140822.4,930650,34770,42082.2,338450,45300,98740.2,592200
75900,138894.8,930650,32760,43423.1,338450,43140,95471.7,592200
71740,134395.2,930650,30720,41240.5,338450,41020,93154.7,592200
67580,125864.3,930650,28660,35656.6,338450,38920,90207.7,592200
63450,114597.3,930650,26650,26567.9,338450,36800,88029.4,592200
60410,112297,930650,25610,25294.3,338450,34800,87002.7,592200
57430,108105.1,930650,24620,25599.4,338450,32810,82505.7,592200
54360,98827.8,930650,23640,19963.2,338450,30720,78864.6,592200
51400,88012.1,930650,22620,13735.3,338450,28780,74276.8,592200
48600,85365.9,930650,21330,13310.6,338450,27270,72055.3,592200
45810,87137,930650,20020,14930.1,338450,25790,72206.9,592200
42970,85182.3,930650,18700,14824.8,338450,24270,70357.5,592200
40230,81496.6,930650,17410,13116.9,338450,22820,68379.7,592200
37910,79765.2,930650,15940,12276.4,338450,21970,67488.8,592200
35590,77847.1,930650,14430,10189.7,338450,21160,67657.4,592200
33350,76433.4,930650,12960,8746.9,338450,20390,67686.5,592200
31030,74453,930650,11460,7424.5,338450,19570,67028.5,592200
29390,74161.5,930650,10220,6553.2,338450,19170,67608.3,592200
27770,76984,930650,8980,7433.9,338450,18790,69550.1,592200
26100,85626.1,930650,7730,11043.4,338450,18370,74582.7,592200
24500,83803.1,930650,6500,6733,338450,18000,77070.1,592200
26260,90994.5,930650,6790,7499,338450,19470,83495.5,592200
28110,98295.3,930650,7060,11843.2,338450,21050,86452.1,592200
29860,111413.3,930650,7330,18038.3,338450,22530,93375,592200
31640,118378.3,930650,7600,20650.9,338450,24040,97727.4,592200
33290,118888.3,930650,7890,19249.8,338450,25400,99638.5,592200
34840,117882,930650,8140,17998,338450,26700,99884,592200
36460,116463.9,930650,8420,17632.4,338450,28040,98831.5,592200
38100,120887.1,930650,8680,22237.4,338450,29420,98649.7,592200
39740,121919.5,930650,9330,24178.4,338450,30410,97741.1,592200
41430,117912.3,930650,9950,21582.3,338450,31480,96330,592200
43000,122590.1,930650,10570,22659.9,338450,32430,99930.2,592200
44690,117573.9,930650,11200,19788.6,338450,33490,97785.3,592200
45920,120162.8,930650,11700,19940.4,338450,34220,100222.4,592200
47140,119213.3,930650,12200,20751.8,338450,34940,98461.5,592200
48330,116529.8,930650,12680,17241.7,338450,35650,99288.1,592200
49500,115395.5,930650,13170,15689.4,338450,36330,99706.1,592200
50720,92093.1,930650,13590,12743.8,338450,37130,79349.3,592200
51960,83914.6,930650,14040,11862.1,338450,37920,72052.5,592200
53140,88144.7,930650,14430,15670,338450,38710,72474.7,592200
54300,99465,930650,14860,15446.6,338450,39440,84018.4,592200
55190,95649.2,930650,15230,16068.9,338450,39960,79580.3,592200
56020,113382.3,930650,15600,14719.1,338450,40420,98663.2,592200
56830,127437.1,930650,16000,16780.9,338450,40830,110656.2,592200
57620,125962.3,930650,16370,19395.9,338450,41250,106566.4,592200
59160,129686.3,930650,16950,20224,338450,42210,109462.3,592200
60680,131707.1,930650,17590,20550.8,338450,43090,111156.3,592200
62230,111929.9,930650,18180,17555.8,338450,44050,94374.1,592200
63730,111733.9,930650,18760,17567,338450,44970,94166.9,592200
65070,113213.1,930650,19220,17339.9,338450,45850,95873.2,592200
66350,132027.6,930650,19610,18498.9,338450,46740,113528.7,592200
67680,131297.2,930650,20050,16268,338450,47630,115029.2,592200
69040,122629.2,930650,20470,16038.2,338450,48570,106591,592200
70180,118069.3,930650,20780,18389.1,338450,49400,99680.2,592200
71370,116823.7,930650,21090,18308.8,338450,50280,98514.9,592200
72490,104284.7,930650,21420,15979.4,338450,51070,88305.3,592200
73570,118357.5,930650,21710,19396.7,338450,51860,98960.8,592200
76590,155916.3,930650,25040,40121.2,338450,51550,115795.1,592200
79670,161109.7,930650,28380,44183.9,338450,51290,116925.8,592200
82720,173455.1,930650,31710,50202.8,338450,51010,123252.3,592200
85820,176913,930650,35040,52175.2,338450,50780,124737.8,592200
89330,185757.6,930650,38610,55684.7,338450,50720,130072.9,592200
92900,202016.8,930650,42200,64098.9,338450,50700,137917.9,592200
96400,216816,930650,45780,72256.8,338450,50620,144559.2,592200
99920,217167,930650,49370,74314.3,338450,50550,142852.7,592200
103950,222911.8,930650,53200,75560.7,338450,50750,147351.1,592200
108110,224454.3,930650,57030,79326.2,338450,51080,145128.1,592200
112140,237428.9,930650,60880,88987.6,338450,51260,148441.3,592200
116220,234586.3,930650,64740,93448.1,338450,51480,141138.2,592200
120240,249071.3,930650,67280,107795.7,338450,52960,141275.6,592200
124380,254627.7,930650,69890,113453.6,338450,54490,141174.1,592200
128470,250177.8,930650,72470,109761.9,338450,56000,140415.9,592200
131040,271612.7,930650,78110,125112.4,338450,52930,146500.3,592200
134430,243215.6,930650,80260,122788.4,338450,54170,120427.2,592200
137840,258769.8,930650,82390,123972.5,338450,55450,134797.3,592200
141230,279241.6,930650,84530,125937.9,338450,56700,153303.7,592200
144670,280286.3,930650,86680,125093.6,338450,57990,155192.7,592200
148740,250481.1,930650,89650,105688.9,338450,59090,144792.2,592200
152930,235319.3,930650,92620,96139,338450,60310,139180.3,592200
157070,236565.3,930650,95560,94589.3,338450,61510,141976,592200
161240,233247.2,930650,98550,87804.8,338450,62690,145442.4,592200
162520,241287.9,930650,99900,89389.1,338450,62620,151898.8,592200
163820,252051.6,930650,101250,97864.9,338450,62570,154186.7,592200
165170,266230.2,930650,102640,112005.4,338450,62530,154224.8,592200
166420,270237.4,930650,104000,124605.2,338450,62420,145632.2,592200
166510,257403.8,930650,103600,123232.1,338450,62910,134171.7,592200
166570,262022.7,930650,103200,124299.2,338450,63370,137723.5,592200
166600,247141.2,930650,102820,112551,338450,63780,134590.2,592200
166650,209253.7,930650,102430,89684.1,338450,64220,119569.6,592200
167160,198324.1,930650,102810,84530.7,338450,64350,113793.4,592200
167720,201203.1,930650,103220,90775.3,338450,64500,110427.8,592200
168220,202783.6,930650,103600,90056.6,338450,64620,112727,592200
168680,242969.5,930650,103980,107721.7,338450,64700,135247.8,592200
166780,246216.5,930650,103960,112558.3,338450,62820,133658.2,592200
164910,252649.2,930650,103930,119229.6,338450,60980,133419.6,592200
162970,265050.3,930650,103890,127364.6,338450,59080,137685.7,592200
161070,310457.4,930650,103860,158682.1,338450,57210,151775.3,592200
159960,292702.9,930650,104400,149080.6,338450,55560,143622.3,592200
158840,269166.7,930650,104990,136984.9,338450,53850,132181.8,592200
157750,265452.7,930650,105540,135218.2,338450,52210,130234.5,592200
156650,261576.8,930650,106100,133811.9,338450,50550,127764.9,592200
156230,246891.5,930650,106900,125435,338450,49330,121456.5,592200
155800,245281.9,930650,107710,126468.8,338450,48090,118813.1,592200
155400,233570.4,930650,108530,122925.4,338450,46870,110645,592200
155030,205786.5,930650,109320,108465.2,338450,45710,97321.3,592200
154760,187893.5,930650,109370,101423,338450,45390,86470.5,592200
154550,181019.6,930650,109420,99158.1,338450,45130,81861.5,592200
154270,187403.4,930650,109460,103408,338450,44810,83995.4,592200
154080,198628.1,930650,109520,111108.6,338450,44560,87519.5,592200
153760,203457.2,930650,109470,114870,338450,44290,88587.2,592200
153460,208178.2,930650,109420,116953.3,338450,44040,91224.9,592200
153170,230391.6,930650,109370,132527.5,338450,43800,97864.1,592200
152890,243599.2,930650,109330,139294.9,338450,43560,104304.3,592200
153580,242599.7,930650,109420,136586.5,338450,44160,106013.2,592200
154200,256942.6,930650,109500,145664.3,338450,44700,111278.3,592200
154820,270185.8,930650,109580,153216.4,338450,45240,116969.4,592200
155400,281375.6,930650,109660,158407,338450,45740,122968.6,592200
159720,270022.3,930650,111990,153197.9,338450,47730,116824.4,592200
163980,277819.3,930650,114360,154488.7,338450,49620,123330.6,592200
168250,290866,930650,116690,161994.8,338450,51560,128871.2,592200
172590,325915,930650,119060,184052.3,338450,53530,141862.7,592200
176810,325097.2,930650,121090,180662.8,338450,55720,144434.4,592200
180980,320128.2,930650,123160,177982.6,338450,57820,142145.6,592200
185180,330107.2,930650,125200,189594.6,338450,59980,140512.6,592200
189430,353988.9,930650,127270,202891.2,338450,62160,151097.7,592200
193400,329855.8,930650,128830,188374,338450,64570,141481.8,592200
197320,354011.2,930650,130370,200405.9,338450,66950,153605.3,592200
201280,371442.3,930650,131930,210313.1,338450,69350,161129.2,592200
205210,376032.3,930650,133490,210377.8,338450,71720,165654.5,592200
211600,385160.1,930650,137560,212024.1,338450,74040,173136,592200
217980,383986.5,930650,141640,210948.4,338450,76340,173038.1,592200
224370,419222.2,930650,145680,227261.7,338450,78690,191960.5,592200
230770,439148.2,930650,149750,236019.9,338450,81020,203128.3,592200
235700,446966.1,930650,152610,234161.8,338450,83090,212804.3,592200
240800,463261.2,930650,155470,239738.8,338450,85330,223522.4,592200
245850,472821.8,930650,158320,244875.8,338450,87530,227946,592200
250910,480155.3,930650,161180,247869.9,338450,89730,232285.4,592200
255400,492827.6,930650,163940,251214.1,338450,91460,241613.5,592200
259970,503525.4,930650,166700,249805.7,338450,93270,253719.7,592200
264480,495672.5,930650,169470,243151.1,338450,95010,252521.4,592200
268960,488254.1,930650,172220,237897.3,338450,96740,250356.8,592200
266850,442482.7,930650,171670,211656.9,338450,95180,230825.8,592200
264620,423125,930650,171110,199785.3,338450,93510,223339.7,592200
262430,454595.3,930650,170520,217799.8,338450,91910,236795.5,592200
260240,452017.5,930650,169970,214131.4,338450,90270,237886.1,592200
257540,464416.2,930650,168990,227205.6,338450,88550,237210.6,592200
254830,467510,930650,168030,230778,338450,86800,236732,592200
252170,447367.1,930650,167030,225042.3,338450,85140,222324.8,592200
249510,428931.4,930650,166060,216918.9,338450,83450,212012.5,592200
246760,413148.8,930650,165600,216607.1,338450,81160,196541.7,592200
244070,391279.3,930650,165140,206268.8,338450,78930,185010.5,592200
241280,322987.3,930650,164660,167604.7,338450,76620,155382.6,592200
238700,299307.8,930650,164200,152949.3,338450,74500,146358.5,592200
234420,300248.4,930650,161340,147848.4,338450,73080,152400,592200
230190,280450.3,930650,158490,137540.4,338450,71700,142909.9,592200
225940,237119.2,930650,155610,114958,338450,70330,122161.2,592200
221670,200057.5,930650,152760,101671.4,338450,68910,98386.1,592200
217780,168913.3,930650,150470,95922.3,338450,67310,72991,592200
213810,166688.4,930650,148200,96581,338450,65610,70107.4,592200
209860,177852.7,930650,145930,103007.4,338450,63930,74845.3,592200
205950,197215.9,930650,143650,103378.1,338450,62300,93837.8,592200
202440,174443.4,930650,141260,97224,338450,61180,77219.4,592200
198940,156843.6,930650,138900,89592.6,338450,60040,67251,592200
195410,155963.4,930650,136530,87793.9,338450,58880,68169.5,592200
191960,161940.6,930650,134140,90058.3,338450,57820,71882.3,592200
187580,160072.6,930650,131070,88401,338450,56510,71671.6,592200
183220,176594,930650,128000,93984.9,338450,55220,82609.1,592200
178920,192238.2,930650,124950,98734.3,338450,53970,93503.9,592200
149440,187558.5,930650,94870,87501,338450,54570,100057.5,592200
144920,153799.3,930650,91950,78419.6,338450,52970,75379.7,592200
140370,143946.9,930650,89080,72662.4,338450,51290,71284.5,592200
135790,131847.4,930650,86180,62747.9,338450,49610,69099.5,592200
131270,118946.2,930650,83310,53742.2,338450,47960,65204,592200
126280,155660.6,930650,79990,60669.7,338450,46290,94990.9,592200
121310,161715.1,930650,76660,63214.8,338450,44650,98500.3,592200
116350,154779.9,930650,73360,62728.1,338450,42990,92051.8,592200
111360,144987.7,930650,70050,63370.3,338450,41310,81617.4,592200
107620,156277.8,930650,66880,65031.9,338450,40740,91245.9,592200
103740,164706.9,930650,63700,65966.4,338450,40040,98740.5,592200
99940,170791,930650,60540,67552.2,338450,39400,103238.8,592200
96230,173221.1,930650,57380,66780.7,338450,38850,106440.4,592200
92130,178522.7,930650,54040,64832,338450,38090,113690.7,592200
88070,167819.5,930650,50680,60842.8,338450,37390,106976.7,592200
84030,169543.7,930650,47340,60160.4,338450,36690,109383.3,592200
79900,163897.5,930650,43990,54847.5,338450,35910,109050,592200
75280,156872.2,930650,40290,49602.7,338450,34990,107269.5,592200
70560,166856.4,930650,36610,49391.6,338450,33950,117464.8,592200
65890,157686.1,930650,32920,49319.9,338450,32970,108366.2,592200
61160,176956.7,930650,29220,50932.9,338450,31940,126023.8,592200
56380,157445.3,930650,26790,45397.4,338450,29590,112047.9,592200
51560,162094,930650,24310,42002.5,338450,27250,120091.5,592200
46710,153869.5,930650,21860,38508.2,338450,24850,115361.3,592200
41910,139060.8,930650,19400,32215.8,338450,22510,106845,592200
37970,124589.5,930650,17620,25049.3,338450,20350,99540.2,592200
34140,111825.5,930650,15860,19393.8,338450,18280,92431.7,592200
30260,107272.4,930650,14080,16128,338450,16180,91144.4,592200
26410,103780.4,930650,12310,14605.4,338450,14100,89175,592200
22900,99903.6,930650,10760,13795.8,338450,12140,86107.8,592200
19400,104177,930650,9210,18178.3,338450,10190,85998.7,592200
15900,95757.1,930650,7670,14750.6,338450,8230,81006.5,592200
12360,92689.7,930650,6100,15841.6,338450,6260,76848.1,592200
11780,93119.6,930650,5870,18171.2,338450,5910,74948.4,592200
11190,94462.1,930650,5630,20126.3,338450,5560,74335.8,592200
10660,87378.2,930650,5420,15426,338450,5240,71952.2,592200
9960,84250.2,930650,5190,13707,338450,4770,70543.2,592200
9480,82056.4,930650,4920,12570.3,338450,4560,69486.1,592200
8900,78814.2,930650,4620,11054.4,338450,4280,67759.8,592200
8300,77936.3,930650,4340,10347.6,338450,3960,67588.7,592200
7810,74902.3,930650,4050,8019.5,338450,3760,66882.8,592200
7160,73119.2,930650,3670,6091,338450,3490,67028.2,592200
6590,72499.9,930650,3290,5435.5,338450,3300,67064.4,592200
5970,71722,930650,2910,5232.7,338450,3060,66489.3,592200
5370,72102.6,930650,2510,5204.5,338450,2860,66898.1,592200
5520,72658.5,930650,2480,5305.1,338450,3040,67353.4,592200
5690,72844,930650,2460,5413.9,338450,3230,67430.1,592200
5840,74441.6,930650,2440,5572.1,338450,3400,68869.5,592200
6070,72467.8,930650,2420,5319.3,338450,3650,67148.5,592200
6250,73085,930650,2380,5851.4,338450,3870,67233.6,592200
6490,73402.5,930650,2340,6461.4,338450,4150,66941.1,592200
6750,72690.5,930650,2310,5728.8,338450,4440,66961.7,592200
6960,72904.2,930650,2280,5648.1,338450,4680,67256.1,592200
7250,72689.9,930650,2310,5801.9,338450,4940,66888,592200
7520,72712.1,930650,2340,5744.2,338450,5180,66967.9,592200
7840,71928.9,930650,2370,5611.6,338450,5470,66317.3,592200
8100,71969.7,930650,2420,5465.6,338450,5680,66504.1,592200
7830,71320.8,930650,2420,5408,338450,5410,65912.8,592200
7630,71166.1,930650,2410,5459,338450,5220,65707.1,592200
7390,70791.5,930650,2440,5400.6,338450,4950,65390.9,592200
7130,70306.4,930650,2420,5222.6,338450,4710,65083.8,592200
6750,70090.5,930650,2340,5114.5,338450,4410,64976,592200
6370,69302.4,930650,2280,5086.7,338450,4090,64215.7,592200
5970,69970.4,930650,2200,5194.2,338450,3770,64776.2,592200
5520,68674.7,930650,2100,5256.5,338450,3420,63418.2,592200
5170,69128,930650,2060,5403.7,338450,3110,63724.3,592200
4870,69026.3,930650,2020,5411.6,338450,2850,63614.7,592200
4560,68738.6,930650,1970,5326.9,338450,2590,63411.7,592200
4180,69582.2,930650,1920,5645.6,338450,2260,63936.6,592200
4230,69757.6,930650,1800,5565.9,338450,2430,64191.7,592200
4310,70460.1,930650,1700,5694.5,338450,2610,64765.6,592200
4360,70396.7,930650,1590,5613.6,338450,2770,64783.1,592200
4450,68854,930650,1480,5415,338450,2970,63439,592200
4540,68916.8,930650,1350,5193.6,338450,3190,63723.2,592200
4750,69108.7,930650,1260,5201,338450,3490,63907.7,592200
4870,68327.8,930650,1130,5063.5,338450,3740,63264.3,592200
5000,68921.2,930650,1050,5226,338450,3950,63695.2,592200
5260,69468.5,930650,1000,5301,338450,4260,64167.5,592200
5530,68426.8,930650,930,5188.5,338450,4600,63238.3,592200
5780,68840.9,930650,900,5326,338450,4880,63514.9,592200
5990,69734.9,930650,820,5463.5,338450,5170,64271.4,592200
7230,70682.2,930650,950,5451,338450,6280,65231.2,592200
8450,72170,930650,1080,5463.5,338450,7370,66706.5,592200
9690,74172.4,930650,1210,5538.5,338450,8480,68633.9,592200
10930,75452,930650,1310,5563.5,338450,9620,69888.5,592200
12120,81735.9,930650,1450,6074.9,338450,10670,75661,592200
13260,86463.3,930650,1560,6598.7,338450,11700,79864.6,592200
14470,90867.7,930650,1670,7238.8,338450,12800,83628.9,592200
15740,92840.4,930650,1780,7381,338450,13960,85459.4,592200
16720,92743.9,930650,1900,7235.4,338450,14820,85508.5,592200
17640,92106.2,930650,2010,7219.2,338450,15630,84887,592200
18660,96851.6,930650,2140,8292.1,338450,16520,88559.5,592200
19690,101118.2,930650,2250,9271.1,338450,17440,91847.1,592200
20540,99075.5,930650,2460,8942.5,338450,18080,90133,592200
21410,97773.3,930650,2670,8594.5,338450,18740,89178.8,592200
22300,94993.8,930650,2870,7371.5,338450,19430,87622.3,592200
15390,97096.4,1332350,1860,8620.1,555250,13530,88476.3,777100
16000,93769,1332350,1940,8513.4,555250,14060,85255.6,777100
16580,93021.4,1332350,2010,8261.5,555250,14570,84759.9,777100
17200,94700.6,1332350,2080,8531,555250,15120,86169.6,777100
17770,98779.1,1332350,2130,9194.2,555250,15640,89584.9,777100
18410,100073.7,1332350,2260,9601,555250,16150,90472.7,777100
19060,104938,1332350,2400,10163.9,555250,16660,94774.1,777100
19640,109541.7,1332350,2540,10899.2,555250,17100,98642.5,777100
20240,107109.4,1332350,2640,10716.5,555250,17600,96392.9,777100
20040,104847.9,1332350,2620,9601.8,555250,17420,95246.1,777100
19780,102040.6,1332350,2610,9025.7,555250,17170,93014.9,777100
19550,103120,1332350,2550,9058.1,555250,17000,94061.9,777100
19290,100994.6,1332350,2530,9547,555250,16760,91447.6,777100
18880,97477.3,1332350,2340,9097,555250,16540,88380.3,777100
18450,95297.8,1332350,2150,8822,555250,16300,86475.8,777100
18070,91608.3,1332350,1960,7683,555250,16110,83925.3,777100
17710,90860.6,1332350,1760,7533,555250,15950,83327.6,777100
17400,88568,1332350,1630,7770.5,555250,15770,80797.5,777100
17020,88928.9,1332350,1530,7652.7,555250,15490,81276.2,777100
16700,87010.7,1332350,1420,8024,555250,15280,78986.7,777100
16360,85061.5,1332350,1290,8286.5,555250,15070,76775,777100
16240,86830.4,1332350,1340,9049.9,555250,14900,77780.5,777100
16160,88291.6,1332350,1380,9346.1,555250,14780,78945.5,777100
16100,89780.8,1332350,1420,9595.5,555250,14680,80185.3,777100
16020,91934.2,1332350,1480,10355.6,555250,14540,81578.6,777100
16010,95132.4,1332350,1510,10984.5,555250,14500,84147.9,777100
16030,94987.5,1332350,1540,10891,555250,14490,84096.5,777100
15990,93281.5,1332350,1560,10271.2,555250,14430,83010.3,777100
16030,92703.1,1332350,1610,9042.9,555250,14420,83660.2,777100
16210,94719.4,1332350,1670,9646.8,555250,14540,85072.6,777100
16440,96155.7,1332350,1760,11092.3,555250,14680,85063.4,777100
16590,100293.5,1332350,1820,12146.5,555250,14770,88147,777100
16780,103609.3,1332350,1900,11971.5,555250,14880,91637.8,777100
15700,100694.8,1332350,1730,11752.7,555250,13970,88942.1,777100
14620,95275,1332350,1590,11485.7,555250,13030,83789.3,777100
13500,89003.2,1332350,1420,10602.8,555250,12080,78400.4,777100
12380,83436.9,1332350,1270,9078.5,555250,11110,74358.4,777100
11120,78871.5,1332350,1130,7466.5,555250,9990,71405,777100
9790,75920.5,1332350,990,6258.1,555250,8800,69662.4,777100
8480,74593.5,1332350,860,5426.6,555250,7620,69166.9,777100
7150,74344.6,1332350,710,5667,555250,6440,68677.6,777100
6280,74103.5,1332350,590,5855.4,555250,5690,68248.1,777100
5410,74645.8,1332350,480,6504.5,555250,4930,68141.3,777100
4500,75750,1332350,360,6592,555250,4140,69158,777100
3660,76420.7,1332350,240,6379.8,555250,3420,70040.9,777100
4120,77328.3,1332350,320,6496.8,555250,3800,70831.5,777100
4560,78307.2,1332350,390,7055.8,555250,4170,71251.4,777100
5080,79078.1,1332350,460,6756.8,555250,4620,72321.3,777100
5530,79108.4,1332350,530,6527.6,555250,5000,72580.8,777100
6080,78077.7,1332350,610,5968.9,555250,5470,72108.8,777100
6650,77906.5,1332350,700,6255.8,555250,5950,71650.7,777100
7240,79392,1332350,770,6208.2,555250,6470,73183.8,777100
7850,80299.6,1332350,860,6436.9,555250,6990,73862.7,777100
8470,83614.7,1332350,960,7503.6,555250,7510,76111.1,777100
9070,84454.8,1332350,1060,7679.1,555250,8010,76775.7,777100
9770,86015.1,1332350,1170,7584.9,555250,8600,78430.2,777100
10380,86610.9,1332350,1270,7754.8,555250,9110,78856.1,777100
11530,90768.7,1332350,1440,8667,555250,10090,82101.7,777100
12570,91526.5,1332350,1560,8889.5,555250,11010,82637,777100
13750,89433.6,1332350,1730,8743.1,555250,12020,80690.5,777100
14840,87992.8,1332350,1870,8292.1,555250,12970,79700.7,777100
16060,82134,1332350,1990,7533,555250,14070,74601,777100
17210,66091.5,1332350,2100,6528.7,555250,15110,59562.8,777100
18400,65631.1,1332350,2200,8068.8,555250,16200,57562.3,777100
19560,40418.4,1332350,2330,8091.9,555250,17230,32326.5,777100
20920,46917.5,1332350,2580,9019.9,555250,18340,37897.6,777100
22210,50113.5,1332350,2820,8061.7,555250,19390,42051.8,777100
23600,57019.7,1332350,3100,9336.9,555250,20500,47682.8,777100
24980,62005.3,1332350,3340,11025.9,555250,21640,50979.4,777100
28030,63827,1332350,3900,11382,555250,24130,52445,777100
31150,63827,1332350,4420,11382,555250,26730,52445,777100
34190,83589.4,1332350,4980,12458.1,555250,29210,71131.3,777100
37260,86934.4,1332350,5530,13627.2,555250,31730,73307.2,777100
39790,87810.1,1332350,5990,14578.3,555250,33800,73231.8,777100
42210,84799.7,1332350,6420,13295,555250,35790,71504.7,777100
44700,90904.9,1332350,6860,17295.6,555250,37840,73609.3,777100
47190,100797.2,1332350,7330,20269.8,555250,39860,80527.4,777100
50210,94832.5,1332350,7950,16110.4,555250,42260,78722.1,777100
53220,98785.3,1332350,8570,16111.5,555250,44650,82673.8,777100
56230,109740.2,1332350,9190,21791.1,555250,47040,87949.1,777100
59240,110355,1332350,9820,21705.9,555250,49420,88649.1,777100
62480,103258.6,1332350,10700,18036.5,555250,51780,85222.1,777100
65670,94883.6,1332350,11560,16688.4,555250,54110,78195.2,777100
68820,93323.8,1332350,12430,18144.2,555250,56390,75179.6,777100
72000,103912.1,1332350,13280,20863.9,555250,58720,83048.2,777100
74950,114412.1,1332350,13900,24064.6,555250,61050,90347.5,777100
77900,117252.6,1332350,14480,26818.1,555250,63420,90434.5,777100
80890,107536.3,1332350,15090,23759.6,555250,65800,83776.7,777100
83850,107786.1,1332350,15690,25482.6,555250,68160,82303.5,777100
86340,97152.3,1332350,16280,23014.5,555250,70060,74137.8,777100
88890,97117.9,1332350,16880,21007.9,555250,72010,76110,777100
91390,104725,1332350,17460,19897.9,555250,73930,84827.1,777100
93920,110523,1332350,18070,23209.6,555250,75850,87313.4,777100
92020,118055.3,1332350,17990,29315.8,555250,74030,88739.5,777100
90070,122697.6,1332350,17910,29864.5,555250,72160,92833.1,777100
88120,116269.3,1332350,17830,27251.7,555250,70290,89017.6,777100
91180,102290.5,1332350,16510,20871.2,555250,74670,81419.3,777100
88500,102369.4,1332350,16430,22131.4,555250,72070,80238,777100
85690,85537.8,1332350,16340,15569.5,555250,69350,69968.3,777100
82990,71868.1,1332350,16260,10857.2,555250,66730,61010.9,777100
80270,71238.1,1332350,16210,10829.3,555250,64060,60408.8,777100
77970,70849.5,1332350,16220,10506.3,555250,61750,60343.2,777100
75660,75924.9,1332350,16250,13772.4,555250,59410,62152.5,777100
73470,85167.9,1332350,16300,17364.1,555250,57170,67803.8,777100
71100,84019.1,1332350,16320,19758.8,555250,54780,64260.3,777100
69790,78549.2,1332350,16470,23730.8,555250,53320,54818.4,777100
68470,77221.6,1332350,16600,24010.9,555250,51870,53210.7,777100
67100,76218.3,1332350,16730,22732.4,555250,50370,53485.9,777100
65700,69588.1,1332350,16860,23481.9,555250,48840,46106.2,777100
64270,60497.4,1332350,16740,21572.2,555250,47530,38925.2,777100
62910,52439.4,1332350,16640,18879.7,555250,46270,33559.7,777100
61510,60016.2,1332350,16540,22433.9,555250,44970,37582.3,777100
60150,65105.5,1332350,16440,24600.8,555250,43710,40504.7,777100
58280,75401.7,1332350,16380,31429.7,555250,41900,43972,777100
56460,80633.5,1332350,16300,31953.5,555250,40160,48680,777100
54660,68426.8,1332350,16250,25531.9,555250,38410,42894.9,777100
52880,68400.7,1332350,16170,25382.3,555250,36710,43018.4,777100
51030,58790.4,1332350,16220,21527.5,555250,34810,37262.9,777100
49250,55054.2,1332350,16280,21693.1,555250,32970,33361.1,777100
47520,51885,1332350,16370,20627.3,555250,31150,31257.7,777100
45630,48017.7,1332350,16430,20716.1,555250,29200,27301.6,777100
44760,50536,1332350,16460,21745.2,555250,28300,28790.8,777100
43790,50711.4,1332350,16500,22756.7,555250,27290,27954.7,777100
42820,48986.7,1332350,16530,21508.5,555250,26290,27478.2,777100
41880,61883.3,1332350,16560,28804.1,555250,25320,33079.2,777100
41440,71321.6,1332350,17180,33197.3,555250,24260,38124.3,777100
40890,65359,1332350,17760,30490.7,555250,23130,34868.3,777100
40400,70380.1,1332350,18350,35628,555250,22050,34752.1,777100
39950,87453,1332350,18970,46872.4,555250,20980,40580.6,777100
37970,104393.1,1332350,18520,58384.6,555250,19450,46008.5,777100
35930,115520.6,1332350,18070,65025.6,555250,17860,50495,777100
33900,115258.9,1332350,17630,65618.3,555250,16270,49640.6,777100
31850,110276,1332350,17180,63496.7,555250,14670,46779.3,777100
30680,125226.3,1332350,17210,72589.2,555250,13470,52637.1,777100
29530,116240.7,1332350,17230,66834.4,555250,12300,49406.3,777100
28380,78074.9,1332350,17240,45581.6,555250,11140,32493.3,777100
27230,64668,1332350,17290,38253.7,555250,9940,26414.3,777100
26450,57633.8,1332350,17030,33457.9,555250,9420,24175.9,777100
25710,46611,1332350,16780,25986.8,555250,8930,20624.2,777100
24970,38682.3,1332350,16560,20723,555250,8410,17959.3,777100
24220,47631.4,1332350,16310,24309.8,555250,7910,23321.6,777100
25540,40487,1332350,17050,19672,555250,8490,20815,777100
26870,34088,1332350,17740,16236.7,555250,9130,17851.3,777100
28320,26521.3,1332350,18480,12461.6,555250,9840,14059.7,777100
29620,17146.1,1332350,19190,8395.7,555250,10430,8750.4,777100
29540,13861.3,1332350,18210,6436.5,555250,11330,7424.8,777100
29320,17119.3,1332350,17180,8139.9,555250,12140,8979.4,777100
29160,16981.8,1332350,16200,7801,555250,12960,9180.8,777100
28980,16476.3,1332350,15150,7648.9,555250,13830,8827.4,777100
29520,18174.5,1332350,14840,8603.8,555250,14680,9570.7,777100
30040,21939.2,1332350,14550,10683.1,555250,15490,11256.1,777100
30470,26091.3,1332350,14200,12765.8,555250,16270,13325.5,777100
31000,25434,1332350,13900,11649.8,555250,17100,13784.2,777100
32670,24778,1332350,15100,11242.8,555250,17570,13535.2,777100
34470,27791,1332350,16340,12628.7,555250,18130,15162.3,777100
36150,36658.5,1332350,17560,18062.9,555250,18590,18595.6,777100
37820,38661.8,1332350,18780,19004.8,555250,19040,19657,777100
39700,36371.2,1332350,20420,17542.2,555250,19280,18829,777100
41770,40431.5,1332350,22100,19031.3,555250,19670,21400.2,777100
43650,60550.3,1332350,23750,21528.3,555250,19900,39022,777100
45640,87778.6,1332350,25400,25819.1,555250,20240,61959.5,777100
46760,60712.4,1332350,26140,24716.1,555250,20620,35996.3,777100
47860,59437.6,1332350,26890,24937.5,555250,20970,34500.1,777100
48980,64518.8,1332350,27610,27795.2,555250,21370,36723.6,777100
50060,115955.4,1332350,28310,55916.9,555250,21750,60038.5,777100
51220,121762,1332350,28350,58837.6,555250,22870,62924.4,777100
52230,79363.9,1332350,28400,34103.3,555250,23830,45260.6,777100
53420,80720.7,1332350,28450,34605.6,555250,24970,46115.1,777100
54470,93237.4,1332350,28480,40403.6,555250,25990,52833.8,777100
55740,110763,1332350,28700,48741.9,555250,27040,62021.1,777100
56950,132969.1,1332350,28930,64121.7,555250,28020,68847.4,777100
58200,144172.1,1332350,29140,75781.7,555250,29060,68390.4,777100
59420,124623.5,1332350,29350,66190.9,555250,30070,58432.6,777100
59930,109263.9,1332350,29770,55882.1,555250,30160,53381.8,777100
60400,83714.1,1332350,30160,42439.3,555250,30240,41274.8,777100
60930,58095.4,1332350,30610,28247.9,555250,30320,29847.5,777100
61450,56828,1332350,31020,28520.2,555250,30430,28307.8,777100
59420,57470.2,1332350,28790,28417.3,555250,30630,29052.9,777100
57330,65157.2,1332350,26600,31550.5,555250,30730,33606.7,777100
55330,73084.3,1332350,24390,34684.5,555250,30940,38399.8,777100
53330,70638.4,1332350,22210,34627.1,555250,31120,36011.3,777100
53180,87490.9,1332350,22250,45124.6,555250,30930,42366.3,777100
52950,86666.6,1332350,22230,46540.8,555250,30720,40125.8,777100
52860,122166.5,1332350,22250,68258.8,555250,30610,53907.7,777100
52670,140913.5,1332350,22260,79576.5,555250,30410,61337,777100
51640,154443.4,1332350,21010,87446.6,555250,30630,66996.8,777100
50650,152968.2,1332350,19800,86513.2,555250,30850,66455,777100
49500,135333.1,1332350,18490,75588.4,555250,31010,59744.7,777100
48510,128807.7,1332350,17260,71496.8,555250,31250,57310.9,777100
49410,112385.9,1332350,17500,60815.9,555250,31910,51570,777100
50260,80912.1,1332350,17760,41886,555250,32500,39026.1,777100
51130,56556.4,1332350,18010,26566.8,555250,33120,29989.6,777100
58220,37566,1332350,32410,18276.4,555250,25810,19289.6,777100
56610,36031.7,1332350,29720,13478.3,555250,26890,22553.4,777100
54910,46511.3,1332350,27000,16918.1,555250,27910,29593.2,777100
53340,46574.6,1332350,24280,14253.8,555250,29060,32320.8,777100
51650,50755.9,1332350,21550,14941.7,555250,30100,35814.2,777100
50530,55782,1332350,19310,17951.3,555250,31220,37830.7,777100
49370,54929.9,1332350,17060,14991.9,555250,32310,39938,777100
48270,54987.3,1332350,14810,13268.9,555250,33460,41718.4,777100
47120,56298.9,1332350,12530,15704.6,555250,34590,40594.3,777100
50570,58805.5,1332350,12320,14990.5,555250,38250,43815,777100
54020,64117.6,1332350,12140,17638.8,555250,41880,46478.8,777100
57400,68847.2,1332350,11900,21035.1,555250,45500,47812.1,777100
60830,74937.7,1332350,11680,22163.7,555250,49150,52774,777100
64420,93185.4,1332350,11480,27535.1,555250,52940,65650.3,777100
67960,93638.1,1332350,11250,26235.1,555250,56710,67403,777100
71450,94066.5,1332350,11040,25241.1,555250,60410,68825.4,777100
75070,103136.7,1332350,10820,31258.3,555250,64250,71878.4,777100
78250,100785.9,1332350,10690,30159.7,555250,67560,70626.2,777100
81500,104490.7,1332350,10560,31545,555250,70940,72945.7,777100
84670,118469.7,1332350,10450,36290,555250,74220,82179.7,777100
87970,134475.2,1332350,10310,40628.1,555250,77660,93847.1,777100
95130,130717.3,1332350,13410,38681.5,555250,81720,92035.8,777100
102370,138912.9,1332350,16510,43082.7,555250,85860,95830.2,777100
109610,140595.9,1332350,19650,39892.8,555250,89960,100703.1,777100
116850,139928.5,1332350,22780,37364.2,555250,94070,102564.3,777100
125500,135757.6,1332350,26250,35560.9,555250,99250,100196.7,777100
134170,148387.3,1332350,29740,42521.1,555250,104430,105866.2,777100
142820,186187.8,1332350,33240,61628.8,555250,109580,124559,777100
151460,230706.5,1332350,36730,82022.2,555250,114730,148684.3,777100
160760,238692.7,1332350,40430,82817,555250,120330,155875.7,777100
170050,225247.1,1332350,44160,76817.3,555250,125890,148429.8,777100
179390,223456.6,1332350,47880,77592.2,555250,131510,145864.4,777100
188690,216503,1332350,51570,75804.9,555250,137120,140698.1,777100
199110,189614.4,1332350,59520,68332.9,555250,139590,121281.5,777100
209660,170249.3,1332350,67520,60190.9,555250,142140,110058.4,777100
220050,148093.1,1332350,75470,52765.4,555250,144580,95327.7,777100
230570,141177.3,1332350,83450,51677,555250,147120,89500.3,777100
240900,160068.2,1332350,91560,66117.5,555250,149340,93950.7,777100
251180,173109.6,1332350,99640,74671.5,555250,151540,98438.1,777100
261520,190835.8,1332350,107730,83825.6,555250,153790,107010.2,777100
271810,207077.4,1332350,115830,92254.2,555250,155980,114823.2,777100
282700,241370.9,1332350,122480,113219.3,555250,160220,128151.6,777100
293630,254569.7,1332350,129140,118819,555250,164490,135750.7,777100
304510,265270.8,1332350,135790,118771.5,555250,168720,146499.3,777100
315410,266349,1332350,142450,114737.8,555250,172960,151611.2,777100
333290,243504.3,1332350,148280,92559.6,555250,185010,150944.7,777100
351170,210129.3,1332350,154110,63527.4,555250,197060,146601.9,777100
368990,175297.3,1332350,159900,39327.8,555250,209090,135969.5,777100
386860,179970.3,1332350,165730,43474.9,555250,221130,136495.4,777100
412090,158159.5,1332350,176430,40766.3,555250,235660,117393.2,777100
437170,168432.8,1332350,187160,52445.1,555250,250010,115987.7,777100
462340,155844.3,1332350,197870,49127.2,555250,264470,106717.1,777100
487510,187416.9,1332350,208590,65646.2,555250,278920,121770.7,777100
511000,231712,1332350,219680,91555.3,555250,291320,140156.7,777100
534520,242518.3,1332350,230750,96985.6,555250,303770,145532.7,777100
558050,249594.1,1332350,241810,94289.5,555250,316240,155304.6,777100
581550,243683.5,1332350,252880,95075.8,555250,328670,148607.7,777100
576540,256623.5,1332350,253650,104166.2,555250,322890,152457.3,777100
571530,253626.2,1332350,254390,105910.5,555250,317140,147715.7,777100
566450,224730.4,1332350,255100,89979.8,555250,311350,134750.6,777100
561410,254607,1332350,255860,102015.4,555250,305550,152591.6,777100
556800,271865.4,1332350,257520,107611.3,555250,299280,164254.1,777100
552200,265460.1,1332350,259200,103581.8,555250,293000,161878.3,777100
547520,263810.6,1332350,260850,108153.8,555250,286670,155656.8,777100
542920,271462.8,1332350,262510,118455.9,555250,280410,153006.9,777100
539110,296977.8,1332350,264720,134128.7,555250,274390,162849.1,777100
535310,360248,1332350,266920,170155.1,555250,268390,190092.9,777100
531490,417305.2,1332350,269140,202420.6,555250,262350,214884.6,777100
527640,420150,1332350,271330,201326.4,555250,256310,218823.6,777100
522860,410174.7,1332350,272120,199263.6,555250,250740,210911.1,777100
518110,404997.9,1332350,272890,202758.7,555250,245220,202239.2,777100
513320,391401.8,1332350,273670,200105.2,555250,239650,191296.6,777100
508540,378631.9,1332350,274450,198985.9,555250,234090,179646,777100
504620,609740.6,1332350,274700,375005.1,555250,229920,234735.5,777100
500650,661708.5,1332350,274960,387321.7,555250,225690,274386.8,777100
496710,707587.4,1332350,275220,416614.6,555250,221490,290972.8,777100
492800,679563.6,1332350,275490,406256.4,555250,217310,273307.2,777100
491600,649151.2,1332350,277980,391944.9,555250,213620,257206.3,777100
490450,655742.3,1332350,280490,398596.3,555250,209960,257146,777100
489280,691097.8,1332350,283000,418675.1,555250,206280,272422.7,777100
488090,677103.5,1332350,285480,419237.2,555250,202610,257866.3,777100
488320,610864,1332350,288960,377545.1,555250,199360,233318.9,777100
488560,581865.4,1332350,292420,365197.8,555250,196140,216667.6,777100
488770,583713.6,1332350,295860,363090.5,555250,192910,220623.1,777100
488990,503013.4,1332350,299320,322286.9,555250,189670,180726.5,777100
490060,460620.8,1332350,301520,295325.5,555250,188540,165295.3,777100
491120,457816.4,1332350,303700,298555.7,555250,187420,159260.7,777100
492150,434921.2,1332350,305900,291073.9,555250,186250,143847.3,777100
493250,407141.9,1332350,308110,268026,555250,185140,139115.9,777100
493600,381587.3,1332350,309100,255415.2,555250,184500,126172.1,777100
493970,311273.8,1332350,310100,214434.6,555250,183870,96839.2,777100
494320,267413.7,1332350,311130,192367.3,555250,183190,75046.4,777100
494660,243610.8,1332350,312130,181865,555250,182530,61745.8,777100
500870,256795.6,1332350,313660,190191.2,555250,187210,66604.4,777100
507180,258580.4,1332350,315200,190127.7,555250,191980,68452.7,777100
513380,245741.2,1332350,316700,182664.1,555250,196680,63077.1,777100
398510,277967.1,1332350,257080,199450.7,555250,141430,78516.4,777100
398300,280256.5,1332350,257290,205040.8,555250,141010,75215.7,777100
398030,267935.4,1332350,257470,199505.9,555250,140560,68429.5,777100
397780,274876.3,1332350,257660,197885.9,555250,140120,76990.4,777100
397590,347577.8,1332350,257860,229969.3,555250,139730,117608.5,777100
395900,399800.4,1332350,256940,267800.4,555250,138960,132000,777100
394250,437630.1,1332350,256040,292690.7,555250,138210,144939.4,777100
392650,465946.4,1332350,255110,312145.3,555250,137540,153801.1,777100
391010,516189,1332350,254200,340210.1,555250,136810,175978.9,777100
388940,562663.8,1332350,250030,361713.5,555250,138910,200950.3,777100
386820,568632.6,1332350,245800,362285.7,555250,141020,206346.9,777100
384730,634900.5,1332350,241600,395315.9,555250,143130,239584.6,777100
382640,609954.7,1332350,237400,375307.5,555250,145240,234647.2,777100
380520,583950.9,1332350,232470,350740.7,555250,148050,233210.2,777100
378390,595178.2,1332350,227540,357050.5,555250,150850,238127.7,777100
376240,546336.4,1332350,222610,327185.9,555250,153630,219150.5,777100
374140,526265.8,1332350,217690,309703,555250,156450,216562.8,777100
372160,495945.9,1332350,213400,286347.9,555250,158760,209598,777100
370150,487786.2,1332350,209100,280274.8,555250,161050,207511.4,777100
368170,478993.4,1332350,204790,269214,555250,163380,209779.4,777100
366220,433917,1332350,200520,245648.7,555250,165700,188268.3,777100
356570,401241.3,1332350,194560,222084.8,555250,162010,179156.5,777100
346980,365235.8,1332350,188630,202791.1,555250,158350,162444.7,777100
337380,333386.9,1332350,182710,183210.1,555250,154670,150176.8,777100
327760,325817.8,1332350,176820,174443.4,555250,150940,151374.4,777100
318740,344336.4,1332350,172010,181551.6,555250,146730,162784.8,777100
309670,380407.8,1332350,167210,203322.5,555250,142460,177085.3,777100
300600,428740.2,1332350,162430,235541.7,555250,138170,193198.5,777100
291540,417367.4,1332350,157630,231227.4,555250,133910,186140,777100
285260,371347.7,1332350,154470,204707.8,555250,130790,166639.9,777100
279010,351480.5,1332350,151310,195453,555250,127700,156027.5,777100
272740,345389.2,1332350,148160,191991.3,555250,124580,153397.9,777100
266510,380176,1332350,144960,214555.7,555250,121550,165620.3,777100
270570,392997.2,1332350,151090,227099.6,555250,119480,165897.6,777100
274530,365252.7,1332350,157150,213865.4,555250,117380,151387.3,777100
278560,343136,1332350,163210,205215,555250,115350,137921,777100
282560,322878.1,1332350,169270,198310.9,555250,113290,124567.2,777100
287150,332504.8,1332350,175000,206166.5,555250,112150,126338.3,777100
291740,313244.6,1332350,180680,200630.7,555250,111060,112613.9,777100
296330,303569.5,1332350,186390,197296.5,555250,109940,106273,777100
300980,260735.9,1332350,192100,174839.8,555250,108880,85896.1,777100
306920,242666.3,1332350,198260,167682.3,555250,108660,74984,777100
312780,228981.7,1332350,204400,160254.1,555250,108380,68727.6,777100
318640,217914.2,1332350,210530,153870.4,555250,108110,64043.8,777100
324640,234736.8,1332350,216680,163945.2,555250,107960,70791.6,777100
342270,248262.9,1332350,221540,166720.1,555250,120730,81542.8,777100
359910,241533.2,1332350,226400,152048,555250,133510,89485.2,777100
377600,239153.4,1332350,231270,143030.6,555250,146330,96122.8,777100
395200,268540.5,1332350,236130,147792.8,555250,159070,120747.7,777100
412570,303618.9,1332350,240240,162234.5,555250,172330,141384.4,777100
430000,368570.1,1332350,244380,194969,555250,185620,173601.1,777100
447390,429312.1,1332350,248480,231235.3,555250,198910,198076.8,777100
464750,499991.7,1332350,252610,273709.8,555250,212140,226281.9,777100
483300,480450.1,1332350,257550,262663,555250,225750,217787.1,777100
501850,491904.8,1332350,262480,258478.9,555250,239370,233425.9,777100
520340,534400.7,1332350,267420,281637,555250,252920,252763.7,777100
538900,545957.7,1332350,272380,282053.4,555250,266520,263904.3,777100
544480,551860.2,1332350,276820,283572.3,555250,267660,268287.9,777100
550040,543812.5,1332350,281300,282611,555250,268740,261201.5,777100
555540,539795.9,1332350,285770,288727.5,555250,269770,251068.4,777100
561140,595529.4,1332350,290220,324436.5,555250,270920,271092.9,777100
564940,627904.7,1332350,293590,343823.2,555250,271350,284081.5,777100
568810,650328.2,1332350,296950,364000.3,555250,271860,286327.9,777100
572640,649366.8,1332350,300320,363950.8,555250,272320,285416,777100
576500,690316.2,1332350,303680,383308.3,555250,272820,307007.9,777100
582040,709747.6,1332350,308440,400112.3,555250,273600,309635.3,777100
587660,711841.7,1332350,313210,399374.7,555250,274450,312467,777100
593230,718533.7,1332350,317960,395104.1,555250,275270,323429.6,777100
598830,693892.3,1332350,322720,381076.2,555250,276110,312816.1,777100
589350,647554.3,1332350,322100,349643.1,555250,267250,297911.2,777100
579760,605746,1332350,321460,329458.4,555250,258300,276287.6,777100
570270,642483.5,1332350,320830,355164,555250,249440,287319.5,777100
560730,652415.7,1332350,320210,368271,555250,240520,284144.7,777100
550480,672050.2,1332350,318810,380957.4,555250,231670,291092.8,777100
540340,650243.6,1332350,317410,369786.5,555250,222930,280457.1,777100
530150,613196.6,1332350,315990,349918.7,555250,214160,263277.9,777100
519940,614939.2,1332350,314580,361207.7,555250,205360,253731.5,777100
509070,614149.2,1332350,313360,364693,555250,195710,249456.2,777100
498160,562427.2,1332350,312120,339233.8,555250,186040,223193.4,777100
487200,515903.7,1332350,310880,318615,555250,176320,197288.7,777100
476470,492145.4,1332350,309670,316697,555250,166800,175448.4,777100
478520,525488.7,1332350,311260,342882.2,555250,167260,182606.5,777100
480800,574950.3,1332350,312900,376324.9,555250,167900,198625.4,777100
483040,604468,1332350,314520,395081.3,555250,168520,209386.7,777100
485300,618922.2,1332350,316160,404579.2,555250,169140,214343,777100
487040,644935.5,1332350,317660,415344.5,555250,169380,229591,777100
488890,613654.5,1332350,319160,391583.1,555250,169730,222071.4,777100
490740,637574,1332350,320700,401481,555250,170040,236093,777100
492540,653051.1,1332350,322240,412088.1,555250,170300,240963,777100
495690,656354.6,1332350,323880,409903.6,555250,171810,246451,777100
498800,640492.2,1332350,325520,395440.6,555250,173280,245051.6,777100
501960,666960.7,1332350,327150,408005.6,555250,174810,258955.1,777100
505050,669459.1,1332350,328780,408061.5,555250,176270,261397.6,777100
519640,678808.2,1332350,334040,410323.2,555250,185600,268485,777100
534160,708455.6,1332350,339360,426674.2,555250,194800,281781.4,777100
548790,792558.8,1332350,344640,471410,555250,204150,321148.8,777100
578480,787717.9,1332350,371980,481754.7,555250,206500,305963.2,777100
592290,776707.6,1332350,376180,476087.2,555250,216110,300620.4,777100
606170,768212.7,1332350,380340,459140,555250,225830,309072.7,777100
620150,734904.3,1332350,384540,431545.4,555250,235610,303358.9,777100
633970,758487.2,1332350,388710,439230.7,555250,245260,319256.5,777100
646690,764509.9,1332350,392710,439009,555250,253980,325500.9,777100
659410,783212.3,1332350,396770,443458.2,555250,262640,339754.1,777100
672160,784858.1,1332350,400780,440935.2,555250,271380,343922.9,777100
684880,777790.8,1332350,404780,439889.2,555250,280100,337901.6,777100
694080,761861.2,1332350,406890,445189.5,555250,287190,316671.7,777100
703310,759401,1332350,408990,445630.7,555250,294320,313770.3,777100
712530,777517.8,1332350,411070,452222,555250,301460,325295.8,777100
721740,777668.6,1332350,413180,448388.9,555250,308560,329279.7,777100
731430,769504.8,1332350,415410,444711,555250,316020,324793.8,777100
741270,775797.6,1332350,417660,441432,555250,323610,334365.6,777100
751100,792229.4,1332350,419870,441773.3,555250,331230,350456.1,777100
760770,829846.9,1332350,422070,456827.1,555250,338700,373019.8,777100
769450,858776.4,1332350,423150,461438.6,555250,346300,397337.8,777100
777880,870493.6,1332350,424140,463745.2,555250,353740,406748.4,777100
786490,870639.8,1332350,425190,460102.4,555250,361300,410537.4,777100
795000,864257.4,1332350,426200,455905.1,555250,368800,408352.3,777100
799340,877166.1,1332350,425660,461010.7,555250,373680,416155.4,777100
803610,884884.7,1332350,425110,464421.4,555250,378500,420463.3,777100
807970,898923.5,1332350,424560,471561.2,555250,383410,427362.3,777100
812250,886986,1332350,424010,466968.2,555250,388240,420017.8,777100
816380,877262.2,1332350,423790,462507.2,555250,392590,414755,777100
820600,885287.2,1332350,423600,462405.3,555250,397000,422881.9,777100
824850,869779,1332350,423410,460473.8,555250,401440,409305.2,777100
828980,884515.3,1332350,423200,466478.8,555250,405780,418036.5,777100
833060,894598.3,1332350,423430,472149.1,555250,409630,422449.2,777100
837080,887453.6,1332350,423660,462949.8,555250,413420,424503.8,777100
841220,866928,1332350,423890,453355.4,555250,417330,413572.6,777100
845200,846908.6,1332350,424110,446797.9,555250,421090,400110.7,777100
850850,870774.8,1332350,423370,458494.5,555250,427480,412280.3,777100
856520,898283.6,1332350,422650,471740.4,555250,433870,426543.2,777100
862140,910896.9,1332350,421920,474961.7,555250,440220,435935.2,777100
867780,900005.2,1332350,421180,467766.7,555250,446600,432238.5,777100
871240,924610.5,1332350,418650,472797.5,555250,452590,451813,777100
874740,954515.8,1332350,416100,480243.8,555250,458640,474272,777100
878200,946266.2,1332350,413540,475696.4,555250,464660,470569.8,777100
881640,940816.1,1332350,411010,473973.6,555250,470630,466842.5,777100
888340,949086.5,1332350,411300,471668.2,555250,477040,477418.3,777100
894980,914350.1,1332350,411580,460462.9,555250,483400,453887.2,777100
901640,932169.3,1332350,411880,469041.5,555250,489760,463127.8,777100
908290,953905.3,1332350,412170,476222.9,555250,496120,477682.4,777100
903700,904550.4,1332350,409750,456353.5,555250,493950,448196.9,777100
899080,917609.9,1332350,407310,460810.8,555250,491770,456799.1,777100
894630,919817.7,1332350,404920,457940.1,555250,489710,461877.6,777100
890010,931164.3,1332350,402480,456351,555250,487530,474813.3,777100
888860,908742.7,1332350,403230,452826.3,555250,485630,455916.4,777100
887700,909917.3,1332350,403990,452856.5,555250,483710,457060.8,777100
886510,914063.4,1332350,404710,460408.5,555250,481800,453654.9,777100
885330,913660.7,1332350,405480,456876.4,555250,479850,456784.3,777100
881790,930467.1,1332350,404780,453811.2,555250,477010,476655.9,777100
878210,941385,1332350,404100,457665.1,555250,474110,483719.9,777100
874610,938725.7,1332350,403380,452463.1,555250,471230,486262.6,777100
871020,925752.9,1332350,402670,443496.8,555250,468350,482256.1,777100
867570,915899.1,1332350,402230,438782.4,555250,465340,477116.7,777100
864170,926314.1,1332350,401780,447613.9,555250,462390,478700.2,777100
860640,917593.1,1332350,401310,451717,555250,459330,465876.1,777100
857260,930807.6,1332350,400870,446487.9,555250,456390,484319.7,777100
853700,947448.3,1332350,400880,448531.3,555250,452820,498917,777100
850180,929184.5,1332350,400920,445423.6,555250,449260,483760.9,777100
846710,918442.2,1332350,400950,442577.4,555250,445760,475864.8,777100
843130,946847.1,1332350,401000,448071.5,555250,442130,498775.6,777100
838660,931456.9,1332350,400410,447373.2,555250,438250,484083.7,777100
834060,945646.2,1332350,399780,461697.4,555250,434280,483948.8,777100
829430,968967.1,1332350,399210,481755.1,555250,430220,487212,777100
824930,950011.1,1332350,398640,473178.3,555250,426290,476832.8,777100
807260,907180.4,1332350,394770,447490.6,555250,412490,459689.8,777100
789560,905756.7,1332350,390940,450207.7,555250,398620,455549,777100
771820,879140.9,1332350,387100,452533.8,555250,384720,426607.1,777100
754120,884771.4,1332350,383250,450415.8,555250,370870,434355.6,777100
736590,874427.3,1332350,379460,445338,555250,357130,429089.3,777100
718990,821139.7,1332350,375660,434810.6,555250,343330,386329.1,777100
701390,796857.8,1332350,371850,430804.7,555250,329540,366053.1,777100
683930,794519.5,1332350,368060,434155.5,555250,315870,360364,777100
665220,764250.4,1332350,364090,425683.1,555250,301130,338567.3,777100
646600,738994.5,1332350,360120,417093,555250,286480,321901.5,777100
627870,719316.5,1332350,356140,407868.2,555250,271730,311448.3,777100
609270,698459.7,1332350,352210,400397.5,555250,257060,298062.2,777100
599590,671959.9,1332350,349390,385953.5,555250,250200,286006.4,777100
590040,637214.4,1332350,346600,377550.9,555250,243440,259663.5,777100
580340,649970.3,1332350,343780,386707.2,555250,236560,263263.1,777100
570810,649246.9,1332350,341040,394752.7,555250,229770,254494.2,777100
561690,622249.2,1332350,337330,386089.6,555250,224360,236159.6,777100
552470,616053.4,1332350,333610,381487.7,555250,218860,234565.7,777100
543290,593439.7,1332350,329880,368909.7,555250,213410,224530,777100
534180,571432.5,1332350,326180,355496.5,555250,208000,215936,777100
526810,580593.8,1332350,323590,357493.8,555250,203220,223100,777100
519380,586059.2,1332350,320990,363597.5,555250,198390,222461.7,777100
511980,588672.4,1332350,318360,364926.9,555250,193620,223745.5,777100
504560,595252.4,1332350,315750,366480.1,555250,188810,228772.3,777100
505130,629963.3,1332350,315890,383494.5,555250,189240,246468.8,777100
505650,628316.6,1332350,316000,381422.5,555250,189650,246894.1,777100
506310,599688,1332350,316150,364890.4,555250,190160,234797.6,777100
477470,596019.8,1332350,308400,367278.6,555250,169070,228741.2,777100
477230,587601.6,1332350,307750,369705.2,555250,169480,217896.4,777100
477010,575495.4,1332350,307120,363844.3,555250,169890,211651.1,777100
476870,573471.7,1332350,306500,363264.3,555250,170370,210207.4,777100
476650,593998.1,1332350,305820,371916.8,555250,170830,222081.3,777100
477350,584977,1332350,305800,370086,555250,171550,214891,777100
478190,599773.7,1332350,305850,380762.6,555250,172340,219011.1,777100
478980,644076.7,1332350,305870,402952.2,555250,173110,241124.5,777100
479830,619914.7,1332350,305890,388252.7,555250,173940,231662,777100
479850,586742.2,1332350,303730,368910.8,555250,176120,217831.4,777100
479830,514826,1332350,301580,322847,555250,178250,191979,777100
479910,475391.5,1332350,299440,294831.3,555250,180470,180560.2,777100
479920,519201.5,1332350,297290,321274.6,555250,182630,197926.9,777100
481260,501923,1332350,296000,312864.8,555250,185260,189058.2,777100
482480,426206.1,1332350,294680,269101.5,555250,187800,157104.6,777100
483780,417773.4,1332350,293390,264570.4,555250,190390,153203,777100
485060,442404.1,1332350,292070,277689.5,555250,192990,164714.6,777100
485850,476297,1332350,291060,292706.4,555250,194790,183590.6,777100
486700,480063.8,1332350,290100,294945,555250,196600,185118.8,777100
487530,476887.6,1332350,289070,293747,555250,198460,183140.6,777100
488370,505783.6,1332350,288080,311416.2,555250,200290,194367.4,777100
491870,501095.4,1332350,287360,309403,555250,204510,191692.4,777100
495460,488505.6,1332350,286660,302069.1,555250,208800,186436.5,777100
498990,450911.1,1332350,285930,279146.6,555250,213060,171764.5,777100
502630,481405,1332350,285210,296254.3,555250,217420,185150.7,777100
508830,546087.7,1332350,286640,331984.6,555250,222190,214103.1,777100
515100,587665.7,1332350,288000,355603.2,555250,227100,232062.5,777100
521300,476000.8,1332350,289370,285668.2,555250,231930,190332.6,777100
527520,389028.3,1332350,290740,230515.9,555250,236780,158512.4,777100
535090,349971.1,1332350,293200,207765.9,555250,241890,142205.2,777100
542670,366254.3,1332350,295640,216164.7,555250,247030,150089.6,777100
550250,346848.8,1332350,298110,194893.9,555250,252140,151954.9,777100
557960,322504.7,1332350,300560,189159.6,555250,257400,133345.1,777100
564230,355487.4,1332350,298320,206020.2,555250,265910,149467.2,777100
570570,388595.5,1332350,296130,214431.6,555250,274440,174163.9,777100
576810,459875,1332350,293910,248299.8,555250,282900,211575.2,777100
583150,484911.3,1332350,291720,262114.5,555250,291430,222796.8,777100
595980,445444.4,1332350,293440,234444.8,555250,302540,210999.6,777100
608760,514383.5,1332350,295180,262473.3,555250,313580,251910.2,777100
621630,537966,1332350,296910,271878.4,555250,324720,266087.6,777100
634410,540600.6,1332350,298600,276369.2,555250,335810,264231.4,777100
647100,602900.4,1332350,299760,304763.2,555250,347340,298137.2,777100
659880,568844.2,1332350,300900,278283.4,555250,358980,290560.8,777100
672500,592064.1,1332350,302040,289487.4,555250,370460,302576.7,777100
685260,589434.7,1332350,303190,291705.5,555250,382070,297729.2,777100
704140,575750.2,1332350,312340,294480.3,555250,391800,281269.9,777100
722990,618762.8,1332350,321500,319914.6,555250,401490,298848.2,777100
741840,657273,1332350,330630,334035.3,555250,411210,323237.7,777100
760790,657540.7,1332350,339810,324926,555250,420980,332614.7,777100
777510,682874.9,1332350,347430,329192.4,555250,430080,353682.5,777100
794160,674968.5,1332350,355070,334441.2,555250,439090,340527.3,777100
810810,686993.5,1332350,362670,336656.4,555250,448140,350337.1,777100
827520,694057.7,1332350,370280,330877.8,555250,457240,363179.9,777100
843870,710056.1,1332350,377710,340684.7,555250,466160,369371.4,777100
860160,770551.2,1332350,385150,367817.1,555250,475010,402734.1,777100
876540,786277.1,1332350,392580,367228.4,555250,483960,419048.7,777100
892880,822522.6,1332350,399990,382350.2,555250,492890,440172.4,777100
896570,922847.1,1332350,401490,440220.8,555250,495080,482626.3,777100
900230,993470.8,1332350,402950,466081.7,555250,497280,527389.1,777100
903980,972040.2,1332350,404430,445448.3,555250,499550,526591.9,777100
907700,969560.1,1332350,405910,447012,555250,501790,522548.1,777100
913540,969150.9,1332350,409920,443821.7,555250,503620,525329.2,777100
919410,998139,1332350,413890,472960.5,555250,505520,525178.5,777100
925250,1041994.8,1332350,417900,486312,555250,507350,555682.8,777100
931160,1074568.8,1332350,421890,493514.2,555250,509270,581054.6,777100
933150,1082953,1332350,423000,507258.6,555250,510150,575694.4,777100
935130,1087750.5,1332350,424090,501937,555250,511040,585813.5,777100
937120,1069310.9,1332350,425220,498887.3,555250,511900,570423.6,777100
939040,1095326.6,1332350,426270,513163,555250,512770,582163.6,777100
936340,1088737.7,1332350,426000,509590.2,555250,510340,579147.5,777100
933610,1084386.7,1332350,425660,510985.2,555250,507950,573401.5,777100
930870,1074416.8,1332350,425390,508714.7,555250,505480,565702.1,777100
928080,1064409.1,1332350,425060,506304,555250,503020,558105.1,777100
921770,1047645.8,1332350,422470,497851.5,555250,499300,549794.3,777100
915370,1072183.7,1332350,419820,510992.9,555250,495550,561190.8,777100
908970,1047844.5,1332350,417200,507492.6,555250,491770,540351.9,777100
902620,1015801.5,1332350,414590,504092,555250,488030,511709.5,777100
904400,1043617.3,1332350,418510,511655.2,555250,485890,531962.1,777100
906200,1030297.6,1332350,422430,503314.9,555250,483770,526982.7,777100
907960,1008512.4,1332350,426340,494433.2,555250,481620,514079.2,777100
909700,1002263.6,1332350,430260,493144.6,555250,479440,509119,777100
886260,991444.1,1332350,414520,491576.6,555250,471740,499867.5,777100
862930,988724,1332350,398810,486565.8,555250,464120,502158.2,777100
839540,1021543.9,1332350,383090,500592.7,555250,456450,520951.2,777100
816170,1021698.6,1332350,367370,493056.8,555250,448800,528641.8,777100
808070,985290.4,1332350,364790,472905.4,555250,443280,512385,777100
800060,974797.3,1332350,362230,470999.6,555250,437830,503797.7,777100
792010,954358,1332350,359660,466508.1,555250,432350,487849.9,777100
783950,788738.5,1332350,357110,374517.7,555250,426840,414220.8,777100
778920,682818.5,1332350,355600,308239.5,555250,423320,374579,777100
773920,655773,1332350,354140,285324.6,555250,419780,370448.4,777100
768960,544990.2,1332350,352670,207506.5,555250,416290,337483.7,777100
763870,579163.5,1332350,351180,221332,555250,412690,357831.5,777100
755510,728907.8,1332350,349170,311191.8,555250,406340,417716,777100
747100,660260.4,1332350,347200,271980.9,555250,399900,388279.5,777100
738700,677612.8,1332350,345220,291836.4,555250,393480,385776.4,777100
793000,823337.1,1332350,356260,374526.3,555250,436740,448810.8,777100
786530,797061.7,1332350,351950,367189.1,555250,434580,429872.6,777100
780060,780141.4,1332350,347650,360674.4,555250,432410,419467,777100
773600,840924,1332350,343390,388446.5,555250,430210,452477.5,777100
767120,777154.3,1332350,339080,353401.6,555250,428040,423752.7,777100
765220,719373.8,1332350,339810,330049.5,555250,425410,389324.3,777100
763520,773137.8,1332350,340540,363551.5,555250,422980,409586.3,777100
761740,763838.2,1332350,341310,356762,555250,420430,407076.2,777100
759900,586779.1,1332350,342050,262363.5,555250,417850,324415.6,777100
749430,502989.2,1332350,339850,221589.2,555250,409580,281400,777100
738980,490965.8,1332350,337620,216706.1,555250,401360,274259.7,777100
728550,600900.1,1332350,335430,273277.4,555250,393120,327622.7,777100
718040,701528.3,1332350,333230,333570.1,555250,384810,367958.2,777100
706780,679545,1332350,330080,326653.2,555250,376700,352891.8,777100
695480,748190.3,1332350,326950,371537.2,555250,368530,376653.1,777100
684120,790650.5,1332350,323770,393715.8,555250,360350,396934.7,777100
672870,792587.5,1332350,320650,392942.8,555250,352220,399644.7,777100
662540,796530.5,1332350,318250,396221.2,555250,344290,400309.3,777100
652200,738961.2,1332350,315880,384433,555250,336320,354528.2,777100
641880,769457.2,1332350,313480,405477.8,555250,328400,363979.4,777100
631540,740787.3,1332350,311090,389086,555250,320450,351701.3,777100
626370,718267.9,1332350,309620,380187.8,555250,316750,338080.1,777100
621160,724291.8,1332350,308190,380214.8,555250,312970,344077,777100
616000,717830,1332350,306730,377694,555250,309270,340136,777100
610800,713467.6,1332350,305290,377809.5,555250,305510,335658.1,777100
607030,716298.8,1332350,304600,379793.4,555250,302430,336505.4,777100
603180,674054.4,1332350,303890,359619.7,555250,299290,314434.7,777100
599380,685214.3,1332350,303190,368371.9,555250,296190,316842.4,777100
595530,676096.3,1332350,302500,365788.4,555250,293030,310307.9,777100
589530,675480.1,1332350,300470,368560,555250,289060,306920.1,777100
583580,598632.1,1332350,298480,318115,555250,285100,280517.1,777100
577600,533418.6,1332350,296460,284417,555250,281140,249001.6,777100
571620,552198.7,1332350,294450,296114.8,555250,277170,256083.9,777100
580780,541774.5,1332350,295630,291297.6,555250,285150,250476.9,777100
589930,522193.3,1332350,296800,283094.1,555250,293130,239099.2,777100
599160,559773.5,1332350,297980,295316.8,555250,301180,264456.7,777100
608300,584249.9,1332350,299140,314134.4,555250,309160,270115.5,777100
616210,601373.9,1332350,299230,317229.9,555250,316980,284144,777100
624170,655923.7,1332350,299300,343072.7,555250,324870,312851,777100
632150,635628.5,1332350,299360,326191.5,555250,332790,309437,777100
640060,690838.5,1332350,299440,349648.1,555250,340620,341190.4,777100
648170,634218.1,1332350,300030,317594.7,555250,348140,316623.4,777100
656380,609586.6,1332350,300680,304979.9,555250,355700,304606.7,777100
664480,559648.1,1332350,301280,278908.1,555250,363200,280740,777100
672660,553300.3,1332350,301900,267471.8,555250,370760,285828.5,777100
665430,526668.6,1332350,295470,248150.9,555250,369960,278517.7,777100
658250,501680.4,1332350,289050,231120.7,555250,369200,270559.7,777100
650970,510053.5,1332350,282620,235050.5,555250,368350,275003,777100
643790,493529.7,1332350,276160,221399.2,555250,367630,272130.5,777100
639110,446709.8,1332350,272320,193021,555250,366790,253688.8,777100
634460,429122.6,1332350,268440,177550.7,555250,366020,251571.9,777100
629790,427235.9,1332350,264580,179261.8,555250,365210,247974.1,777100
625130,486215.4,1332350,260710,216429,555250,364420,269786.4,777100
616910,506777.5,1332350,254610,220209.2,555250,362300,286568.3,777100
608520,529899.1,1332350,248410,224258.4,555250,360110,305640.7,777100
600220,565698.9,1332350,242280,248225.2,555250,357940,317473.7,777100
591900,545060.4,1332350,236130,242824.1,555250,355770,302236.3,777100
585250,548042.6,1332350,234700,227398.9,555250,350550,320643.7,777100
578660,553957.1,1332350,233290,240809.2,555250,345370,313147.9,777100
572060,593078,1332350,231890,263510.5,555250,340170,329567.5,777100
565380,590303.2,1332350,230490,259606.9,555250,334890,330696.3,777100
561930,582733.5,1332350,231690,273557.5,555250,330240,309176,777100
558500,667838.8,1332350,232890,308717.9,555250,325610,359120.9,777100
555050,690824.6,1332350,234110,322723,555250,320940,368101.6,777100
551590,720986.8,1332350,235330,354102.2,555250,316260,366884.6,777100
549200,705586.3,1332350,237940,356661.1,555250,311260,348925.2,777100
546830,683779.8,1332350,240610,334302.7,555250,306220,349477.1,777100
544410,690816.9,1332350,243200,332054.6,555250,301210,358762.3,777100
542040,777030.2,1332350,245850,380197.7,555250,296190,396832.5,777100
535640,806944.4,1332350,249070,409695.4,555250,286570,397249,777100
529210,808925.7,1332350,252300,419898.2,555250,276910,389027.5,777100
522800,818726,1332350,255530,428142.9,555250,267270,390583.1,777100
516410,802476.9,1332350,258800,425673.6,555250,257610,376803.3,777100
509310,791353.3,1332350,261700,424228.2,555250,247610,367125.1,777100
502290,793276.4,1332350,264710,427711.6,555250,237580,365564.8,777100
495240,793420,1332350,267640,433946.3,555250,227600,359473.7,777100
488270,771197.6,1332350,270620,426454.4,555250,217650,344743.2,777100
479020,726533.9,1332350,272350,417712.2,555250,206670,308821.7,777100
469820,718968.6,1332350,274130,424508.7,555250,195690,294459.9,777100
460760,724750,1332350,275900,430055.7,555250,184860,294694.3,777100
451590,703102.5,1332350,277690,416307.8,555250,173900,286794.7,777100
451330,656579.1,1332350,278730,391588.1,555250,172600,264991,777100
451040,563933.5,1332350,279790,347019.3,555250,171250,216914.2,777100
450720,497944.8,1332350,280820,320305.5,555250,169900,177639.3,777100
450490,470948,1332350,281850,303377.6,555250,168640,167570.4,777100
453360,479836.2,1332350,284330,301119.6,555250,169030,178716.6,777100
456150,480277.9,1332350,286810,299218.1,555250,169340,181059.8,777100
459040,431491.8,1332350,289300,269515.2,555250,169740,161976.6,777100
461860,425688,1332350,291790,256196.9,555250,170070,169491.1,777100
464000,467966.9,1332350,292960,272567.2,555250,171040,195399.7,777100
466110,514594.4,1332350,294150,305693.6,555250,171960,208900.8,777100
468320,559776.1,1332350,295340,331796.9,555250,172980,227979.2,777100
470440,615685.7,1332350,296490,359249.8,555250,173950,256435.9,777100
479230,641115.9,1332350,299400,373799.6,555250,179830,267316.3,777100
487980,680141.4,1332350,302260,394755,555250,185720,285386.4,777100
496820,727389.2,1332350,305160,416809.2,555250,191660,310580,777100
559660,772301.6,1332350,328600,437319.1,555250,231060,334982.5,777100
572460,809614.7,1332350,332650,456964.8,555250,239810,352649.9,777100
585270,822589.3,1332350,336700,459987.6,555250,248570,362601.7,777100
598060,868060.7,1332350,340760,480106.4,555250,257300,387954.3,777100
610900,894447.5,1332350,344830,485396.6,555250,266070,409050.9,777100
624980,909878.2,1332350,349530,483967.3,555250,275450,425910.9,777100
639070,919178.6,1332350,354240,482235.1,555250,284830,436943.5,777100
653180,908683.1,1332350,358960,470266.1,555250,294220,438417,777100
667230,930138.6,1332350,363660,480382.8,555250,303570,449755.8,777100
674900,950540.4,1332350,363950,491098.6,555250,310950,459441.8,777100
682420,950979,1332350,364190,490552.3,555250,318230,460426.7,777100
690100,953398.4,1332350,364480,485298.2,555250,325620,468100.2,777100
697670,950521.8,1332350,364740,481873.6,555250,332930,468648.2,777100
705570,939088.5,1332350,365250,469224,555250,340320,469864.5,777100
713530,917449.9,1332350,365780,460131.9,555250,347750,457318,777100
721420,931470.7,1332350,366270,460276.3,555250,355150,471194.4,777100
729260,952272.4,1332350,366790,475065.3,555250,362470,477207.1,777100
735130,965566.7,1332350,366190,482161.8,555250,368940,483404.9,777100
740920,939729.4,1332350,365620,465065.7,555250,375300,474663.7,777100
746750,918093,1332350,364990,451342.2,555250,381760,466750.8,777100
752650,965318.1,1332350,364430,473444.2,555250,388220,491873.9,777100
751620,919884.4,1332350,363150,452215.2,555250,388470,467669.2,777100
750460,912960.3,1332350,361840,453040.3,555250,388620,459920,777100
749380,915703.9,1332350,360520,442831.3,555250,388860,472872.6,777100
748320,906582.3,1332350,359220,435976.1,555250,389100,470606.2,777100
747510,916498.4,1332350,357770,441564.6,555250,389740,474933.8,777100
746710,923169,1332350,356300,449570.1,555250,390410,473598.9,777100
745870,927852.8,1332350,354840,452335.3,555250,391030,475517.5,777100
745100,914047,1332350,353390,439386.8,555250,391710,474660.2,777100
743540,934606.3,1332350,351190,447470.5,555250,392350,487135.8,777100
742010,939013.9,1332350,348970,449852.2,555250,393040,489161.7,777100
740330,915372.7,1332350,346770,437865.6,555250,393560,477507.1,777100
738780,918682.5,1332350,344560,437821,555250,394220,480861.5,777100
744700,931734.5,1332350,344440,444094.6,555250,400260,487639.9,777100
750590,926549.3,1332350,344290,442632.3,555250,406300,483917,777100
756440,907274.7,1332350,344130,440505.5,555250,412310,466769.2,777100
762370,813451.9,1332350,344030,375720.6,555250,418340,437731.3,777100
766970,757733,1332350,342610,338861.3,555250,424360,418871.7,777100
771700,842452.6,1332350,341230,393050.6,555250,430470,449402,777100
776280,848619.9,1332350,339830,394970.8,555250,436450,453649.1,777100
780950,848266.4,1332350,338420,385247.5,555250,442530,463018.9,777100
783210,864098.5,1332350,334630,392424.2,555250,448580,471674.3,777100
785380,847224.4,1332350,330830,389527.7,555250,454550,457696.7,777100
787540,844426.9,1332350,327030,375146.1,555250,460510,469280.8,777100
789790,790474.6,1332350,323250,341100.8,555250,466540,449373.8,777100
778700,809326.7,1332350,313260,355900,555250,465440,453426.7,777100
767630,826741.4,1332350,303290,365519,555250,464340,461222.4,777100
756530,868172.7,1332350,293290,384297.4,555250,463240,483875.3,777100
745450,863493.6,1332350,283340,382399.6,555250,462110,481094,777100
733340,887594.1,1332350,272900,383588,555250,460440,504006.1,777100
721290,846663.8,1332350,262450,354730.5,555250,458840,491933.3,777100
709260,792935,1332350,252010,306807,555250,457250,486128,777100
697180,747295.5,1332350,241570,275797.9,555250,455610,471497.6,777100
687000,702300,1332350,233420,244380.6,555250,453580,457919.4,777100
676920,687329.8,1332350,225260,243412.3,555250,451660,443917.5,777100
666770,728391.3,1332350,217110,271563.9,555250,449660,456827.4,777100
656660,802881.3,1332350,208970,303620,555250,447690,499261.3,777100
661480,755821,1332350,213430,271772.2,555250,448050,484048.8,777100
666280,713100.9,1332350,217830,252295.7,555250,448450,460805.2,777100
671060,733505.3,1332350,222250,273810.9,555250,448810,459694.4,777100
675830,791479,1332350,226690,312153.8,555250,449140,479325.2,777100
681170,844901.8,1332350,232230,340242.2,555250,448940,504659.6,777100
686490,909854.2,1332350,237810,373381.9,555250,448680,536472.3,777100
691860,982413.4,1332350,243370,410338.3,555250,448490,572075.1,777100
697160,1006348.4,1332350,248940,432801.9,555250,448220,573546.5,777100
704600,1009265.8,1332350,256840,440647.3,555250,447760,568618.5,777100
711960,1009062.9,1332350,264730,438964.1,555250,447230,570098.8,777100
719300,989018.1,1332350,272590,423740.5,555250,446710,565277.6,777100
726720,942209.9,1332350,280490,408093.3,555250,446230,534116.6,777100
732790,924198.6,1332350,292440,410995.9,555250,440350,513202.7,777100
738930,907109.4,1332350,304370,416228.8,555250,434560,490880.6,777100
745010,889575.7,1332350,316320,424628.9,555250,428690,464946.8,777100
751130,860735.5,1332350,328280,405731.4,555250,422850,455004.1,777100
754370,865090.8,1332350,336290,398405.7,555250,418080,466685.1,777100
757730,866478.2,1332350,344310,407129.2,555250,413420,459349,777100
761040,832675.3,1332350,352320,405273.3,555250,408720,427402,777100
764360,840247.7,1332350,360340,412689.2,555250,404020,427558.5,777100
767190,884091.2,1332350,368530,434912.9,555250,398660,449178.3,777100
770130,900769.7,1332350,376690,440538.8,555250,393440,460230.9,777100
773020,872952.1,1332350,384890,419913.9,555250,388130,453038.2,777100
775910,855301.3,1332350,393060,409232.6,555250,382850,446068.7,777100
770490,823446.8,1332350,391980,403839.8,555250,378510,419607,777100
765100,798649.6,1332350,390870,400031,555250,374230,398618.6,777100
759680,769115.4,1332350,389750,396161.8,555250,369930,372953.6,777100
754270,759111,1332350,388650,396578.1,555250,365620,362532.9,777100
747500,758134.3,1332350,385890,401301,555250,361610,356833.3,777100
740680,760988.7,1332350,383090,401750.6,555250,357590,359238.1,777100
733840,727217.4,1332350,380320,381241.2,555250,353520,345976.2,777100
727060,695442.9,1332350,377560,364180.3,555250,349500,331262.6,777100
719580,736240,1332350,373990,390162.8,555250,345590,346077.2,777100
712180,725524.2,1332350,370460,387347.6,555250,341720,338176.6,777100
704560,632193.3,1332350,366880,331203.4,555250,337680,300989.9,777100
697100,612836.4,1332350,363320,324344.9,555250,333780,288491.5,777100
695950,527057.8,1332350,361280,272063.3,555250,334670,254994.5,777100
694690,586617.9,1332350,359210,300212.2,555250,335480,286405.7,777100
693510,556638.7,1332350,357160,277412.7,555250,336350,279226,777100
788080,597011,1332350,396750,294086,555250,391330,302925,777100
781110,697985.4,1332350,393710,350652.3,555250,387400,347333.1,777100
774020,680067.4,1332350,390600,341210.4,555250,383420,338857,777100
766940,629468.7,1332350,387530,312611.2,555250,379410,316857.5,777100
759930,599094.3,1332350,384470,300667.8,555250,375460,298426.5,777100
751870,555075,1332350,379670,281607.7,555250,372200,273467.3,777100
743610,505447.1,1332350,374860,260619.2,555250,368750,244827.9,777100
735550,481227.4,1332350,370070,249023.8,555250,365480,232203.6,777100
727420,467655.7,1332350,365250,243013.9,555250,362170,224641.8,777100
707360,400622.3,1332350,356820,193810.9,555250,350540,206811.4,777100
687270,465709.6,1332350,348380,223293.5,555250,338890,242416.1,777100
667230,587505,1332350,339930,299908.2,555250,327300,287596.8,777100
647170,609903.3,1332350,331510,322035.1,555250,315660,287868.2,777100
627230,618411.7,1332350,322520,325080.4,555250,304710,293331.3,777100
607310,629656.3,1332350,313570,328741.3,555250,293740,300915,777100
587350,606839,1332350,304600,318435.8,555250,282750,288403.2,777100
567420,558986.1,1332350,295600,294892,555250,271820,264094.1,777100
546290,509144.7,1332350,285670,265641.6,555250,260620,243503.1,777100
525150,436493.4,1332350,275660,225228.3,555250,249490,211265.1,777100
503970,427902.6,1332350,265700,220903.9,555250,238270,206998.7,777100
482850,405966.2,1332350,255710,213205.9,555250,227140,192760.3,777100
470790,409194.4,1332350,248670,217925.9,555250,222120,191268.5,777100
458750,396755.3,1332350,241600,218949.1,555250,217150,177806.2,777100
446590,391564.4,1332350,234560,221423.7,555250,212030,170140.7,777100
434560,375163.2,1332350,227500,211322.4,555250,207060,163840.8,777100
422930,342643.7,1332350,220260,191013.6,555250,202670,151630.1,777100
411240,353782.4,1332350,213020,196588,555250,198220,157194.4,777100
399590,329358.7,1332350,205770,182927.7,555250,193820,146431,777100
387940,305829.4,1332350,198530,165672.7,555250,189410,140156.7,777100
377120,317101.4,1332350,192680,171585.9,555250,184440,145515.5,777100
366250,297462.8,1332350,186820,159366.5,555250,179430,138096.3,777100
355440,269735,1332350,180960,142145.3,555250,174480,127589.7,777100
344620,247344.3,1332350,175100,125955.2,555250,169520,121389.1,777100
348700,243817.4,1332350,175560,121598.6,555250,173140,122218.8,777100
352850,226712.2,1332350,176060,107887.7,555250,176790,118824.5,777100
356940,265141.7,1332350,176540,127588.7,555250,180400,137553,777100
361110,294151.9,1332350,177040,141540,555250,184070,152611.9,777100
364220,328854.2,1332350,176710,163064.3,555250,187510,165789.9,777100
367490,342601.1,1332350,176390,169473.6,555250,191100,173127.5,777100
370690,350712.7,1332350,176070,170426.1,555250,194620,180286.6,777100
373920,335988.9,1332350,175760,162110.2,555250,198160,173878.7,777100
377600,341751.3,1332350,175970,163427.2,555250,201630,178324.1,777100
381340,121114.2,1332350,176210,72602,555250,205130,48512.2,777100
385040,127457,1332350,176410,72288.2,555250,208630,55168.8,777100
388680,292769.7,1332350,176620,127640.4,555250,212060,165129.3,777100
389270,319447.3,1332350,178720,147991.8,555250,210550,171455.5,777100
389830,295724.7,1332350,180800,132773.1,555250,209030,162951.6,777100
390390,271032.9,1332350,182860,125067.8,555250,207530,145965.1,777100
391000,303648.6,1332350,184950,144739.5,555250,206050,158909.1,777100
389930,268390.7,1332350,186600,123803.3,555250,203330,144587.4,777100
388940,220200.8,1332350,188230,103007.9,555250,200710,117192.9,777100
387920,246117.4,1332350,189880,115032.7,555250,198040,131084.7,777100
386940,306728.3,1332350,191510,149371.9,555250,195430,157356.4,777100
385490,332435,1332350,192130,155274.1,555250,193360,177160.9,777100
383940,305573.9,1332350,192740,138142.2,555250,191200,167431.7,777100
382400,300578.3,1332350,193300,145029.7,555250,189100,155548.6,777100
380880,311836.9,1332350,193910,149829.1,555250,186970,162007.8,777100
375360,369213.8,1332350,195470,182550.4,555250,179890,186663.4,777100
369770,432153.1,1332350,197040,224740,555250,172730,207413.1,777100
364170,393943.6,1332350,198590,205992.9,555250,165580,187950.7,777100
358640,353266.6,1332350,200170,184210.6,555250,158470,169056,777100
348740,325060.8,1332350,197290,169977.5,555250,151450,155083.3,777100
338860,337002.4,1332350,194430,176515,555250,144430,160487.4,777100
328960,392309.8,1332350,191560,218219.8,555250,137400,174090,777100
319040,281439.8,1332350,188700,152289.4,555250,130340,129150.4,777100
310380,155524.4,1332350,187170,80141.4,555250,123210,75383,777100
301740,140113.9,1332350,185630,72919.6,555250,116110,67194.3,777100
293060,109220.1,1332350,184050,61593.7,555250,109010,47626.4,777100
284390,82312.6,1332350,182530,42623.6,555250,101860,39689,777100
269010,73610.8,1332350,171530,30476.8,555250,97480,43134,777100
253690,75604.7,1332350,160550,32242.3,555250,93140,43362.4,777100
238290,101394.1,1332350,149550,47061.7,555250,88740,54332.4,777100
222900,103428.5,1332350,138550,49208.3,555250,84350,54220.2,777100
209090,105322,1332350,129760,53005,555250,79330,52317,777100
195340,108687.5,1332350,121000,53782.4,555250,74340,54905.1,777100
181560,118845.2,1332350,112210,58605.1,555250,69350,60240.1,777100
167770,141038.3,1332350,103420,73824,555250,64350,67214.3,777100
154720,154656.2,1332350,95330,83386.4,555250,59390,71269.8,777100
141650,154894.9,1332350,87240,82205.2,555250,54410,72689.7,777100
128620,123789.5,1332350,79170,65144.7,555250,49450,58644.8,777100
115570,138656,1332350,71080,71086.4,555250,44490,67569.6,777100
117930,167358.9,1332350,70750,86006.7,555250,47180,81352.2,777100
120300,213669.2,1332350,70400,115903.2,555250,49900,97766,777100
122660,272558.3,1332350,70050,152352.5,555250,52610,120205.8,777100
124940,343880.9,1332350,69730,192408.9,555250,55210,151472,777100
128010,368505.9,1332350,70350,197390.8,555250,57660,171115.1,777100
131080,405795.6,1332350,71020,212184.4,555250,60060,193611.2,777100
134130,464820.9,1332350,71630,239900.1,555250,62500,224920.8,777100
137140,527559.4,1332350,72280,272123.4,555250,64860,255436,777100
144830,591631.6,1332350,76440,303306.7,555250,68390,288324.9,777100
152500,657082.9,1332350,80580,336364.8,555250,71920,320718.1,777100
160230,705054.5,1332350,84750,357695.9,555250,75480,347358.6,777100
167880,748406.4,1332350,88890,380021.8,555250,78990,368384.6,777100
187340,702356,1332350,98710,350905.7,555250,88630,351450.3,777100
206720,686480.2,1332350,108550,339695.8,555250,98170,346784.4,777100
226150,687093.6,1332350,118400,337187.7,555250,107750,349905.9,777100
474040,712774.2,1332350,253160,364567.3,555250,220880,348206.9,777100
498140,747228.2,1332350,263970,384350.3,555250,234170,362877.9,777100
522240,787117.4,1332350,274760,408458.4,555250,247480,378659,777100
546210,836908.2,1332350,285550,441723.3,555250,260660,395184.9,777100
570290,832046.4,1332350,296330,445621.1,555250,273960,386425.3,777100
595960,820230.4,1332350,308490,436428.6,555250,287470,383801.8,777100
621690,827471.3,1332350,320640,431359.8,555250,301050,396111.5,777100
647380,816627.3,1332350,332800,426696.4,555250,314580,389930.9,777100
673110,824797.1,1332350,344980,424022.2,555250,328130,400774.9,777100
681090,824264.8,1332350,350890,419668.2,555250,330200,404596.6,777100
689070,831603.1,1332350,356830,421108.8,555250,332240,410494.3,777100
697160,827150.3,1332350,362750,422908.5,555250,334410,404241.8,777100
705240,794890.4,1332350,368700,410470.8,555250,336540,384419.6,777100
710790,789755.9,1332350,372800,405664.5,555250,337990,384091.4,777100
716380,750425.6,1332350,376930,389030.6,555250,339450,361395,777100
721990,726197.9,1332350,381050,381900.7,555250,340940,344297.2,777100
727510,655497.5,1332350,385160,345412.9,555250,342350,310084.6,777100
728160,657097,1332350,386750,348669.4,555250,341410,308427.6,777100
728700,690527.8,1332350,388350,373184.5,555250,340350,317343.3,777100
729310,717338.1,1332350,389930,389852.4,555250,339380,327485.7,777100
729800,670421.7,1332350,391520,360925.1,555250,338280,309496.6,777100
719410,708065.2,1332350,387360,378165.4,555250,332050,329899.8,777100
708890,729111.9,1332350,383150,384646.6,555250,325740,344465.3,777100
698340,758683.7,1332350,378980,399300.5,555250,319360,359383.2,777100
687950,815788.5,1332350,374810,428078.9,555250,313140,387709.6,777100
680840,797024.8,1332350,372130,423007.7,555250,308710,374017.1,777100
673710,763122.9,1332350,369450,411585.2,555250,304260,351537.7,777100
666680,743196,1332350,366750,411321.1,555250,299930,331874.9,777100
659580,734209.2,1332350,364070,412643,555250,295510,321566.2,777100
652060,739984.5,1332350,360900,418156.1,555250,291160,321828.4,777100
644600,739630.6,1332350,357770,420232.5,555250,286830,319398.1,777100
637010,708972.8,1332350,354630,407802.6,555250,282380,301170.2,777100
629530,679369.8,1332350,351470,399456.2,555250,278060,279913.6,777100
630790,652681.1,1332350,355160,390686.8,555250,275630,261994.3,777100
632170,674058.6,1332350,358820,401227.4,555250,273350,272831.2,777100
633470,663259.2,1332350,362530,402429.6,555250,270940,260829.6,777100
634780,635489.3,1332350,366210,391715.4,555250,268570,243773.9,777100
637650,640693.3,1332350,370420,392234.7,555250,267230,248458.6,777100
640490,639049.7,1332350,374580,388642.7,555250,265910,250407,777100
643330,608690.9,1332350,378800,376205.1,555250,264530,232485.8,777100
646170,628988.7,1332350,382980,389528.5,555250,263190,239460.2,777100
646480,601299.1,1332350,385870,383283.4,555250,260610,218015.7,777100
646800,614718.5,1332350,388730,387472.3,555250,258070,227246.2,777100
647000,625035.1,1332350,391610,389746.2,555250,255390,235288.9,777100
647260,639070.9,1332350,394450,395905.7,555250,252810,243165.2,777100
648590,626754,1332350,393610,387721.5,555250,254980,239032.5,777100
649870,608245.1,1332350,392770,374962.9,555250,257100,233282.2,777100
651250,589868.1,1332350,391910,363058.6,555250,259340,226809.5,777100
652610,566679.2,1332350,391050,344373.8,555250,261560,222305.4,777100
655610,557161.7,1332350,390800,336650.1,555250,264810,220511.6,777100
658660,512749.7,1332350,390550,299327.1,555250,268110,213422.6,777100
661720,530705.6,1332350,390320,296879.9,555250,271400,233825.7,777100
664770,540517.3,1332350,390070,301697.6,555250,274700,238819.7,777100
666610,487202.3,1332350,389840,265120.3,555250,276770,222082,777100
668400,454329.7,1332350,389640,247290.8,555250,278760,207038.9,777100
670190,517678.2,1332350,389390,287742.6,555250,280800,229935.6,777100
671990,557980.1,1332350,389160,309915.3,555250,282830,248064.8,777100
664460,597391.2,1332350,386390,327893.9,555250,278070,269497.3,777100
656920,583132.9,1332350,383600,320569.9,555250,273320,262563,777100
649410,545453.4,1332350,380810,300562.2,555250,268600,244891.2,777100
641880,548806.7,1332350,378050,305764.8,555250,263830,243041.9,777100
632780,583270.5,1332350,374440,328790.9,555250,258340,254479.6,777100
623690,591079.3,1332350,370820,336789.5,555250,252870,254289.8,777100
614620,593458.2,1332350,367200,342890.1,555250,247420,250568.1,777100
605600,622239.1,1332350,363610,364925.6,555250,241990,257313.5,777100
595750,637136.5,1332350,359360,379648.7,555250,236390,257487.8,777100
585800,643358.7,1332350,355070,386032.8,555250,230730,257325.9,777100
576010,633698.9,1332350,350800,377673.3,555250,225210,256025.6,777100
566070,584431.5,1332350,346540,355044.3,555250,219530,229387.2,777100
545740,584781.8,1332350,338430,353535.2,555250,207310,231246.6,777100
525470,602192.9,1332350,330360,362604.2,555250,195110,239588.7,777100
505130,599555.1,1332350,322220,366108.2,555250,182910,233446.9,777100
484850,609882.2,1332350,314130,375062.1,555250,170720,234820.1,777100
463290,568023.7,1332350,305340,361926.7,555250,157950,206097,777100
441830,524118.4,1332350,296550,342134.9,555250,145280,181983.5,777100
420320,499220.8,1332350,287750,333296.2,555250,132570,165924.6,777100
398860,515477.7,1332350,278970,348290.2,555250,119890,167187.5,777100
376710,525035.4,1332350,268810,356057.1,555250,107900,168978.3,777100
354510,524102,1332350,258670,356535.2,555250,95840,167566.8,777100
332360,519208.2,1332350,248520,356606.4,555250,83840,162601.8,777100
310170,408245.1,1332350,238400,295488.8,555250,71770,112756.3,777100
295750,307682.1,1332350,227920,235422.1,555250,67830,72260,777100
281410,270061.4,1332350,217430,212370.2,555250,63980,57691.2,777100
266990,240051,1332350,206940,194107.7,555250,60050,45943.3,777100
252620,220631.5,1332350,196450,180485,555250,56170,40146.5,777100
238610,172875.7,1332350,186010,148501.7,555250,52600,24374,777100
224590,154441.8,1332350,175540,134320.2,555250,49050,20121.6,777100
210570,147866.8,1332350,165100,125810.8,555250,45470,22056,777100
196550,117873.5,1332350,154630,104092.1,555250,41920,13781.4,777100
183540,102833.1,1332350,144550,89202.1,555250,38990,13631,777100
170520,104930,1332350,134480,87314.7,555250,36040,17615.3,777100
157470,105626.5,1332350,124430,86474.2,555250,33040,19152.3,777100
144430,94602,1332350,114340,77380,555250,30090,17222,777100
134810,69893.6,1332350,106120,55338.5,555250,28690,14555.1,777100
125200,60433.3,1332350,97840,47339.7,555250,27360,13093.6,777100
115580,53171.7,1332350,89600,41869.8,555250,25980,11301.9,777100
117450,41130.6,1332350,78250,27475.9,555250,39200,13654.7,777100
108140,42727.2,1332350,70110,25832.7,555250,38030,16894.5,777100
98720,37167.4,1332350,61930,19674.6,555250,36790,17492.8,777100
89260,37610.9,1332350,53750,18026.9,555250,35510,19584,777100
79810,35933,1332350,45590,16444.1,555250,34220,19488.9,777100
71020,29403.3,1332350,38020,11675.2,555250,33000,17728.1,777100
62220,27100.6,1332350,30450,9318,555250,31770,17782.6,777100
53390,28626.1,1332350,22840,9613.8,555250,30550,19012.3,777100
44550,23784.9,1332350,15280,4778.7,555250,29270,19006.2,777100
43090,21292.3,1332350,14520,2732,555250,28570,18560.3,777100
41710,20394.8,1332350,13780,2462.4,555250,27930,17932.4,777100
40240,19885.9,1332350,13040,1632.4,555250,27200,18253.5,777100
38730,19715.2,1332350,12280,1695.1,555250,26450,18020.1,777100
37210,23421.7,1332350,11460,4535.4,555250,25750,18886.3,777100
35710,19696.7,1332350,10670,2548.9,555250,25040,17147.8,777100
34200,17854.2,1332350,9850,1205.2,555250,24350,16649,777100
32720,17023.7,1332350,9030,1241.6,555250,23690,15782.1,777100
31210,17657.4,1332350,7970,1935.5,555250,23240,15721.9,777100
29590,18817.6,1332350,6860,2264.4,555250,22730,16553.2,777100
28070,17625,1332350,5810,1109.6,555250,22260,16515.4,777100
26530,17111.2,1332350,4750,480.5,555250,21780,16630.7,777100
25770,17045.4,1332350,4470,710.6,555250,21300,16334.8,777100
25100,20639.4,1332350,4230,2712.2,555250,20870,17927.2,777100
24380,23240.3,1332350,3960,3995.8,555250,20420,19244.5,777100
23650,27600.2,1332350,3720,6262.2,555250,19930,21338,777100
23110,25978.8,1332350,3610,4389.8,555250,19500,21589,777100
22560,26552.3,1332350,3540,4438.6,555250,19020,22113.7,777100
21990,36633.4,1332350,3430,10666.1,555250,18560,25967.3,777100
21490,27485,1332350,3370,5611.5,555250,18120,21873.5,777100
19920,25840.7,1332350,3050,5586.2,555250,16870,20254.5,777100
18300,34195,1332350,2680,10308.9,555250,15620,23886.1,777100
16750,35286.5,1332350,2360,10506.1,555250,14390,24780.4,777100
15250,33524,1332350,2030,8484.6,555250,13220,25039.4,777100
15370,31158.8,1332350,1940,7562.6,555250,13430,23596.2,777100
15560,27786.1,1332350,1860,5292.1,555250,13700,22494,777100
15830,21719.3,1332350,1780,1582.9,555250,14050,20136.4,777100
15950,21852.8,1332350,1670,873.2,555250,14280,20979.6,777100
16750,27859.4,1332350,1700,2648.9,555250,15050,25210.5,777100
17350,29415.7,1332350,1710,2869.9,555250,15640,26545.8,777100
18070,26079.7,1332350,1720,1131.6,555250,16350,24948.1,777100
18730,24585,1332350,1720,789,555250,17010,23796,777100
19900,26652,1332350,1750,826.5,555250,18150,25825.5,777100
21000,28804.8,1332350,1830,851.5,555250,19170,27953.3,777100
22140,28150.7,1332350,1890,749.7,555250,20250,27401,777100
23260,29840.7,1332350,1930,723.6,555250,21330,29117.1,777100
25500,29325.3,1332350,2520,620.9,555250,22980,28704.4,777100
27760,30896.8,1332350,3130,1005.7,555250,24630,29891.1,777100
30010,34975.7,1332350,3750,2645.5,555250,26260,32330.2,777100
32220,56420.6,1332350,4320,19801.7,555250,27900,36618.9,777100
34530,38498.9,1332350,4960,3934,555250,29570,34564.9,777100
36820,45440,1332350,5640,6753.1,555250,31180,38686.9,777100
39100,50121.5,1332350,6300,9333,555250,32800,40788.5,777100
41360,53000.1,1332350,6940,11351,555250,34420,41649.1,777100
43500,61768,1332350,7540,15333.6,555250,35960,46434.4,777100
45620,71574.3,1332350,8150,20017.9,555250,37470,51556.4,777100
47690,77341.5,1332350,8770,25801.2,555250,38920,51540.3,777100
49800,89693.2,1332350,9380,31026.9,555250,40420,58666.3,777100
53350,97646.1,1332350,11070,35487.3,555250,42280,62158.8,777100
56880,104772.8,1332350,12770,38359.8,555250,44110,66413,777100
60530,101599.5,1332350,14470,38142.3,555250,46060,63457.2,777100
63990,97374.2,1332350,16160,35538.3,555250,47830,61835.9,777100
67220,95617.7,1332350,18060,33835.7,555250,49160,61782,777100
70450,84567.6,1332350,19950,29538.9,555250,50500,55028.7,777100
73630,87351.9,1332350,21830,31376.4,555250,51800,55975.5,777100
76850,101363.2,1332350,23730,39111.5,555250,53120,62251.7,777100
79810,114816.4,1332350,25610,46787.1,555250,54200,68029.3,777100
82800,121777.5,1332350,27470,48696.1,555250,55330,73081.4,777100
85790,113705.2,1332350,29350,39930,555250,56440,73775.2,777100
88720,104168.2,1332350,31190,36528.1,555250,57530,67640.1,777100
88990,113334.9,1332350,32240,41358.3,555250,56750,71976.6,777100
89090,120009,1332350,33250,43382.7,555250,55840,76626.3,777100
89330,121394.9,1332350,34320,44380.2,555250,55010,77014.7,777100
89490,137046.4,1332350,35330,54009.8,555250,54160,83036.6,777100
89670,150301.3,1332350,36330,60229.4,555250,53340,90071.9,777100
89820,158690.1,1332350,37310,65184.1,555250,52510,93506,777100
90000,183092.2,1332350,38310,79363,555250,51690,103729.2,777100
90160,215106.1,1332350,39280,97168.6,555250,50880,117937.5,777100
91230,237898.6,1332350,41030,114182,555250,50200,123716.6,777100
92290,258309.1,1332350,42800,127450.4,555250,49490,130858.7,777100
93330,236035.4,1332350,44540,113655.6,555250,48790,122379.8,777100
94450,257668.9,1332350,46320,127378.6,555250,48130,130290.3,777100
95310,296216.3,1332350,47430,154057.6,555250,47880,142158.7,777100
96250,324728.4,1332350,48600,172100.4,555250,47650,152628,777100
97060,338496.1,1332350,49700,182917.4,555250,47360,155578.7,777100
97940,366359,1332350,50870,199481.1,555250,47070,166877.9,777100
98990,410633.3,1332350,52580,227160,555250,46410,183473.3,777100
100030,421848.5,1332350,54320,237756.1,555250,45710,184092.4,777100
101050,390081.9,1332350,56050,219623.7,555250,45000,170458.2,777100
102060,379501.2,1332350,57760,217011.8,555250,44300,162489.4,777100
101020,360121.2,1332350,57580,205858.5,555250,43440,154262.7,777100
100030,394511,1332350,57350,229313.4,555250,42680,165197.6,777100
98980,356933,1332350,57170,209244.7,555250,41810,147688.3,777100
97980,252437.3,1332350,56940,147998.3,555250,41040,104439,777100
99040,174595.8,1332350,57600,102245.6,555250,41440,72350.2,777100
100120,170774.3,1332350,58220,99309.4,555250,41900,71464.9,777100
101170,175966.7,1332350,58850,103172.4,555250,42320,72794.3,777100
144890,133141.3,1332350,98190,90785.8,555250,46700,42355.5,777100
141940,110985.6,1332350,97350,81119.9,555250,44590,29865.7,777100
138970,91621.8,1332350,96500,70230.4,555250,42470,21391.4,777100
136040,77849.8,1332350,95640,62479.2,555250,40400,15370.6,777100
133130,49240.1,1332350,94790,40394.3,555250,38340,8845.8,777100
130300,49683.8,1332350,93800,41264.5,555250,36500,8419.3,777100
127570,36855.9,1332350,92830,29211.2,555250,34740,7644.7,777100
124870,48095.2,1332350,91860,39434.2,555250,33010,8661,777100
122110,37056.9,1332350,90870,29573,555250,31240,7483.9,777100
119070,38150.5,1332350,88970,30663.2,555250,30100,7487.3,777100
116040,37851,1332350,87090,29559.5,555250,28950,8291.5,777100
113020,33467.7,1332350,85200,26049.1,555250,27820,7418.6,777100
109980,44838.9,1332350,83300,38080.3,555250,26680,6758.6,777100
104520,50507.6,1332350,78410,41268.4,555250,26110,9239.2,777100
99030,50543.8,1332350,73510,40721.9,555250,25520,9821.9,777100
93560,46809.4,1332350,68610,36834.8,555250,24950,9974.6,777100
88140,59125.1,1332350,63720,43398.4,555250,24420,15726.7,777100
85220,88886.1,1332350,61280,60176.4,555250,23940,28709.7,777100
82400,75737.6,1332350,58870,51343.3,555250,23530,24394.3,777100
79580,92782.7,1332350,56450,60241.9,555250,23130,32540.8,777100
76810,140414.5,1332350,54050,87314.1,555250,22760,53100.4,777100
79120,152092.1,1332350,55550,95005.9,555250,23570,57086.2,777100
81500,154565.2,1332350,57060,96666.3,555250,24440,57898.9,777100
83770,157907.3,1332350,58550,97679.5,555250,25220,60227.8,777100
86120,136303.4,1332350,60060,84642.7,555250,26060,51660.7,777100
88250,137003.3,1332350,61710,86764.1,555250,26540,50239.2,777100
90290,158406.7,1332350,63360,99297.6,555250,26930,59109.1,777100
92430,161508.3,1332350,65000,102044.7,555250,27430,59463.6,777100
94580,154313.6,1332350,66680,96541.1,555250,27900,57772.5,777100
97130,136924.9,1332350,68950,83602.2,555250,28180,53322.7,777100
99790,175662.6,1332350,71260,105199,555250,28530,70463.6,777100
102430,152193,1332350,73570,93776.1,555250,28860,58416.9,777100
105060,165771.9,1332350,75840,101285.6,555250,29220,64486.3,777100
106480,199085.4,1332350,76270,119231.3,555250,30210,79854.1,777100
107930,212141.9,1332350,76740,125326.5,555250,31190,86815.4,777100
109370,210487.6,1332350,77160,123084.5,555250,32210,87403.1,777100
110830,228098.4,1332350,77620,133601.8,555250,33210,94496.6,777100
111450,230148.6,1332350,77740,133033.6,555250,33710,97115,777100
112080,220820.9,1332350,77860,127232.2,555250,34220,93588.7,777100
112660,229740.9,1332350,77960,134246.5,555250,34700,95494.4,777100
113310,209109.4,1332350,78100,124188.2,555250,35210,84921.2,777100
116210,194082.8,1332350,80400,116608,555250,35810,77474.8,777100
119160,207226.2,1332350,82710,126900.3,555250,36450,80325.9,777100
122060,216386.2,1332350,85020,132133.8,555250,37040,84252.4,777100
124950,178364.4,1332350,87310,112731.9,555250,37640,65632.5,777100
124680,188481.9,1332350,86340,117927.6,555250,38340,70554.3,777100
124400,179992.7,1332350,85360,110911.4,555250,39040,69081.3,777100
124200,155085.5,1332350,84360,97183.4,555250,39840,57902.1,777100
123950,148024,1332350,83410,92624.5,555250,40540,55399.5,777100
124530,174327.1,1332350,83590,108084.1,555250,40940,66243,777100
125120,213898.7,1332350,83780,133807.9,555250,41340,80090.8,777100
125660,218802.8,1332350,83970,138491.6,555250,41690,80311.2,777100
126300,219632.1,1332350,84160,138789.6,555250,42140,80842.5,777100
126700,202002,1332350,83870,128676.4,555250,42830,73325.6,777100
127190,188425.5,1332350,83570,119947.3,555250,43620,68478.2,777100
127520,177288.3,1332350,83260,112859.9,555250,44260,64428.4,777100
127960,147918.4,1332350,82980,94831.3,555250,44980,53087.1,777100
129790,171605.1,1332350,83890,107957,555250,45900,63648.1,777100
131560,184202.7,1332350,84810,115682.1,555250,46750,68520.6,777100
133400,207728.6,1332350,85710,127028.5,555250,47690,80700.1,777100
135210,226424.2,1332350,86630,136505.6,555250,48580,89918.6,777100
136550,238903.9,1332350,87010,143614.1,555250,49540,95289.8,777100
137830,268516.9,1332350,87350,163122.6,555250,50480,105394.3,777100
139080,284849.6,1332350,87700,172690.5,555250,51380,112159.1,777100
140430,288849.6,1332350,88070,174172.2,555250,52360,114677.4,777100
142660,291460.2,1332350,89220,174701.6,555250,53440,116758.6,777100
144840,298055.1,1332350,90320,178308.5,555250,54520,119746.6,777100
147140,311736.2,1332350,91470,186447.7,555250,55670,125288.5,777100
149290,306480.6,1332350,92580,183453.3,555250,56710,123027.3,777100
150620,267465,1332350,93600,158898.8,555250,57020,108566.2,777100
151740,272789.8,1332350,94550,161402.7,555250,57190,111387.1,777100
152990,270288.1,1332350,95560,160193.6,555250,57430,110094.5,777100
154210,280734,1332350,96560,161620.2,555250,57650,119113.8,777100
155900,289770.7,1332350,97560,166301.8,555250,58340,123468.9,777100
157560,302521.9,1332350,98600,177197.2,555250,58960,125324.7,777100
159190,311568.8,1332350,99600,180611.5,555250,59590,130957.3,777100
160980,307181,1332350,100630,180516.3,555250,60350,126664.7,777100
163770,296936.5,1332350,102260,176805.1,555250,61510,120131.4,777100
166730,307265.5,1332350,103930,184065.1,555250,62800,123200.4,777100
169560,300549.4,1332350,105580,180822.5,555250,63980,119726.9,777100
172460,275466.2,1332350,107210,168824.6,555250,65250,106641.6,777100
173500,247593.8,1332350,108050,155730,555250,65450,91863.8,777100
174520,272089,1332350,108880,169697.5,555250,65640,102391.5,777100
175530,258044,1332350,109710,163894.3,555250,65820,94149.7,777100
176490,243878.5,1332350,110520,158499.5,555250,65970,85379,777100
177540,222387.5,1332350,112000,146763.8,555250,65540,75623.7,777100
178670,185569.5,1332350,113450,125961.2,555250,65220,59608.3,777100
179740,163173.9,1332350,114920,114727.4,555250,64820,48446.5,777100
180810,121397.5,1332350,116380,89633.7,555250,64430,31763.8,777100
180470,127158.4,1332350,115950,93302.7,555250,64520,33855.7,777100
180170,129443.4,1332350,115480,94893,555250,64690,34550.4,777100
179850,125967.1,1332350,115050,90685.3,555250,64800,35281.8,777100
179530,97765.8,1332350,114590,73507.5,555250,64940,24258.3,777100
177330,93380.4,1332350,114380,71773.3,555250,62950,21607.1,777100
175190,72322.4,1332350,114150,56837.6,555250,61040,15484.8,777100
172990,65477.1,1332350,113900,52524.1,555250,59090,12953,777100
173800,56239.8,1332350,122540,45909.5,555250,51260,10330.3,777100
169360,51462.7,1332350,118640,40947.2,555250,50720,10515.5,777100
164890,49963.5,1332350,114690,38229.5,555250,50200,11734,777100
160500,58666.4,1332350,110780,44727.5,555250,49720,13938.9,777100
156070,47995.7,1332350,106820,35246.6,555250,49250,12749.1,777100
152470,57235.9,1332350,103310,42501.9,555250,49160,14734,777100
148740,72951.2,1332350,99770,51880,555250,48970,21071.2,777100
145150,86570.3,1332350,96260,60177.1,555250,48890,26393.2,777100
141440,90071,1332350,92720,61118.8,555250,48720,28952.2,777100
143450,98795.3,1332350,94050,64467.8,555250,49400,34327.5,777100
145460,108652.4,1332350,95370,71888.9,555250,50090,36763.5,777100
147470,115881.3,1332350,96690,78282,555250,50780,37599.3,777100
149380,126416.2,1332350,98010,85489.1,555250,51370,40927.1,777100
151390,117520.9,1332350,99120,79824.2,555250,52270,37696.7,777100
153370,110587.9,1332350,100220,75973.1,555250,53150,34614.8,777100
155360,114137.7,1332350,101330,77973.2,555250,54030,36164.5,777100
157340,96333.2,1332350,102410,67509.2,555250,54930,28824,777100
160620,83026.8,1332350,104560,59906,555250,56060,23120.8,777100
163870,80257.2,1332350,106700,58689.2,555250,57170,21568,777100
167120,62264.9,1332350,108790,45582.9,555250,58330,16682,777100
170410,53085.4,1332350,110970,38561.9,555250,59440,14523.5,777100
171470,57760.8,1332350,111040,41828.8,555250,60430,15932,777100
172590,58212.8,1332350,111140,42257.7,555250,61450,15955.1,777100
173680,55717.7,1332350,111240,40494.6,555250,62440,15223.1,777100
174750,54635.2,1332350,111310,39789.6,555250,63440,14845.6,777100
176780,47761.2,1332350,112750,34318.7,555250,64030,13442.5,777100
178880,45165.3,1332350,114150,32234.6,555250,64730,12930.7,777100
180930,43400.6,1332350,115590,31066.8,555250,65340,12333.8,777100
183130,39361.3,1332350,117020,27735.9,555250,66110,11625.4,777100
184410,41587.6,1332350,118070,29380,555250,66340,12207.6,777100
185740,74419.2,1332350,119140,55233.6,555250,66600,19185.6,777100
187080,88133.6,1332350,120200,65769.3,555250,66880,22364.3,777100
188370,85103.2,1332350,121270,63119.3,555250,67100,21983.9,777100
184760,89523.3,1332350,119960,66726.4,555250,64800,22796.9,777100
181200,100173.8,1332350,118640,74874.2,555250,62560,25299.6,777100
177650,96519.9,1332350,117320,72735.2,555250,60330,23784.7,777100
174050,90398.8,1332350,115980,69484.4,555250,58070,20914.4,777100
169990,84141,1332350,114080,66057.3,555250,55910,18083.7,777100
166010,86285.1,1332350,112200,67291.8,555250,53810,18993.3,777100
161970,85618.7,1332350,110300,67164.8,555250,51670,18453.9,777100
157930,76334.9,1332350,108430,60404.1,555250,49500,15930.8,777100
153730,86842.6,1332350,105610,68339.7,555250,48120,18502.9,777100
149550,73059.6,1332350,102810,58390.8,555250,46740,14668.8,777100
145380,54484.6,1332350,100020,43357,555250,45360,11127.6,777100
141180,46095.6,1332350,97240,36007.2,555250,43940,10088.4,777100
137800,50720.1,1332350,95780,40631.2,555250,42020,10088.9,777100
134460,51905.9,1332350,94360,42126.9,555250,40100,9779,777100
131180,46346.4,1332350,92950,38420.8,555250,38230,7925.6,777100
127830,37581,1332350,91530,31578.8,555250,36300,6002.2,777100
122000,36416.1,1332350,87750,31141.8,555250,34250,5274.3,777100
116110,33978.9,1332350,83960,29851.3,555250,32150,4127.6,777100
110230,24730.6,1332350,80190,21394.2,555250,30040,3336.4,777100
104350,21701.6,1332350,76420,18551.8,555250,27930,3149.8,777100
98520,21508.1,1332350,72510,19153.9,555250,26010,2354.2,777100
92660,18944.5,1332350,68580,16805.1,555250,24080,2139.4,777100
86850,15010.3,1332350,64690,12775.4,555250,22160,2234.9,777100
81000,8411,1332350,60770,6528.2,555250,20230,1882.8,777100
75760,12294.3,1332350,55680,10360.4,555250,20080,1933.9,777100
70480,16503.2,1332350,50580,14265.5,555250,19900,2237.7,777100
65180,16963.3,1332350,45500,13832,555250,19680,3131.3,777100
59880,12697.1,1332350,40400,9006,555250,19480,3691.1,777100
55670,6171.9,1332350,36640,2612.3,555250,19030,3559.6,777100
51480,7220.9,1332350,32890,2929,555250,18590,4291.9,777100
47260,8093.7,1332350,29150,2864.1,555250,18110,5229.6,777100
43060,6127.7,1332350,25380,1115.9,555250,17680,5011.8,777100
39730,7991.4,1332350,21990,785.6,555250,17740,7205.8,777100
36290,8421.8,1332350,18550,885.9,555250,17740,7535.9,777100
32890,8914.7,1332350,15140,1096.2,555250,17750,7818.5,777100
29510,10618.6,1332350,11720,1139.8,555250,17790,9478.8,777100
28410,16373.3,1332350,11320,2024.3,555250,17090,14349,777100
27400,17403.1,1332350,10940,2347.3,555250,16460,15055.8,777100
26320,15795.9,1332350,10540,2067.8,555250,15780,13728.1,777100
25230,16994.6,1332350,10130,2513.4,555250,15100,14481.2,777100
23190,19681.1,1332350,9130,2557.1,555250,14060,17124,777100
21340,26750.3,1332350,8160,3889,555250,13180,22861.3,777100
19360,34775.2,1332350,7150,5141.1,555250,12210,29634.1,777100
17370,43416.9,1332350,6160,8357.8,555250,11210,35059.1,777100
15560,53761.2,1332350,5250,12485.8,555250,10310,41275.4,777100
13750,52794.6,1332350,4350,11405,555250,9400,41389.6,777100
11950,46887.4,1332350,3450,8125.1,555250,8500,38762.3,777100
10150,39793.1,1332350,2530,6133.9,555250,7620,33659.2,777100
16990,42447.8,1332350,4350,8166.4,555250,12640,34281.4,777100
23890,56889,1332350,6200,12280,555250,17690,44609,777100
30680,70666.7,1332350,8020,15654.4,555250,22660,55012.3,777100
37550,82022.2,1332350,9850,17391.7,555250,27700,64630.5,777100
44990,101871,1332350,11860,20671.9,555250,33130,81199.1,777100
52340,109608.4,1332350,13880,20564,555250,38460,89044.4,777100
59710,122354.1,1332350,15900,21775.6,555250,43810,100578.5,777100
67040,133253.9,1332350,17910,25852.6,555250,49130,107401.3,777100
75450,135421.6,1332350,20190,27091.9,555250,55260,108329.7,777100
83950,144169.8,1332350,22470,30689.4,555250,61480,113480.4,777100
92420,158192.4,1332350,24750,30933.4,555250,67670,127259,777100
100820,187408.6,1332350,27050,37661.4,555250,73770,149747.2,777100
120710,197119.8,1332350,36050,38693.9,555250,84660,158425.9,777100
140650,199721.3,1332350,45070,37532.2,555250,95580,162189.1,777100
160540,213413.5,1332350,54090,47647.5,555250,106450,165766,777100
233960,227082.8,1332350,73880,52779.9,555250,160080,174302.9,777100
250550,225942.5,1332350,84090,56149.4,555250,166460,169793.1,777100
267110,206956.8,1332350,94300,51958.2,555250,172810,154998.6,777100
283670,182039,1332350,104510,42392.4,555250,179160,139646.6,777100
300280,173263.5,1332350,114690,40146,555250,185590,133117.5,777100
315200,167230.6,1332350,124780,42428.6,555250,190420,124802,777100
330130,181479.7,1332350,134880,53784.9,555250,195250,127694.8,777100
345090,181080.4,1332350,144970,59122.2,555250,200120,121958.2,777100
360120,166652.4,1332350,155080,55985,555250,205040,110667.4,777100
361790,137989,1332350,158650,44741.8,555250,203140,93247.2,777100
363390,116555.1,1332350,162180,36444.3,555250,201210,80110.8,777100
365030,98072.3,1332350,165740,36416,555250,199290,61656.3,777100
366680,85132,1332350,169280,34534.3,555250,197400,50597.7,777100
364830,94165.7,1332350,169820,39399.3,555250,195010,54766.4,777100
363040,99773.7,1332350,170360,39123.7,555250,192680,60650,777100
361330,94923.7,1332350,170930,38708.2,555250,190400,56215.5,777100
359420,102487.7,1332350,171460,44013.1,555250,187960,58474.6,777100
357190,112612.4,1332350,170720,48785.6,555250,186470,63826.8,777100
355110,105330.5,1332350,170010,46399.4,555250,185100,58931.1,777100
352950,120577.6,1332350,169280,53605.6,555250,183670,66972,777100
350750,136128.7,1332350,168530,59533.4,555250,182220,76595.3,777100
349520,157354.4,1332350,169700,71481.3,555250,179820,85873.1,777100
348330,169820.1,1332350,170830,76516.8,555250,177500,93303.3,777100
347100,181897.5,1332350,171970,85931,555250,175130,95966.5,777100
345820,204033.2,1332350,173080,98190.7,555250,172740,105842.5,777100
346310,213345.4,1332350,176090,98328.3,555250,170220,115017.1,777100
346740,236478.1,1332350,179080,107986.1,555250,167660,128492,777100
347200,238799.6,1332350,182020,106752,555250,165180,132047.6,777100
347640,214455.4,1332350,185030,102120.8,555250,162610,112334.6,777100
347880,222936.2,1332350,187460,117383.7,555250,160420,105552.5,777100
348170,253587.6,1332350,189880,144053.2,555250,158290,109534.4,777100
348440,253802.4,1332350,192330,152815.6,555250,156110,100986.8,777100
348760,241862.2,1332350,194760,150409.8,555250,154000,91452.4,777100
340920,226542.5,1332350,192620,146474.8,555250,148300,80067.7,777100
333150,208031.2,1332350,190500,138651.8,555250,142650,69379.4,777100
325390,173172.5,1332350,188380,117268.7,555250,137010,55903.8,777100
317560,166150.7,1332350,186250,114208.6,555250,131310,51942.1,777100
308670,179361.2,1332350,182960,125097.6,555250,125710,54263.6,777100
299670,176832.5,1332350,179640,125145.9,555250,120030,51686.6,777100
290840,155603,1332350,176360,113062.9,555250,114480,42540.1,777100
281830,141693.3,1332350,173070,105247.8,555250,108760,36445.5,777100
274710,164743,1332350,171260,122991.1,555250,103450,41751.9,777100
267640,162078,1332350,169480,122047.9,555250,98160,40030.1,777100
260580,148183,1332350,167700,112584.5,555250,92880,35598.5,777100
253430,149065.3,1332350,165870,113454.8,555250,87560,35610.5,777100
254900,149283.9,1332350,168710,115089.9,555250,86190,34194,777100
256430,135413.3,1332350,171590,106223.2,555250,84840,29190.1,777100
257850,111499.6,1332350,174410,89928,555250,83440,21571.6,777100
259340,108197.1,1332350,177250,88419,555250,82090,19778.1,777100
260230,120682.1,1332350,179660,98712.2,555250,80570,21969.9,777100
261180,135588.4,1332350,182080,110206.5,555250,79100,25381.9,777100
262150,123491.8,1332350,184530,101041.2,555250,77620,22450.6,777100
263080,127078.4,1332350,186950,103906.8,555250,76130,23171.6,777100
264840,124771.9,1332350,190060,100636.1,555250,74780,24135.8,777100
266600,113676.6,1332350,193180,91253.6,555250,73420,22423,777100
268440,96020.9,1332350,196280,77854.6,555250,72160,18166.3,777100
270150,107224.7,1332350,199420,86617.3,555250,70730,20607.4,777100
271920,104597.2,1332350,201720,85771.6,555250,70200,18825.6,777100
273790,117412.1,1332350,204030,95626,555250,69760,21786.1,777100
275610,151584.2,1332350,206320,119833.7,555250,69290,31750.5,777100
277450,165632.4,1332350,208630,126522,555250,68820,39110.4,777100
279960,171463.7,1332350,211600,128468.6,555250,68360,42995.1,777100
282470,185003.1,1332350,214540,133967.3,555250,67930,51035.8,777100
285010,174705.9,1332350,217490,129310.6,555250,67520,45395.3,777100
287590,165880.5,1332350,220480,120518.9,555250,67110,45361.6,777100
290490,187417.6,1332350,223710,136688.3,555250,66780,50729.3,777100
293360,224224.7,1332350,226970,160760.1,555250,66390,63464.6,777100
296230,233629.5,1332350,230220,166392.1,555250,66010,67237.4,777100
299120,237398.4,1332350,233470,170121.4,555250,65650,67277,777100
304850,241379.9,1332350,235860,169475,555250,68990,71904.9,777100
310540,254881.4,1332350,238240,176503.2,555250,72300,78378.2,777100
316180,249502.6,1332350,240610,171335.8,555250,75570,78166.8,777100
321790,247371.7,1332350,242940,173054.1,555250,78850,74317.6,777100
326560,271356.1,1332350,244100,185523.6,555250,82460,85832.5,777100
331310,278195.8,1332350,245250,189574,555250,86060,88621.8,777100
336030,242851.9,1332350,246410,162112.9,555250,89620,80739,777100
340810,221799.7,1332350,247550,142074.7,555250,93260,79725,777100
339840,207117.7,1332350,243440,127195.5,555250,96400,79922.2,777100
338900,207330.4,1332350,239350,124714.7,555250,99550,82615.7,777100
337970,195774,1332350,235260,117447.6,555250,102710,78326.4,777100
336990,182857.6,1332350,231150,106345.1,555250,105840,76512.5,777100
333720,189970.7,1332350,226170,116034,555250,107550,73936.7,777100
330600,174371,1332350,221190,108564.2,555250,109410,65806.8,777100
327480,133764.9,1332350,216230,78410.6,555250,111250,55354.3,777100
324250,123789.5,1332350,211270,71607.4,555250,112980,52182.1,777100
324370,104160.7,1332350,209400,59359,555250,114970,44801.7,777100
324490,100172.3,1332350,207500,57485,555250,116990,42687.3,777100
324540,107432.9,1332350,205620,63277.9,555250,118920,44155,777100
324660,105500.2,1332350,203750,61055,555250,120910,44445.2,777100
325650,115106.2,1332350,202210,64262.2,555250,123440,50844,777100
326670,117998.1,1332350,200670,63625.8,555250,126000,54372.3,777100
327720,107303.2,1332350,199160,55408.5,555250,128560,51894.7,777100
328730,99030.9,1332350,197640,52359.2,555250,131090,46671.7,777100
323970,106628.2,1332350,193850,58621,555250,130120,48007.2,777100
319240,95605.8,1332350,190080,53840.9,555250,129160,41764.9,777100
314490,83450.5,1332350,186330,43827.4,555250,128160,39623.1,777100
166130,110972.1,1332350,61250,36054.9,555250,104880,74917.2,777100
160550,118362.9,1332350,58820,39697.4,555250,101730,78665.5,777100
154990,120245.3,1332350,56360,43611.4,555250,98630,76633.9,777100
149340,123378.5,1332350,53930,48223.9,555250,95410,75154.6,777100
143760,130309.6,1332350,51490,54197.1,555250,92270,76112.5,777100
138370,103679.2,1332350,49660,41631.3,555250,88710,62047.9,777100
133030,80556.3,1332350,47870,28646.5,555250,85160,51909.8,777100
127660,74180.8,1332350,46060,30363.3,555250,81600,43817.5,777100
122240,81954.3,1332350,44240,35280.2,555250,78000,46674.1,777100
123680,102784.3,1332350,45830,43651.2,555250,77850,59133.1,777100
125300,119797.7,1332350,47450,51800,555250,77850,67997.7,777100
126720,130522.2,1332350,49050,60284,555250,77670,70238.2,777100
128200,155801.7,1332350,50630,73327,555250,77570,82474.7,777100
129820,143711.6,1332350,52020,67735.2,555250,77800,75976.4,777100
131390,120685.4,1332350,53410,54167.5,555250,77980,66517.9,777100
132930,106055.3,1332350,54800,45494.4,555250,78130,60560.9,777100
134560,110664.7,1332350,56170,47093.1,555250,78390,63571.6,777100
135850,111901.8,1332350,57520,47754.4,555250,78330,64147.4,777100
137140,130110.9,1332350,58870,56962.1,555250,78270,73148.8,777100
138460,148180.8,1332350,60220,63247.3,555250,78240,84933.5,777100
139760,149718,1332350,61560,65002.3,555250,78200,84715.7,777100
136120,152504.9,1332350,59390,66272.7,555250,76730,86232.2,777100
132470,162309.2,1332350,57220,74857.9,555250,75250,87451.3,777100
128860,149439.9,1332350,55030,70453.4,555250,73830,78986.5,777100
125210,142290.7,1332350,52870,67676.5,555250,72340,74614.2,777100
122520,135130.8,1332350,51670,65506.6,555250,70850,69624.2,777100
119960,135726.2,1332350,50540,65341.5,555250,69420,70384.7,777100
117290,144402.4,1332350,49340,67344.7,555250,67950,77057.7,777100
114750,141278.7,1332350,48210,70030.5,555250,66540,71248.2,777100
111180,135379,1332350,46570,69120.1,555250,64610,66258.9,777100
107630,117574.9,1332350,44940,59230.1,555250,62690,58344.8,777100
104200,118474.8,1332350,43320,60545.5,555250,60880,57929.3,777100
100670,110989.3,1332350,41680,57540.8,555250,58990,53448.5,777100
101090,103852.7,1332350,41520,51716.3,555250,59570,52136.4,777100
101580,84471.8,1332350,41370,40457.4,555250,60210,44014.4,777100
102110,63498.1,1332350,41240,27145.8,555250,60870,36352.3,777100
102580,60650.1,1332350,41090,25663,555250,61490,34987.1,777100
103140,62499.4,1332350,41600,25671.8,555250,61540,36827.6,777100
103620,74591.4,1332350,42060,33527.3,555250,61560,41064.1,777100
104240,89001.4,1332350,42590,43535.6,555250,61650,45465.8,777100
104850,73427.9,1332350,43070,34620.4,555250,61780,38807.5,777100
106090,51139.6,1332350,44380,22723.9,555250,61710,28415.7,777100
107320,41579.2,1332350,45680,17430.2,555250,61640,24149,777100
108640,34108.5,1332350,47000,12298.8,555250,61640,21809.7,777100
109860,33995.4,1332350,48310,11959.4,555250,61550,22036,777100
112270,33747.3,1332350,47940,11494.2,555250,64330,22253.1,777100
114580,46991.2,1332350,47550,20544.6,555250,67030,26446.6,777100
116840,42212,1332350,47150,16671.5,555250,69690,25540.5,777100
119200,46779.1,1332350,46770,19404.5,555250,72430,27374.6,777100
122440,43927.9,1332350,47260,16512.6,555250,75180,27415.3,777100
125640,48626.3,1332350,47770,19313,555250,77870,29313.3,777100
128910,47143.4,1332350,48270,17282.3,555250,80640,29861.1,777100
132100,55440.1,1332350,48770,22701.9,555250,83330,32738.2,777100
136270,59754.3,1332350,50010,23385.8,555250,86260,36368.5,777100
140520,54831.4,1332350,51310,20675.2,555250,89210,34156.2,777100
144650,60038.5,1332350,52570,23331.8,555250,92080,36706.7,777100
148920,61319.2,1332350,53840,22236.1,555250,95080,39083.1,777100
152250,57518.1,1332350,56090,20057.8,555250,96160,37460.3,777100
155470,62997.7,1332350,58300,22970.6,555250,97170,40027.1,777100
158830,48919.3,1332350,60520,12601.1,555250,98310,36318.2,777100
162060,46382.5,1332350,62750,11050.3,555250,99310,35332.2,777100
164780,52379.2,1332350,64930,15914.9,555250,99850,36464.3,777100
167510,50945.7,1332350,67110,15604.8,555250,100400,35340.9,777100
170230,50427.6,1332350,69280,15003,555250,100950,35424.6,777100
172930,49291.7,1332350,71440,14237.1,555250,101490,35054.6,777100
176270,49947.3,1332350,73920,14664.3,555250,102350,35283,777100
179590,46053.4,1332350,76380,12336.3,555250,103210,33717.1,777100
182950,37121,1332350,78860,7791.2,555250,104090,29329.8,777100
186150,40914.6,1332350,81280,10935,555250,104870,29979.6,777100
185460,35741.3,1332350,83880,10083.4,555250,101580,25657.9,777100
184750,35406,1332350,86470,12529.9,555250,98280,22876.1,777100
184040,31437.5,1332350,89050,12837.2,555250,94990,18600.3,777100
183350,31516.9,1332350,91640,15372.9,555250,91710,16144,777100
183850,29304.7,1332350,95370,16237.4,555250,88480,13067.3,777100
184380,22779.7,1332350,99080,13093.6,555250,85300,9686.1,777100
184860,27658.1,1332350,102760,18966.4,555250,82100,8691.7,777100
185420,43594.4,1332350,106470,33141.9,555250,78950,10452.5,777100
183970,64018.5,1332350,108150,49587.7,555250,75820,14430.8,777100
182460,76899,1332350,109820,60028.6,555250,72640,16870.4,777100
181040,69813.7,1332350,111540,57006.5,555250,69500,12807.2,777100
179630,89554.5,1332350,113230,71450.6,555250,66400,18103.9,777100
180300,103957.2,1332350,114340,81441.2,555250,65960,22516,777100
181060,96192.9,1332350,115480,77688.2,555250,65580,18504.7,777100
181800,76281.2,1332350,116580,64859.6,555250,65220,11421.6,777100
182530,85113.2,1332350,117720,71524.5,555250,64810,13588.7,777100
183660,94700.5,1332350,119560,78532.3,555250,64100,16168.2,777100
184770,70848.8,1332350,121400,61623.5,555250,63370,9225.3,777100
185920,61317.4,1332350,123240,53649.3,555250,62680,7668.1,777100
187010,67978.2,1332350,125080,58957,555250,61930,9021.2,777100
189600,69659.6,1332350,127820,60820.1,555250,61780,8839.5,777100
192230,64553.8,1332350,130540,56143.3,555250,61690,8410.5,777100
194900,72603,1332350,133300,63450.5,555250,61600,9152.5,777100
197480,85042.3,1332350,135990,74907.9,555250,61490,10134.4,777100
199120,122301.9,1332350,137230,103564.4,555250,61890,18737.5,777100
200720,151528.9,1332350,138410,122517.8,555250,62310,29011.1,777100
202380,178874.4,1332350,139650,138535.4,555250,62730,40339,777100
106330,181833.9,1332350,89090,135296.7,555250,17240,46537.2,777100
106690,191311.3,1332350,89660,141092.9,555250,17030,50218.4,777100
107030,189657.7,1332350,90230,140439,555250,16800,49218.7,777100
107330,157616,1332350,90800,120467.9,555250,16530,37148.1,777100
107630,160371.9,1332350,91380,121319.9,555250,16250,39052,777100
107310,174398,1332350,91120,128915.2,555250,16190,45482.8,777100
106910,194469,1332350,90860,141226.2,555250,16050,53242.8,777100
106580,201786.6,1332350,90620,146164.9,555250,15960,55621.7,777100
106300,210610.6,1332350,90370,150999.5,555250,15930,59611.1,777100
109450,239942.2,1332350,93270,168775.9,555250,16180,71166.3,777100
112670,238806.8,1332350,96140,168935.6,555250,16530,69871.2,777100
115820,264206.7,1332350,99030,184226.4,555250,16790,79980.3,777100
119090,270185.3,1332350,101930,188153,555250,17160,82032.3,777100
122320,277019.5,1332350,105180,193958.3,555250,17140,83061.2,777100
125570,267591.5,1332350,108480,189596.9,555250,17090,77994.6,777100
128860,266868.8,1332350,111750,189652.7,555250,17110,77216.1,777100
132070,274764.9,1332350,115030,194378.4,555250,17040,80386.5,777100
135560,294741,1332350,118660,210094.5,555250,16900,84646.5,777100
138990,308026.3,1332350,122290,219216.5,555250,16700,88809.8,777100
142520,315068.4,1332350,125920,225417.8,555250,16600,89650.6,777100
146010,363544.5,1332350,129560,255927.2,555250,16450,107617.3,777100
152820,407616.6,1332350,135230,283385.9,555250,17590,124230.7,777100
159640,442836.2,1332350,140870,304886.4,555250,18770,137949.8,777100
166480,485901.3,1332350,146530,331404.1,555250,19950,154497.2,777100
173290,523120.9,1332350,152180,355460.7,555250,21110,167660.2,777100
181140,545127.1,1332350,158610,370614.1,555250,22530,174513,777100
188930,565439.2,1332350,165000,384371.3,555250,23930,181067.9,777100
196750,542695.9,1332350,171390,372633.9,555250,25360,170062,777100
204540,533516.1,1332350,177780,368473.2,555250,26760,165042.9,777100
210590,545129.2,1332350,182560,375892.6,555250,28030,169236.6,777100
216650,522193.4,1332350,187340,361870.2,555250,29310,160323.2,777100
222740,526474.4,1332350,192140,367129.4,555250,30600,159345,777100
228810,530007,1332350,196910,370301.7,555250,31900,159705.3,777100
232670,543684.6,1332350,200370,379256.3,555250,32300,164428.3,777100
236480,552129.9,1332350,203800,386259.2,555250,32680,165870.7,777100
240310,558785.5,1332350,207240,389943.1,555250,33070,168842.4,777100
244090,548427.1,1332350,210670,384334,555250,33420,164093.1,777100
245710,557268.5,1332350,211910,388640.9,555250,33800,168627.6,777100
247260,555951.3,1332350,213100,389760.3,555250,34160,166191,777100
248800,560133.6,1332350,214350,394031,555250,34450,166102.6,777100
250410,569228,1332350,215580,398129.9,555250,34830,171098.1,777100
250750,584990.8,1332350,215800,406067.9,555250,34950,178922.9,777100
251160,589917.1,1332350,216070,411722.7,555250,35090,178194.4,777100
251530,586184.5,1332350,216320,406716,555250,35210,179468.5,777100
251860,574152.4,1332350,216550,396624.4,555250,35310,177528,777100
254560,543378,1332350,217920,378556.4,555250,36640,164821.6,777100
257310,516668.1,1332350,219310,359230.8,555250,38000,157437.3,777100
260090,486212.4,1332350,220690,338613.2,555250,39400,147599.2,777100
262800,472023.2,1332350,222080,329191.8,555250,40720,142831.4,777100
265630,438111.7,1332350,223190,311069,555250,42440,127042.7,777100
268400,427785.4,1332350,224300,307275.9,555250,44100,120509.5,777100
271300,430016.7,1332350,225460,308231.1,555250,45840,121785.6,777100
274080,429697.2,1332350,226560,309392.9,555250,47520,120304.3,777100
276700,460474.9,1332350,227730,326421.2,555250,48970,134053.7,777100
279280,508379.4,1332350,228880,355079.9,555250,50400,153299.5,777100
281850,536066.1,1332350,230040,368720.5,555250,51810,167345.6,777100
284460,569350,1332350,231210,386984.2,555250,53250,182365.8,777100
294860,571165.7,1332350,236270,385247.1,555250,58590,185918.6,777100
305310,565479.3,1332350,241300,378243.9,555250,64010,187235.4,777100
315700,587547.9,1332350,246350,389719,555250,69350,197828.9,777100
326050,618570.6,1332350,251350,407121.2,555250,74700,211449.4,777100
337420,627973.9,1332350,257110,413779.3,555250,80310,214194.6,777100
348670,633839.8,1332350,262840,409311.4,555250,85830,224528.4,777100
359920,643542.9,1332350,268540,409207.2,555250,91380,234335.7,777100
371260,611361.4,1332350,274260,391292.6,555250,97000,220068.8,777100
381360,618587,1332350,279190,397534.9,555250,102170,221052.1,777100
391490,641338.9,1332350,284130,413762,555250,107360,227576.9,777100
401600,658851.2,1332350,289050,427860.8,555250,112550,230990.4,777100
411710,668708,1332350,294000,430776.6,555250,117710,237931.4,777100
418810,685544.9,1332350,295930,436500.2,555250,122880,249044.7,777100
425890,688123.2,1332350,297840,437148.4,555250,128050,250974.8,777100
433000,685971.8,1332350,299790,435041.3,555250,133210,250930.5,777100
440070,688724.4,1332350,301720,435596.7,555250,138350,253127.7,777100
447640,704373.9,1332350,304150,438100.5,555250,143490,266273.4,777100
455210,700043.5,1332350,306570,438065.9,555250,148640,261977.6,777100
462760,716832.3,1332350,309000,442457.2,555250,153760,274375.1,777100
470350,719058.8,1332350,311450,442996.3,555250,158900,276062.5,777100
477640,735095.7,1332350,314010,446192.8,555250,163630,288902.9,777100
484930,735509.8,1332350,316590,438869.8,555250,168340,296640,777100
492290,722191.7,1332350,319190,435027,555250,173100,287164.7,777100
499630,723954.7,1332350,321770,429880.8,555250,177860,294073.9,777100
498130,746075.3,1332350,318550,438264.2,555250,179580,307811.1,777100
496600,746960.5,1332350,315280,434199.7,555250,181320,312760.8,777100
495160,749640.2,1332350,312070,433008.5,555250,183090,316631.7,777100
493690,747970.7,1332350,308860,426314.8,555250,184830,321655.9,777100
492310,759611.8,1332350,305420,436319.3,555250,186890,323292.5,777100
490970,782802.1,1332350,302010,448237.1,555250,188960,334565,777100
489650,798955.5,1332350,298590,456642.8,555250,191060,342312.7,777100
488290,785420.3,1332350,295150,451202.3,555250,193140,334218,777100
486250,776280.6,1332350,291580,440082,555250,194670,336198.6,777100
484110,780122.5,1332350,288030,440839.5,555250,196080,339283,777100
482020,788231.2,1332350,284400,438872.6,555250,197620,349358.6,777100
479940,749329.5,1332350,280810,417281.5,555250,199130,332048,777100
474900,761215.2,1332350,275920,416148.4,555250,198980,345066.8,777100
469810,758407.3,1332350,271030,414401.6,555250,198780,344005.7,777100
464680,765723.3,1332350,266120,414996.8,555250,198560,350726.5,777100
542810,787664.1,1332350,281420,413762.4,555250,261390,373901.7,777100
542040,795211,1332350,277130,414569.3,555250,264910,380641.7,777100
541250,790026,1332350,272790,409019.6,555250,268460,381006.4,777100
540500,756755.7,1332350,268470,387680.9,555250,272030,369074.8,777100
539760,812625.5,1332350,264180,411160,555250,275580,401465.5,777100
539450,839862.2,1332350,261390,431893.1,555250,278060,407969.1,777100
539180,834854.8,1332350,258620,420597.6,555250,280560,414257.2,777100
538860,819480.3,1332350,255860,408491.9,555250,283000,410988.4,777100
538480,849852,1332350,253060,424502.2,555250,285420,425349.8,777100
540660,830518.1,1332350,254060,412355.6,555250,286600,418162.5,777100
542850,851702.5,1332350,255050,431621.2,555250,287800,420081.3,777100
545060,869624.9,1332350,256060,429230,555250,289000,440394.9,777100
547200,880593.2,1332350,257040,438971.8,555250,290160,441621.4,777100
548670,901484.2,1332350,258060,448765.6,555250,290610,452718.6,777100
550180,915712.3,1332350,259090,457645.6,555250,291090,458066.7,777100
551640,871803.3,1332350,260110,428580.8,555250,291530,443222.5,777100
553140,889019.7,1332350,261130,434937.3,555250,292010,454082.4,777100
557130,903318.6,1332350,264940,446737.5,555250,292190,456581.1,777100
561080,916395.8,1332350,268700,450894.8,555250,292380,465501,777100
565080,862612.8,1332350,272490,434745.3,555250,292590,427867.5,777100
569090,840430.5,1332350,276270,426955.8,555250,292820,413474.7,777100
572200,857632.5,1332350,276380,433770.9,555250,295820,423861.6,777100
575250,858947.3,1332350,276490,443922.6,555250,298760,415024.7,777100
578400,791755.3,1332350,276630,407554.5,555250,301770,384200.8,777100
581430,793797.7,1332350,276740,407004.3,555250,304690,386793.4,777100
585700,790250.8,1332350,277960,403064.2,555250,307740,387186.6,777100
589960,780009.4,1332350,279200,401189.6,555250,310760,378819.8,777100
594300,765354,1332350,280410,398210.3,555250,313890,367143.7,777100
598540,775033.4,1332350,281640,400729.4,555250,316900,374304,777100
605240,782052.1,1332350,285090,410113.5,555250,320150,371938.6,777100
611970,764988.5,1332350,288520,398093.8,555250,323450,366894.7,777100
618600,690547.2,1332350,291960,354446.2,555250,326640,336101,777100
625320,624094.6,1332350,295410,318621.4,555250,329910,305473.2,777100
625420,571536.4,1332350,290700,280778.3,555250,334720,290758.1,777100
625580,559329.4,1332350,285990,272541.6,555250,339590,286787.8,777100
625550,595814.9,1332350,281270,298971.6,555250,344280,296843.3,777100
625660,583036.5,1332350,276530,285811.5,555250,349130,297225,777100
624780,576245.3,1332350,271900,270579.5,555250,352880,305665.8,777100
623890,569358,1332350,267240,270760.7,555250,356650,298597.3,777100
623080,567083.9,1332350,262610,266843.7,555250,360470,300240.2,777100
622100,537254.6,1332350,257920,246166.9,555250,364180,291087.7,777100
620410,460784.1,1332350,252420,192432.3,555250,367990,268351.8,777100
618810,421949.5,1332350,246900,168021.3,555250,371910,253928.2,777100
617060,399534.7,1332350,241370,158881.5,555250,375690,240653.2,777100
615360,399512.5,1332350,235860,157068.8,555250,379500,242443.7,777100
609830,407659.7,1332350,230390,163011.8,555250,379440,244647.9,777100
604460,435354,1332350,224960,168415.7,555250,379500,266938.3,777100
598880,434370,1332350,219510,166461.1,555250,379370,267908.9,777100
593440,423302.5,1332350,214070,160137.4,555250,379370,263165.1,777100
588380,392534.1,1332350,208830,139759.7,555250,379550,252774.4,777100
583440,369049.1,1332350,203570,120515.2,555250,379870,248533.9,777100
578430,351451.3,1332350,198350,112378.3,555250,380080,239073,777100
573440,326264,1332350,193110,99732.3,555250,380330,226531.7,777100
567550,329735.3,1332350,187040,93772.2,555250,380510,235963.1,777100
561630,318784.7,1332350,180980,82972.1,555250,380650,235812.6,777100
555620,294809.7,1332350,174950,70370.2,555250,380670,224439.5,777100
549720,301297.5,1332350,168880,72152.2,555250,380840,229145.3,777100
537340,292852.8,1332350,162380,70390.2,555250,374960,222462.6,777100
524940,291876.8,1332350,155900,66823.6,555250,369040,225053.2,777100
512540,328295,1332350,149410,80890.3,555250,363130,247404.7,777100
500150,325375.3,1332350,142920,79484.5,555250,357230,245890.8,777100
487370,316036.9,1332350,136760,74183.2,555250,350610,241853.7,777100
474540,310618.7,1332350,130570,67941.6,555250,343970,242677.1,777100
461790,300760.7,1332350,124400,60410.2,555250,337390,240350.5,777100
449040,274325.8,1332350,118230,48471.8,555250,330810,225854,777100
436380,262257.1,1332350,112300,44830.2,555250,324080,217426.9,777100
423800,244006,1332350,106400,42053.9,555250,317400,201952.1,777100
411150,243976.3,1332350,100460,46378.8,555250,310690,197597.5,777100
398550,241210.2,1332350,94540,42876.2,555250,304010,198334,777100
377520,229451.2,1332350,88160,40647.2,555250,289360,188804,777100
356390,221656.5,1332350,81790,37139.9,555250,274600,184516.6,777100
335250,210194.8,1332350,75420,34182.2,555250,259830,176012.6,777100
314170,206446.3,1332350,69020,39064.4,555250,245150,167381.9,777100
292830,232972.8,1332350,62940,62395.5,555250,229890,170577.3,777100
271500,276680.8,1332350,56830,93708.9,555250,214670,182971.9,777100
250200,273950.6,1332350,50730,94332,555250,199470,179618.6,777100
228860,252634.1,1332350,44650,88283.4,555250,184210,164350.7,777100
206630,248547.3,1332350,38950,91593.3,555250,167680,156954,777100
184450,265415.4,1332350,33290,107540.2,555250,151160,157875.2,777100
162270,262820.3,1332350,27600,109074.2,555250,134670,153746.1,777100
140130,240382.9,1332350,21920,99513.4,555250,118210,140869.5,777100
130240,228099.4,1332350,20450,95844.5,555250,109790,132254.9,777100
120410,205181.8,1332350,18990,83312.9,555250,101420,121868.9,777100
110490,182378.7,1332350,17520,73948.5,555250,92970,108430.2,777100
100700,190915.4,1332350,16060,82393.8,555250,84640,108521.6,777100
91670,145074,1332350,14730,56156.2,555250,76940,88917.8,777100
82670,100438,1332350,13340,30887.7,555250,69330,69550.3,777100
73640,80762.9,1332350,11960,19634.1,555250,61680,61128.8,777100
64610,75449.5,1332350,10600,18125.5,555250,54010,57324,777100
57940,74930.1,1332350,11390,18838.2,555250,46550,56091.9,777100
51330,79017,1332350,12220,20892.6,555250,39110,58124.4,777100
44650,71468.8,1332350,13040,20378,555250,31610,51090.8,777100
38090,64474.3,1332350,13860,17393.9,555250,24230,47080.4,777100
48590,79235.3,1332350,20860,24722.7,555250,27730,54512.6,777100
59150,78810.6,1332350,27920,23644.6,555250,31230,55166,777100
69690,73208.1,1332350,34950,20346.9,555250,34740,52861.2,777100
50990,95548.3,1332350,15110,20554.2,555250,35880,74994.1,777100
52840,104453.6,1332350,15390,23662.8,555250,37450,80790.8,777100
54670,116790.2,1332350,15690,29862.4,555250,38980,86927.8,777100
56440,135097,1332350,15970,35502.2,555250,40470,99594.8,777100
58230,164936.9,1332350,16240,48788.1,555250,41990,116148.8,777100
64330,211255.8,1332350,20640,74283.1,555250,43690,136972.7,777100
70310,203844.1,1332350,25040,66671.5,555250,45270,137172.6,777100
76240,274410.2,1332350,29420,101695.3,555250,46820,172714.9,777100
82240,318393,1332350,33810,125451.6,555250,48430,192941.4,777100
90190,294317,1332350,35580,111189.1,555250,54610,183127.9,777100
98150,333756.4,1332350,37320,133111.3,555250,60830,200645.1,777100
106170,494038.8,1332350,39130,223423.6,555250,67040,270615.2,777100
114180,574275.9,1332350,40890,268510.4,555250,73290,305765.5,777100
128310,536209.3,1332350,47530,247867.9,555250,80780,288341.4,777100
142590,479041.7,1332350,54210,215762.6,555250,88380,263279.1,777100
156770,386934.9,1332350,60840,159990.4,555250,95930,226944.5,777100
170990,357647.5,1332350,67510,141661.4,555250,103480,215986.1,777100
180250,358995.9,1332350,71820,143925.5,555250,108430,215070.4,777100
189540,337709.3,1332350,76120,133821.7,555250,113420,203887.6,777100
198810,315753.5,1332350,80420,115791.7,555250,118390,199961.8,777100
208060,321827.3,1332350,84710,118460.3,555250,123350,203367,777100
227940,332738.5,1332350,96210,134600.3,555250,131730,198138.2,777100
247730,314229.4,1332350,107690,127148.1,555250,140040,187081.3,777100
267600,227440.6,1332350,119180,80282.2,555250,148420,147158.4,777100
287450,207182.3,1332350,130660,72122.6,555250,156790,135059.7,777100
310760,225480.3,1332350,145690,89593.2,555250,165070,135887.1,777100
334080,259110.3,1332350,160680,113839,555250,173400,145271.3,777100
357410,273448.1,1332350,175700,128203.6,555250,181710,145244.5,777100
380680,259387.1,1332350,190690,121728.9,555250,189990,137658.2,777100
401260,279795.1,1332350,203050,133172.7,555250,198210,146622.4,777100
421910,371553,1332350,215380,195985.2,555250,206530,175567.8,777100
442490,486413.8,1332350,227740,273695.2,555250,214750,212718.6,777100
463150,559841.6,1332350,240060,313726.8,555250,223090,246114.8,777100
471100,665158.7,1332350,246550,374292.5,555250,224550,290866.2,777100
479120,543400.4,1332350,253010,310123.1,555250,226110,233277.3,777100
487070,576106.6,1332350,259460,321725.3,555250,227610,254381.3,777100
495130,516711.1,1332350,265960,278522.6,555250,229170,238188.5,777100
498800,644819.5,1332350,267240,365103.5,555250,231560,279716,777100
502420,534032,1332350,268580,300853.8,555250,233840,233178.2,777100
506100,430923.3,1332350,269880,241756.7,555250,236220,189166.6,777100
509770,513800.9,1332350,271220,289935.2,555250,238550,223865.7,777100
514640,553775.5,1332350,274580,297571.5,555250,240060,256204,777100
519480,554856.2,1332350,277950,281312.9,555250,241530,273543.3,777100
524230,497938.4,1332350,281310,270665.5,555250,242920,227272.9,777100
529070,508233.5,1332350,284690,275192.3,555250,244380,233041.2,777100
535460,510883.7,1332350,286640,276658.2,555250,248820,234225.5,777100
541910,470459.4,1332350,288640,250962.3,555250,253270,219497.1,777100
548280,497200.1,1332350,290630,249260.4,555250,257650,247939.7,777100
554610,565457.4,1332350,292600,292385.3,555250,262010,273072.1,777100
558720,567107.5,1332350,292370,294520.4,555250,266350,272587.1,777100
562820,600223,1332350,292150,325405.5,555250,270670,274817.5,777100
566930,540219.4,1332350,291920,286803.8,555250,275010,253415.6,777100
571010,578941,1332350,291710,302707.8,555250,279300,276233.2,777100
579380,442574.9,1332350,296030,233950.5,555250,283350,208624.4,777100
587820,390312.3,1332350,300400,203574.7,555250,287420,186737.6,777100
596210,337091.9,1332350,304740,172938.8,555250,291470,164153.1,777100
604660,300428.6,1332350,309080,146649.6,555250,295580,153779,777100
601410,315401.7,1332350,304450,153740.7,555250,296960,161661,777100
598120,288839.6,1332350,299790,136392.1,555250,298330,152447.5,777100
594820,316331,1332350,295100,152875.9,555250,299720,163455.1,777100
591540,351088.8,1332350,290440,175404.8,555250,301100,175684,777100
588060,329058.4,1332350,285610,155138,555250,302450,173920.4,777100
584510,277089.6,1332350,280740,121029.4,555250,303770,156060.2,777100
581030,233007.1,1332350,275890,109178.6,555250,305140,123828.5,777100
577510,227528.7,1332350,271010,99294.3,555250,306500,128234.4,777100
575990,221500.1,1332350,268040,83096.9,555250,307950,138403.2,777100
574410,213201.2,1332350,265090,82306.1,555250,309320,130895.1,777100
572860,198836.2,1332350,262150,83993.9,555250,310710,114842.3,777100
571300,207400.1,1332350,259180,90812.2,555250,312120,116587.9,777100
551870,240945.8,1332350,249870,115540.4,555250,302000,125405.4,777100
532490,413005.3,1332350,240570,214534.2,555250,291920,198471.1,777100
513010,498834.4,1332350,231260,261297.5,555250,281750,237536.9,777100
493640,523054.2,1332350,221950,274908.4,555250,271690,248145.8,777100
471600,401944.8,1332350,210510,206435.6,555250,261090,195509.2,777100
449650,289786.1,1332350,199040,139431.5,555250,250610,150354.6,777100
427620,191521.7,1332350,187610,80895.3,555250,240010,110626.4,777100
405630,173498.7,1332350,176160,71482,555250,229470,102016.7,777100
384090,173075,1332350,165890,73874.4,555250,218200,99200.6,777100
362640,183442,1332350,155650,77636.9,555250,206990,105805.1,777100
341090,184986.4,1332350,145420,84983.1,555250,195670,100003.3,777100
319670,163027.7,1332350,135160,73599.9,555250,184510,89427.8,777100
312710,161523.6,1332350,135050,74254.3,555250,177660,87269.3,777100
305800,148474.4,1332350,134990,68444,555250,170810,80030.4,777100
298970,105211.5,1332350,134890,49234.6,555250,164080,55976.9,777100
291990,79587.5,1332350,134770,36058.5,555250,157220,43529,777100
285830,67368.9,1332350,135770,33252.6,555250,150060,34116.3,777100
279560,65679.8,1332350,136780,35489.8,555250,142780,30190,777100
273370,62741.4,1332350,137780,37305.3,555250,135590,25436.1,777100
267120,54515.6,1332350,138770,33126.6,555250,128350,21389,777100
259890,54493.2,1332350,138220,34295.9,555250,121670,20197.3,777100
252690,58662.5,1332350,137690,37044.6,555250,115000,21617.9,777100
245410,59455.1,1332350,137130,37580.9,555250,108280,21874.2,777100
238220,52934.6,1332350,136600,36646.1,555250,101620,16288.5,777100
241740,60682.9,1332350,139890,43570,555250,101850,17112.9,777100
245300,66372.4,1332350,143190,46957.2,555250,102110,19415.2,777100
248820,59182.8,1332350,146480,40833.8,555250,102340,18349,777100
83410,98790.9,1332350,36420,44593.2,555250,46990,54197.7,777100
85770,107651.9,1332350,38930,48801.7,555250,46840,58850.2,777100
88100,103267,1332350,41470,47211.8,555250,46630,56055.2,777100
90470,76784.7,1332350,43970,32858.7,555250,46500,43926,777100
92800,57949.5,1332350,46510,21267.7,555250,46290,36681.8,777100
95950,64748.6,1332350,49410,26202.3,555250,46540,38546.3,777100
99050,111524.1,1332350,52310,52473,555250,46740,59051.1,777100
102260,138532.6,1332350,55200,67934.5,555250,47060,70598.1,777100
105350,147883,1332350,58110,72930.7,555250,47240,74952.3,777100
112070,199960.4,1332350,63930,103100.6,555250,48140,96859.8,777100
118720,94294.7,1332350,69750,40243.2,555250,48970,54051.5,777100
125470,153130,1332350,75560,76992.9,555250,49910,76137.1,777100
132170,147636.4,1332350,81380,75764.2,555250,50790,71872.2,777100
138270,194578.7,1332350,86970,108029.8,555250,51300,86548.9,777100
144370,192025.3,1332350,92550,108330.1,555250,51820,83695.2,777100
150460,198017.5,1332350,98110,117487.7,555250,52350,80529.8,777100
156530,262024.7,1332350,103670,162201.8,555250,52860,99822.9,777100
164210,279871.2,1332350,110600,174640.5,555250,53610,105230.7,777100
171890,189394.4,1332350,117540,122300.5,555250,54350,67093.9,777100
179540,243175.6,1332350,124450,158130.6,555250,55090,85045,777100
187190,245946.9,1332350,131380,162428.1,555250,55810,83518.8,777100
190710,189045.2,1332350,132580,128656,555250,58130,60389.2,777100
194220,168341.5,1332350,133760,115200.3,555250,60460,53141.2,777100
197660,150945.5,1332350,134940,102638.5,555250,62720,48307,777100
201140,192382.9,1332350,136140,128911.1,555250,65000,63471.8,777100
204080,231964.8,1332350,137020,152839.4,555250,67060,79125.4,777100
207050,288342.6,1332350,137950,184660.6,555250,69100,103682,777100
209980,345954.4,1332350,138880,217644.8,555250,71100,128309.6,777100
212920,351006.9,1332350,139780,220887.9,555250,73140,130119,777100
213620,371731.2,1332350,140720,231049.9,555250,72900,140681.3,777100
214340,288665.1,1332350,141630,183252.3,555250,72710,105412.8,777100
214960,217861.6,1332350,142540,141786.1,555250,72420,76075.5,777100
215690,193337.1,1332350,143450,130195.7,555250,72240,63141.4,777100
214060,154564.5,1332350,140800,103641.6,555250,73260,50922.9,777100
212430,118522,1332350,138120,80604.4,555250,74310,37917.6,777100
210780,261273.4,1332350,135440,164979.9,555250,75340,96293.5,777100
209150,290594.7,1332350,132750,180014.5,555250,76400,110580.2,777100
209620,282270.9,1332350,130280,169466.3,555250,79340,112804.6,777100
210300,249824.6,1332350,127870,144743,555250,82430,105081.6,777100
210920,268574.8,1332350,125410,149918.9,555250,85510,118655.9,777100
211480,309607.8,1332350,122970,167394.3,555250,88510,142213.5,777100
209470,309840.7,1332350,119400,162056.2,555250,90070,147784.5,777100
207510,335548.7,1332350,115840,172449,555250,91670,163099.7,777100
205480,374199.3,1332350,112270,185767.7,555250,93210,188431.6,777100
203430,306975.3,1332350,108710,143653.3,555250,94720,163322,777100
197800,239743.9,1332350,104560,101095.9,555250,93240,138648,777100
192170,218839.8,1332350,100370,93526.3,555250,91800,125313.5,777100
186530,241389.6,1332350,96220,102805.4,555250,90310,138584.2,777100
180850,212499.3,1332350,92040,80524.3,555250,88810,131975,777100
175130,187419.9,1332350,87390,72069.9,555250,87740,115350,777100
169350,186882.3,1332350,82720,74692.5,555250,86630,112189.8,777100
163630,209939.1,1332350,78060,88764.6,555250,85570,121174.5,777100
157840,210912,1332350,73380,90234.3,555250,84460,120677.7,777100
152930,231547.8,1332350,69250,96287.1,555250,83680,135260.7,777100
148160,249576,1332350,65120,107055.9,555250,83040,142520.1,777100
143300,242820,1332350,60980,113816.2,555250,82320,129003.8,777100
138450,200203.7,1332350,56870,87183.5,555250,81580,113020.2,777100
136310,218952.6,1332350,55920,99017,555250,80390,119935.6,777100
134160,269438.3,1332350,54940,126184.9,555250,79220,143253.4,777100
131940,249378.4,1332350,53960,110410,555250,77980,138968.4,777100
129850,210666.4,1332350,53000,90143.9,555250,76850,120522.5,777100
127230,213869.8,1332350,52980,94477.3,555250,74250,119392.5,777100
124710,230310.9,1332350,53000,102934.3,555250,71710,127376.6,777100
122110,233457.4,1332350,53000,103409.3,555250,69110,130048.1,777100
119600,212997.9,1332350,53000,91819,555250,66600,121178.9,777100
118330,190410.3,1332350,53790,79332.6,555250,64540,111077.7,777100
117100,176012.5,1332350,54550,75352.5,555250,62550,100660,777100
115840,214108.6,1332350,55330,100174.9,555250,60510,113933.7,777100
114640,209998.7,1332350,56090,98739.4,555250,58550,111259.3,777100
118880,196641.5,1332350,61900,97303.8,555250,56980,99337.7,777100
123100,195131.9,1332350,67710,96714,555250,55390,98417.9,777100
127340,163929.7,1332350,73510,86576.8,555250,53830,77352.9,777100
131580,164595.1,1332350,79310,93585.7,555250,52270,71009.4,777100
136990,169693.4,1332350,86280,103521.8,555250,50710,66171.6,777100
142440,144234.8,1332350,93270,91674.8,555250,49170,52560,777100
148010,129262.8,1332350,100280,88065,555250,47730,41197.8,777100
153480,134903.8,1332350,107270,95437,555250,46210,39466.8,777100
158710,111669.5,1332350,113610,87436.6,555250,45100,24232.9,777100
163900,100035.4,1332350,119930,83170.5,555250,43970,16864.9,777100
169140,101255.6,1332350,126280,86005.3,555250,42860,15250.3,777100
174380,102724.1,1332350,132620,87553.3,555250,41760,15170.8,777100
180710,126556.5,1332350,137070,105122.7,555250,43640,21433.8,777100
187010,198602.8,1332350,141530,148738.2,555250,45480,49864.6,777100
193360,261030.4,1332350,145970,178966.3,555250,47390,82064.1,777100
199700,314064.2,1332350,150440,207829.3,555250,49260,106234.9,777100
206130,358027.7,1332350,154790,239049.8,555250,51340,118977.9,777100
212540,383261.7,1332350,159170,254729.5,555250,53370,128532.2,777100
219020,379422.6,1332350,163570,252868.9,555250,55450,126553.7,777100
225440,395842.4,1332350,167970,264284.8,555250,57470,131557.6,777100
231680,388733.7,1332350,172010,254596.5,555250,59670,134137.2,777100
237930,306182.2,1332350,176060,203795.6,555250,61870,102386.6,777100
244120,200343.6,1332350,180120,145264.2,555250,64000,55079.4,777100
250330,161044.1,1332350,184160,116327.2,555250,66170,44716.9,777100
247010,242712.2,1332350,182130,168878.3,555250,64880,73833.9,777100
243710,300664,1332350,180120,206580.6,555250,63590,94083.4,777100
240430,348817.8,1332350,178080,235025.7,555250,62350,113792.1,777100
237180,359117.3,1332350,173660,242093,555250,63520,117024.3,777100
243200,333914.3,1332350,178070,230664.1,555250,65130,103250.2,777100
249370,321965.2,1332350,182470,217554.2,555250,66900,104411,777100
255440,308609,1332350,186870,207025.2,555250,68570,101583.8,777100
261510,286557.5,1332350,191290,199521.9,555250,70220,87035.6,777100
273130,266754.8,1332350,201020,195611.6,555250,72110,71143.2,777100
284800,284804.8,1332350,210780,211397.3,555250,74020,73407.5,777100
296450,349000.1,1332350,220530,254734.2,555250,75920,94265.9,777100
308140,396034.8,1332350,230300,285967.3,555250,77840,110067.5,777100
308590,392282.4,1332350,229610,279784.3,555250,78980,112498.1,777100
308940,316001.8,1332350,228910,231128.3,555250,80030,84873.5,777100
309230,254149.4,1332350,228180,193779.4,555250,81050,60370,777100
309760,293008.4,1332350,227520,211659.4,555250,82240,81349,777100
309200,290068.9,1332350,225860,209237.2,555250,83340,80831.7,777100
308770,296773.8,1332350,224220,209973.8,555250,84550,86800,777100
308330,319088.6,1332350,222610,224284.7,555250,85720,94803.9,777100
307920,332403.8,1332350,220960,232643.7,555250,86960,99760.1,777100
307920,338287,1332350,219620,229614.8,555250,88300,108672.2,777100
308080,337615.4,1332350,218250,230189.4,555250,89830,107426,777100
308220,360182.3,1332350,216930,243212.6,555250,91290,116969.7,777100
308310,359941.3,1332350,215570,240674.1,555250,92740,119267.2,777100
301920,347672.1,1332350,210730,229059.9,555250,91190,118612.2,777100
295600,305920,1332350,205930,203985.4,555250,89670,101934.6,777100
289320,292370.4,1332350,201130,195853.2,555250,88190,96517.2,777100
282960,264367.7,1332350,196330,178510.2,555250,86630,85857.5,777100
275090,235770.3,1332350,189950,159589.6,555250,85140,76180.7,777100
267240,243534.6,1332350,183570,162777.5,555250,83670,80757.1,777100
259330,260339.5,1332350,177220,171331.5,555250,82110,89008,777100
251520,249671.2,1332350,170830,167130.7,555250,80690,82540.5,777100
243080,245344.1,1332350,165610,163999.8,555250,77470,81344.3,777100
234650,257602,1332350,160380,172404,555250,74270,85198,777100
226250,253341.1,1332350,155160,172252.2,555250,71090,81088.9,777100
217820,270174.5,1332350,149930,183123.9,555250,67890,87050.6,777100
211550,259497.9,1332350,144770,175251.9,555250,66780,84246,777100
205220,272029.5,1332350,139650,182241.9,555250,65570,89787.6,777100
198820,244259.8,1332350,134510,165719.6,555250,64310,78540.2,777100
192510,201992,1332350,129370,140240.4,555250,63140,61751.6,777100
188970,211732.5,1332350,125450,143532.4,555250,63520,68200.1,777100
185420,213645,1332350,121540,141144.3,555250,63880,72500.7,777100
181880,201042.7,1332350,117610,132590.8,555250,64270,68451.9,777100
178360,188174.9,1332350,113740,119718.6,555250,64620,68456.3,777100
176450,204212.9,1332350,110740,125680.2,555250,65710,78532.7,777100
174550,209640.9,1332350,107730,126534.9,555250,66820,83106,777100
172750,227646.6,1332350,104770,136536.3,555250,67980,91110.3,777100
170840,256138.8,1332350,101750,148741,555250,69090,107397.8,777100
184640,271731.5,1332350,107160,156139.3,555250,77480,115592.2,777100
198410,285446.2,1332350,112590,160501.8,555250,85820,124944.4,777100
212200,303850.1,1332350,118030,170991.6,555250,94170,132858.5,777100
225970,327417.5,1332350,123440,173677.7,555250,102530,153739.8,777100
241350,290638.1,1332350,130130,155478.6,555250,111220,135159.5,777100
256650,276769.6,1332350,136790,148571.4,555250,119860,128198.2,777100
271940,311963,1332350,143480,166039,555250,128460,145924,777100
287280,333866.3,1332350,150180,183301.2,555250,137100,150565.1,777100
301240,402792.9,1332350,155310,215278.1,555250,145930,187514.8,777100
315220,436960.2,1332350,160460,229854,555250,154760,207106.2,777100
329120,463466,1332350,165600,245337.1,555250,163520,218128.9,777100
343170,461295.5,1332350,170750,241649,555250,172420,219646.5,777100
357050,477948.8,1332350,175270,249251.2,555250,181780,228697.6,777100
370910,496233.5,1332350,179770,254151,555250,191140,242082.5,777100
384800,501939.4,1332350,184310,252639.9,555250,200490,249299.5,777100
398620,486986.3,1332350,188810,243953.7,555250,209810,243032.6,777100
412460,502621.5,1332350,193470,245454.9,555250,218990,257166.6,777100
426300,517065.8,1332350,198130,252116.2,555250,228170,264949.6,777100
440100,565657.8,1332350,202820,270766.9,555250,237280,294890.9,777100
453960,558925.6,1332350,207470,272146.5,555250,246490,286779.1,777100
469070,564240.4,1332350,213280,276405.3,555250,255790,287835.1,777100
484220,633377.1,1332350,219040,316895.1,555250,265180,316482,777100
499260,637765.8,1332350,224820,311187.8,555250,274440,326578,777100
514370,639174.8,1332350,230620,308623.9,555250,283750,330550.9,777100
520080,604938.6,1332350,234420,290515.7,555250,285660,314422.9,777100
525740,628913.4,1332350,238200,300768.7,555250,287540,328144.7,777100
531370,588847.5,1332350,241970,280425.1,555250,289400,308422.4,777100
537060,611468.8,1332350,245770,301497.1,555250,291290,309971.7,777100
539490,632052.5,1332350,247820,314868.4,555250,291670,317184.1,777100
541860,658987.5,1332350,249840,322272,555250,292020,336715.5,777100
544300,625264.2,1332350,251910,308601.8,555250,292390,316662.4,777100
546710,669638.6,1332350,253970,329439.9,555250,292740,340198.7,777100
550740,670910.2,1332350,258210,336476.6,555250,292530,334433.6,777100
554760,682229.7,1332350,262480,349886.1,555250,292280,332343.6,777100
558690,630732.8,1332350,266740,326887.4,555250,291950,303845.4,777100
562740,604246.9,1332350,270980,317398.7,555250,291760,286848.2,777100
556160,555762.5,1332350,268930,289498.1,555250,287230,266264.4,777100
549540,559726.6,1332350,266900,294726.9,555250,282640,264999.7,777100
543000,532018.2,1332350,264860,279447.9,555250,278140,252570.3,777100
536410,510750.2,1332350,262840,265958.5,555250,273570,244791.7,777100
532680,486387.2,1332350,264220,256208.1,555250,268460,230179.1,777100
529200,481527.1,1332350,265670,256196.1,555250,263530,225331,777100
525630,440117.7,1332350,267060,241417.1,555250,258570,198700.6,777100
521980,437114.3,1332350,268460,240051.3,555250,253520,197063,777100
517180,404389.2,1332350,268520,228976.4,555250,248660,175412.8,777100
512420,388357.5,1332350,268570,225146.5,555250,243850,163211,777100
507640,393893.4,1332350,268610,229667.6,555250,239030,164225.8,777100
502840,366024.4,1332350,268650,215007.9,555250,234190,151016.5,777100
505750,398936.6,1332350,269800,237133,555250,235950,161803.6,777100
508610,402599.5,1332350,270930,238019.1,555250,237680,164580.4,777100
511590,374950.2,1332350,272060,222939.2,555250,239530,152011,777100
377270,365147.1,1332350,200940,211150.3,555250,176330,153996.8,777100
376700,301726.6,1332350,199880,171078.6,555250,176820,130648,777100
376150,347867.2,1332350,198840,195220.7,555250,177310,152646.5,777100
375540,378147.7,1332350,197780,213101.7,555250,177760,165046,777100
375030,417963.9,1332350,196750,235921.4,555250,178280,182042.5,777100
375400,434859.8,1332350,196550,243623.5,555250,178850,191236.3,777100
375770,456954.9,1332350,196340,256044.7,555250,179430,200910.2,777100
376200,459990.9,1332350,196110,253991.7,555250,180090,205999.2,777100
376610,460025.2,1332350,195920,251219.3,555250,180690,208805.9,777100
386930,477434.8,1332350,200440,260930.2,555250,186490,216504.6,777100
397230,491001.3,1332350,204980,268223.5,555250,192250,222777.8,777100
407440,518395.7,1332350,209480,282360.7,555250,197960,236035,777100
417720,517612.6,1332350,214040,282863.8,555250,203680,234748.8,777100
427420,566120,1332350,218050,309914.3,555250,209370,256205.7,777100
437070,580142.9,1332350,222080,316667.2,555250,214990,263475.7,777100
446750,571892.4,1332350,226110,309966.4,555250,220640,261926,777100
456400,604441.6,1332350,230140,328303.1,555250,226260,276138.5,777100
465040,647449.6,1332350,233880,351730.6,555250,231160,295719,777100
473690,692656.7,1332350,237650,375599,555250,236040,317057.7,777100
482390,726202.9,1332350,241370,393380.3,555250,241020,332822.6,777100
491000,728590.1,1332350,245130,395289,555250,245870,333301.1,777100
493960,715453.1,1332350,246110,384763,555250,247850,330690.1,777100
496830,709074.9,1332350,247070,381456.9,555250,249760,327618,777100
499770,718850.6,1332350,248030,385175,555250,251740,333675.6,777100
502680,742718.5,1332350,248990,398350.4,555250,253690,344368.1,777100
502960,732657.1,1332350,247980,396157.1,555250,254980,336500,777100
503080,740520.9,1332350,246910,399443.5,555250,256170,341077.4,777100
503240,751751.9,1332350,245870,404196.7,555250,257370,347555.2,777100
503540,737649,1332350,244860,396670.8,555250,258680,340978.2,777100
506130,725329.3,1332350,245720,389696,555250,260410,335633.3,777100
508800,700118.8,1332350,246590,376693.2,555250,262210,323425.6,777100
511490,670514,1332350,247490,356321.2,555250,264000,314192.8,777100
514090,636840.9,1332350,248360,332929.2,555250,265730,303911.7,777100
519950,605416.3,1332350,249090,316385.2,555250,270860,289031.1,777100
525920,615118.3,1332350,249860,320327.7,555250,276060,294790.6,777100
531750,612431.4,1332350,250620,313970.8,555250,281130,298460.6,777100
537610,607821.1,1332350,251350,306460.7,555250,286260,301360.4,777100
542120,581623,1332350,251070,288220.4,555250,291050,293402.6,777100
546620,565238.3,1332350,250760,275836.7,555250,295860,289401.6,777100
551110,568188.3,1332350,250470,273091.3,555250,300640,295097,777100
555520,556894.7,1332350,250130,268949,555250,305390,287945.7,777100
559110,508952.3,1332350,249090,238883,555250,310020,270069.3,777100
562640,473311,1332350,248020,212655.7,555250,314620,260655.3,777100
566120,470652,1332350,246940,209052.3,555250,319180,261599.7,777100
569690,481666.1,1332350,245890,213684.9,555250,323800,267981.2,777100
564770,480161.1,1332350,241350,209311.6,555250,323420,270849.5,777100
559780,487811.6,1332350,236810,210032.7,555250,322970,277778.9,777100
554820,516800.3,1332350,232260,221955.9,555250,322560,294844.4,777100
549930,533426.8,1332350,227710,222601.9,555250,322220,310824.9,777100
545060,520942.2,1332350,223140,212040.4,555250,321920,308901.8,777100
540140,562948.8,1332350,218570,235616.8,555250,321570,327332,777100
535190,593016.4,1332350,214000,249088.7,555250,321190,343927.7,777100
530370,621892.1,1332350,209410,261305.9,555250,320960,360586.2,777100
527220,607275,1332350,206440,254376.3,555250,320780,352898.7,777100
524170,534391.2,1332350,203460,211811.8,555250,320710,322579.4,777100
521110,497862.2,1332350,200520,184964,555250,320590,312898.2,777100
517970,458323.7,1332350,197550,159664.3,555250,320420,298659.4,777100
516180,489737.8,1332350,195120,170571.8,555250,321060,319166,777100
514430,546615.5,1332350,192720,204692.5,555250,321710,341923,777100
512640,591718.2,1332350,190280,224037.6,555250,322360,367680.6,777100
510770,607283.1,1332350,187870,228855.7,555250,322900,378427.4,777100
507960,601464.7,1332350,184470,222381.3,555250,323490,379083.4,777100
505060,594175.1,1332350,181090,207791.2,555250,323970,386383.9,777100
502270,603225.3,1332350,177700,213566.1,555250,324570,389659.2,777100
499480,617154.7,1332350,174330,220943.4,555250,325150,396211.3,777100
495990,626402.8,1332350,169970,229044,555250,326020,397358.8,777100
492600,610198.3,1332350,165640,212158.3,555250,326960,398040,777100
489190,596547.1,1332350,161310,200676.2,555250,327880,395870.9,777100
485800,596835,1332350,156980,200344,555250,328820,396491,777100
474380,567954.7,1332350,150800,184686.5,555250,323580,383268.2,777100
462980,518061.4,1332350,144660,158278.4,555250,318320,359783,777100
451490,476233.9,1332350,138480,138114.2,555250,313010,338119.7,777100
440100,453568.4,1332350,132320,125218,555250,307780,328350.4,777100
428820,441872.3,1332350,126970,117264.1,555250,301850,324608.2,777100
417470,411262.1,1332350,121640,106361,555250,295830,304901.1,777100
406240,402136.7,1332350,116310,97412.2,555250,289930,304724.5,777100
394870,389224.8,1332350,110980,94944,555250,283890,294280.8,777100
383200,380096.9,1332350,105810,89923.7,555250,277390,290173.2,777100
371570,367645.5,1332350,100670,85732.1,555250,270900,281913.4,777100
359860,368263.5,1332350,95480,91042.6,555250,264380,277220.9,777100
348120,365176.3,1332350,90320,84950.7,555250,257800,280225.6,777100
338360,345433.8,1332350,86680,82452.4,555250,251680,262981.4,777100
328510,341292.4,1332350,83010,81375,555250,245500,259917.4,777100
318600,316268.2,1332350,79310,71152.9,555250,239290,245115.3,777100
308750,298212.5,1332350,75640,65764.5,555250,233110,232448,777100
298430,270833.3,1332350,71770,56385.3,555250,226660,214448,777100
288170,262158.9,1332350,67910,54763.1,555250,220260,207395.8,777100
277820,268314.5,1332350,64050,58322.5,555250,213770,209992,777100
267560,268165.4,1332350,60180,54987.7,555250,207380,213177.7,777100
258190,265018.2,1332350,56620,54035,555250,201570,210983.2,777100
248910,265281.3,1332350,53130,52022,555250,195780,213259.3,777100
239590,257612.3,1332350,49610,47265.3,555250,189980,210347,777100
230200,244601.8,1332350,46090,43098,555250,184110,201503.8,777100
234490,238782.4,1332350,50420,41781.3,555250,184070,197001.1,777100
238580,229072.8,1332350,54700,36016.6,555250,183880,193056.2,777100
242840,217530.5,1332350,59020,30051.1,555250,183820,187479.4,777100
279330,205977,1332350,74800,27012.5,555250,204530,178964.5,777100
274600,206773.6,1332350,72380,25610.3,555250,202220,181163.3,777100
269790,207244.1,1332350,69880,26422,555250,199910,180822.1,777100
265140,226449.6,1332350,67460,31779.8,555250,197680,194669.8,777100
260320,243353,1332350,65000,40969.1,555250,195320,202383.9,777100
256310,250600.5,1332350,63020,45159.1,555250,193290,205441.4,777100
252170,244462.6,1332350,61030,37470.6,555250,191140,206992,777100
248070,224756.1,1332350,59020,32046.8,555250,189050,192709.3,777100
243960,229788.2,1332350,57040,35261.1,555250,186920,194527.1,777100
245690,220707.7,1332350,59240,27053.1,555250,186450,193654.6,777100
247470,210361.6,1332350,61430,25455.7,555250,186040,184905.9,777100
249250,218108.1,1332350,63620,28287.5,555250,185630,189820.6,777100
251030,223514.8,1332350,65820,28235.9,555250,185210,195278.9,777100
252950,220131.4,1332350,68390,24278.4,555250,184560,195853,777100
254840,210233.7,1332350,70960,22275.8,555250,183880,187957.9,777100
256810,209040.8,1332350,73550,23301.7,555250,183260,185739.1,777100
258710,198942.5,1332350,76120,26686.8,555250,182590,172255.7,777100
258480,198874.9,1332350,77040,31464.2,555250,181440,167410.7,777100
258370,199119.1,1332350,78010,33849.9,555250,180360,165269.2,777100
258170,203464.3,1332350,78950,34808.6,555250,179220,168655.7,777100
257910,212883,1332350,79860,37234.1,555250,178050,175648.9,777100
249410,222433.4,1332350,78070,45718.4,555250,171340,176715,777100
240960,236207,1332350,76280,55663.6,555250,164680,180543.4,777100
232460,252890.6,1332350,74480,65282.3,555250,157980,187608.3,777100
223890,264718.9,1332350,72650,75517.1,555250,151240,189201.8,777100
216030,279572.8,1332350,71020,85557.4,555250,145010,194015.4,777100
208170,264316.2,1332350,69410,78852.2,555250,138760,185464,777100
200300,230853.4,1332350,67760,65027.2,555250,132540,165826.2,777100
192310,189019.2,1332350,66130,47729,555250,126180,141290.2,777100
184420,164693.4,1332350,63790,39813.4,555250,120630,124880,777100
176530,159501,1332350,61460,45304.1,555250,115070,114196.9,777100
168650,178955.8,1332350,59160,61821.1,555250,109490,117134.7,777100
160840,206552.2,1332350,56830,86023.2,555250,104010,120529,777100
159440,258100.3,1332350,60720,129503.4,555250,98720,128596.9,777100
158080,268567.6,1332350,64600,142978.8,555250,93480,125588.8,777100
156730,272616.1,1332350,68490,150166.1,555250,88240,122450,777100
155370,256584.4,1332350,72340,144512.4,555250,83030,112072,777100
154070,222549.4,1332350,74540,127711.1,555250,79530,94838.3,777100
152830,209556.5,1332350,76730,122488.2,555250,76100,87068.3,777100
151580,225067.8,1332350,78930,131579.9,555250,72650,93487.9,777100
150270,200716.9,1332350,81120,116464.5,555250,69150,84252.4,777100
149580,168342.2,1332350,83250,99062.7,555250,66330,69279.5,777100
148930,135222.2,1332350,85420,80483.1,555250,63510,54739.1,777100
148260,96249.8,1332350,87570,58581.8,555250,60690,37668,777100
147470,91010.5,1332350,89700,57666.1,555250,57770,33344.4,777100
148400,96464.1,1332350,90980,62389.9,555250,57420,34074.2,777100
149300,102655.4,1332350,92250,64950.9,555250,57050,37704.5,777100
150230,114383.8,1332350,93530,72068,555250,56700,42315.8,777100
151140,102349.4,1332350,94790,65556.4,555250,56350,36793,777100
151020,106572.5,1332350,95310,67428.8,555250,55710,39143.7,777100
150940,103574.5,1332350,95870,66249,555250,55070,37325.5,777100
150890,93417.2,1332350,96420,61531.2,555250,54470,31886,777100
150790,90719.1,1332350,96980,60937.3,555250,53810,29781.8,777100
151870,87185.9,1332350,98610,58827.4,555250,53260,28358.5,777100
153020,83799.6,1332350,100210,57199.7,555250,52810,26599.9,777100
154190,81211.5,1332350,101840,58152.4,555250,52350,23059.1,777100
155320,85367.9,1332350,103490,62630,555250,51830,22737.9,777100
154610,76928.3,1332350,104950,58887,555250,49660,18041.3,777100
153910,78213.4,1332350,106450,59527.1,555250,47460,18686.3,777100
153280,77878.5,1332350,107910,61758.8,555250,45370,16119.7,777100
152560,81452.8,1332350,109410,68285.5,555250,43150,13167.3,777100
151360,75223.3,1332350,110380,66127.3,555250,40980,9096,777100
150270,72888.9,1332350,111380,64409,555250,38890,8479.9,777100
148990,63267.8,1332350,112360,55684.8,555250,36630,7583,777100
147770,48946.9,1332350,113340,42230.8,555250,34430,6716.1,777100
146190,37539.3,1332350,113890,31134.9,555250,32300,6404.4,777100
144540,30233.8,1332350,114390,24388.7,555250,30150,5845.1,777100
142970,27708.1,1332350,114960,20765.8,555250,28010,6942.3,777100
141300,29588,1332350,115450,23225.5,555250,25850,6362.5,777100
131880,30908.6,1332350,107440,24857.7,555250,24440,6050.9,777100
122560,30915.2,1332350,99400,23375,555250,23160,7540.2,777100
113160,24419.5,1332350,91360,17779.8,555250,21800,6639.7,777100
103820,17545.1,1332350,83360,11477.2,555250,20460,6067.9,777100
95560,10895.3,1332350,76200,5140.7,555250,19360,5754.6,777100
87260,7057.9,1332350,69000,1837.9,555250,18260,5220,777100
79020,6998.3,1332350,61830,778.1,555250,17190,6220.2,777100
70750,6483.7,1332350,54650,122,555250,16100,6361.7,777100
62770,6101.5,1332350,48080,168.5,555250,14690,5933,777100
54790,6021,1332350,41470,191.9,555250,13320,5829.1,777100
46760,7071.6,1332350,34910,235.7,555250,11850,6835.9,777100
38750,7144.6,1332350,28310,210.6,555250,10440,6934,777100
37740,7696,1332350,26720,539.3,555250,11020,7156.7,777100
36770,8543.5,1332350,25120,1211.8,555250,11650,7331.7,777100
35820,12279.1,1332350,23530,3277.6,555250,12290,9001.5,777100
34840,22837.4,1332350,21950,10470.6,555250,12890,12366.8,777100
35260,29696.8,1332350,21910,13990.9,555250,13350,15705.9,777100
35780,37858.5,1332350,21890,18236.8,555250,13890,19621.7,777100
36290,64564.5,1332350,21830,33563.6,555250,14460,31000.9,777100
36700,77581.4,1332350,21810,40951.9,555250,14890,36629.5,777100
39550,85119.9,1332350,24180,45752.8,555250,15370,39367.1,777100
42230,102941.4,1332350,26510,57409,555250,15720,45532.4,777100
45140,119962.8,1332350,28890,68745.6,555250,16250,51217.2,777100
47920,147090.6,1332350,31230,86364.4,555250,16690,60726.2,777100
58540,190493.8,1332350,39320,115655.9,555250,19220,74837.9,777100
69210,228077.2,1332350,47410,140982.9,555250,21800,87094.3,777100
79830,259805.9,1332350,55470,163415.5,555250,24360,96390.4,777100
154940,259101.3,1332350,106750,176072,555250,48190,83029.3,777100
166850,280311.9,1332350,114840,193738.3,555250,52010,86573.6,777100
178790,300909.1,1332350,122950,207631.5,555250,55840,93277.6,777100
190730,287202.7,1332350,131050,200420.8,555250,59680,86781.9,777100
202680,263849.7,1332350,139150,187997.1,555250,63530,75852.6,777100
213830,256226.1,1332350,146380,184259.3,555250,67450,71966.8,777100
224910,253590.3,1332350,153640,182958.5,555250,71270,70631.8,777100
236090,247351.3,1332350,160890,179271.2,555250,75200,68080.1,777100
247200,234975.8,1332350,168120,170798,555250,79080,64177.8,777100
256420,244222.3,1332350,173000,173757.8,555250,83420,70464.5,777100
265600,250628.5,1332350,177830,173855.6,555250,87770,76772.9,777100
274870,320871.8,1332350,182710,213572.6,555250,92160,107299.2,777100
283990,373856.3,1332350,187550,244139.7,555250,96440,129716.6,777100
292440,370297.8,1332350,191890,240543.2,555250,100550,129754.6,777100
301010,377301.8,1332350,196250,241155.2,555250,104760,136146.6,777100
309460,417609,1332350,200640,263651.2,555250,108820,153957.8,777100
317930,438173.2,1332350,204960,276049.5,555250,112970,162123.7,777100
326510,434740.5,1332350,209600,273219.7,555250,116910,161520.8,777100
335110,425544.7,1332350,214290,265240.2,555250,120820,160304.5,777100
343630,401364.7,1332350,218910,251059,555250,124720,150305.7,777100
352250,369248.3,1332350,223580,232118.6,555250,128670,137129.7,777100
357320,327470.5,1332350,225390,202890.3,555250,131930,124580.2,777100
362350,322174.5,1332350,227170,192444.1,555250,135180,129730.4,777100
367430,359693.8,1332350,228970,206988.1,555250,138460,152705.7,777100
372530,392279.5,1332350,230770,221890.8,555250,141760,170388.7,777100
377760,398089.8,1332350,232730,221387.3,555250,145030,176702.5,777100
383120,385225.9,1332350,234710,211191,555250,148410,174034.9,777100
388400,418233.8,1332350,236690,227339.2,555250,151710,190894.6,777100
393690,409537,1332350,238640,223523.6,555250,155050,186013.4,777100
398360,424780.5,1332350,239210,237384.7,555250,159150,187395.8,777100
403000,437779.1,1332350,239760,248957.8,555250,163240,188821.3,777100
407590,383875.9,1332350,240340,218521.4,555250,167250,165354.5,777100
412240,357364.4,1332350,240910,207168.3,555250,171330,150196.1,777100
405210,356243.2,1332350,237200,215313.9,555250,168010,140929.3,777100
398160,341953,1332350,233540,211831.9,555250,164620,130121.1,777100
391150,314446.4,1332350,229830,201000.9,555250,161320,113445.5,777100
384140,324407.8,1332350,226170,205557.5,555250,157970,118850.3,777100
375240,314282.9,1332350,221930,198907.9,555250,153310,115375,777100
366380,323460,1332350,217690,205726.6,555250,148690,117733.4,777100
357490,384889.3,1332350,213440,239255.3,555250,144050,145634,777100
348650,436106.9,1332350,209200,268156.8,555250,139450,167950.1,777100
342450,460896.9,1332350,204560,275174.5,555250,137890,185722.4,777100
336130,443659.2,1332350,199920,264857.9,555250,136210,178801.3,777100
329750,389515.3,1332350,195240,233185.5,555250,134510,156329.8,777100
323490,301328.9,1332350,190600,175457.7,555250,132890,125871.2,777100
317190,281253,1332350,184170,161218.6,555250,133020,120034.4,777100
310870,309048.9,1332350,177710,170537.6,555250,133160,138511.3,777100
304650,352009,1332350,171330,188747.4,555250,133320,163261.6,777100
298270,366949.3,1332350,164850,195726.4,555250,133420,171222.9,777100
291620,435519.5,1332350,157600,234934.5,555250,134020,200585,777100
284850,483430.7,1332350,150300,264544.9,555250,134550,218885.8,777100
278050,526209,1332350,143000,290572.8,555250,135050,235636.2,777100
271280,566060.9,1332350,135710,314658.1,555250,135570,251402.8,777100
264080,592418.6,1332350,128130,328477.1,555250,135950,263941.5,777100
256800,585104.3,1332350,120550,322006.6,555250,136250,263097.7,777100
249570,597305.4,1332350,112990,326786,555250,136580,270519.4,777100
242300,586637.2,1332350,105430,314691.2,555250,136870,271946,777100
238230,565323.3,1332350,103960,299299.8,555250,134270,266023.5,777100
234110,610800.4,1332350,102450,298570,555250,131660,312230.4,777100
230040,595280.8,1332350,100960,281231.1,555250,129080,314049.7,777100
225930,565580.3,1332350,99470,266846.4,555250,126460,298733.9,777100
223220,496299.6,1332350,99660,245226.5,555250,123560,251073.1,777100
220410,487201,1332350,99840,234028.7,555250,120570,253172.3,777100
217810,362942.6,1332350,100050,180446.7,555250,117760,182495.9,777100
215090,202791.1,1332350,100260,104632.9,555250,114830,98158.2,777100
211040,175394.8,1332350,99640,88699.4,555250,111400,86695.4,777100
206930,151001.1,1332350,99010,76301.2,555250,107920,74699.9,777100
202900,172528.1,1332350,98380,84257.6,555250,104520,88270.5,777100
198860,154321.4,1332350,97760,75784.2,555250,101100,78537.2,777100
195590,148023.9,1332350,95900,75162.4,555250,99690,72861.5,777100
192280,240245.2,1332350,94030,124169,555250,98250,116076.2,777100
189040,198912.6,1332350,92160,99827.3,555250,96880,99085.3,777100
185720,148277.7,1332350,90270,73551.8,555250,95450,74725.9,777100
181510,119390.3,1332350,87640,54894.3,555250,93870,64496,777100
177320,84731.3,1332350,84970,35773.8,555250,92350,48957.5,777100
173080,71362.2,1332350,82310,30907.7,555250,90770,40454.5,777100
168870,86437.8,1332350,79650,37727.2,555250,89220,48710.6,777100
165040,70171.3,1332350,77270,30422.9,555250,87770,39748.4,777100
161280,49401.1,1332350,74910,19185.9,555250,86370,30215.2,777100
157540,49314.5,1332350,72530,22011.5,555250,85010,27303,777100
153730,71304.3,1332350,70170,33011.5,555250,83560,38292.8,777100
153430,63853.2,1332350,70290,30837.7,555250,83140,33015.5,777100
153130,47925.2,1332350,70380,20781.4,555250,82750,27143.8,777100
152790,42072.8,1332350,70480,18836.6,555250,82310,23236.2,777100
152510,17762.7,1332350,70590,7550.8,555250,81920,10211.9,777100
155950,11548.5,1332350,74420,5722,555250,81530,5826.5,777100
159340,17147.9,1332350,78230,10627,555250,81110,6520.9,777100
162800,32753.8,1332350,82060,22353.2,555250,80740,10400.6,777100
166240,42121.2,1332350,85880,30298.1,555250,80360,11823.1,777100
163870,33583.8,1332350,83420,22939.9,555250,80450,10643.9,777100
161410,49218.6,1332350,80950,31925.1,555250,80460,17293.5,777100
158940,73110.1,1332350,78480,43931.1,555250,80460,29179,777100
156530,73307.1,1332350,76050,40907.6,555250,80480,32399.5,777100
158910,57448.3,1332350,75490,30435.7,555250,83420,27012.6,777100
161260,67778.8,1332350,74920,36156.8,555250,86340,31622,777100
163680,107611.1,1332350,74410,55902.6,555250,89270,51708.5,777100
149310,78374.3,1332350,65130,36989.4,555250,84180,41384.9,777100
155300,48265.2,1332350,67650,19506.2,555250,87650,28759,777100
161280,43175.8,1332350,70120,12692.9,555250,91160,30482.9,777100
167250,61724.3,1332350,72610,18123.8,555250,94640,43600.5,777100
173290,57184.7,1332350,75100,20038.5,555250,98190,37146.2,777100
180810,45337.5,1332350,79330,14071,555250,101480,31266.5,777100
188370,38796.4,1332350,83590,8980.5,555250,104780,29815.9,777100
195800,36059.6,1332350,87790,8090.1,555250,108010,27969.5,777100
203370,27678.5,1332350,92040,6348.6,555250,111330,21329.9,777100
206160,28210.1,1332350,92370,6565.2,555250,113790,21644.9,777100
209110,28509.1,1332350,92730,6937.9,555250,116380,21571.2,777100
211880,25706.1,1332350,93070,5813.4,555250,118810,19892.7,777100
214710,27788,1332350,93420,5322.6,555250,121290,22465.4,777100
216880,34595,1332350,94220,8331.6,555250,122660,26263.4,777100
219040,38101.7,1332350,95040,10019.1,555250,124000,28082.6,777100
221150,48233.6,1332350,95860,15004.9,555250,125290,33228.7,777100
223290,61855.3,1332350,96660,23596.2,555250,126630,38259.1,777100
224220,74038.6,1332350,96730,30067.1,555250,127490,43971.5,777100
225160,67386.9,1332350,96800,26044.4,555250,128360,41342.5,777100
226010,66589.3,1332350,96840,22893.5,555250,129170,43695.8,777100
226950,70532.2,1332350,96910,24243.7,555250,130040,46288.5,777100
223910,75123.6,1332350,96840,29491.9,555250,127070,45631.7,777100
220890,87256,1332350,96790,37664.4,555250,124100,49591.6,777100
217900,92753.1,1332350,96760,42303.8,555250,121140,50449.3,777100
214980,85651.1,1332350,96720,39396.6,555250,118260,46254.5,777100
212170,71410.4,1332350,96410,32728.6,555250,115760,38681.8,777100
209240,64723,1332350,96090,29467.6,555250,113150,35255.4,777100
206480,77823.3,1332350,95780,37902.6,555250,110700,39920.7,777100
203620,80648.9,1332350,95490,39463.9,555250,108130,41185,777100
202950,78885.6,1332350,96140,39043.1,555250,106810,39842.5,777100
202400,78037.8,1332350,96830,39091.1,555250,105570,38946.7,777100
201810,68102.8,1332350,97500,34655.8,555250,104310,33447,777100
201200,64391.9,1332350,98180,32878,555250,103020,31513.9,777100
200120,64479.9,1332350,96080,31622.8,555250,104040,32857.1,777100
199200,64000.4,1332350,94010,29305.3,555250,105190,34695.1,777100
198180,64058.3,1332350,91920,27062.7,555250,106260,36995.6,777100
197140,63729.1,1332350,89870,25713.5,555250,107270,38015.6,777100
194170,77419.9,1332350,86790,31488.9,555250,107380,45931,777100
191160,88363.6,1332350,83680,36345.1,555250,107480,52018.5,777100
188200,111872.3,1332350,80600,45361.7,555250,107600,66510.6,777100
185130,122193.3,1332350,77490,47200.2,555250,107640,74993.1,777100
182270,128372.3,1332350,74440,48572.3,555250,107830,79800,777100
179380,135001.1,1332350,71370,50988.7,555250,108010,84012.4,777100
176510,141927.3,1332350,68290,52793.7,555250,108220,89133.6,777100
173650,151155.3,1332350,65220,54303,555250,108430,96852.3,777100
173690,154555.8,1332350,65460,56361.7,555250,108230,98194.1,777100
173810,163243.4,1332350,65710,62251.8,555250,108100,100991.6,777100
173910,186449,1332350,65970,75365.1,555250,107940,111083.9,777100
173970,197065.4,1332350,66210,79690.6,555250,107760,117374.8,777100
172970,218135.1,1332350,65510,89985.6,555250,107460,128149.5,777100
171990,316427.5,1332350,64780,146397.3,555250,107210,170030.2,777100
170950,393497.3,1332350,64080,194083.2,555250,106870,199414.1,777100
170010,302371.4,1332350,63380,136121.3,555250,106630,166250.1,777100
168300,287513.8,1332350,61940,123513,555250,106360,164000.8,777100
166600,282039,1332350,60500,116211.3,555250,106100,165827.7,777100
164940,285277.9,1332350,59060,116235.5,555250,105880,169042.4,777100
163220,271227.4,1332350,57600,114032,555250,105620,157195.4,777100
161460,249086.6,1332350,57920,104335,555250,103540,144751.6,777100
159570,222302.1,1332350,58250,92352.6,555250,101320,129949.5,777100
157710,223348.9,1332350,58530,93047.1,555250,99180,130301.8,777100
155960,219834.9,1332350,58850,89565.1,555250,97110,130269.8,777100
154870,195892.3,1332350,59760,81052.7,555250,95110,114839.6,777100
153580,182772.2,1332350,60650,71125.4,555250,92930,111646.8,777100
152450,160949.3,1332350,61570,63495.4,555250,90880,97453.9,777100
151280,153596.7,1332350,62520,59570.4,555250,88760,94026.3,777100
149670,161948.4,1332350,63360,68083.3,555250,86310,93865.1,777100
148190,183295.6,1332350,64280,83682.1,555250,83910,99613.5,777100
146690,210292.5,1332350,65210,100408.2,555250,81480,109884.3,777100
145140,217221.9,1332350,66100,106925.2,555250,79040,110296.7,777100
142940,222696.8,1332350,66160,110187.8,555250,76780,112509,777100
140740,214459.5,1332350,66220,106342.2,555250,74520,108117.3,777100
138550,215285.3,1332350,66280,107258.6,555250,72270,108026.7,777100
136360,208084.7,1332350,66320,102960.6,555250,70040,105124.1,777100
134100,182287.9,1332350,66230,87042.5,555250,67870,95245.4,777100
131750,166690,1332350,66150,78794.9,555250,65600,87895.1,777100
129530,157899.4,1332350,66050,75875.2,555250,63480,82024.2,777100
127210,175063.1,1332350,65970,79829.4,555250,61240,95233.7,777100
125460,155639.2,1332350,66190,67274,555250,59270,88365.2,777100
123780,133469.3,1332350,66440,58075.7,555250,57340,75393.6,777100
121980,146108.8,1332350,66670,67475.5,555250,55310,78633.3,777100
120300,130415.6,1332350,66910,62557.1,555250,53390,67858.5,777100
120910,130323.2,1332350,68210,64759.5,555250,52700,65563.7,777100
121550,127465.3,1332350,69500,64748.4,555250,52050,62716.9,777100
122170,131351.1,1332350,70790,64125,555250,51380,67226.1,777100
122820,181371.6,1332350,72100,95917.2,555250,50720,85454.4,777100
124120,242201.9,1332350,73840,134847.9,555250,50280,107354,777100
125320,220672,1332350,75560,124110.1,555250,49760,96561.9,777100
126620,177809.6,1332350,77290,98976.6,555250,49330,78833,777100
127900,204193.4,1332350,79020,114601.7,555250,48880,89591.7,777100
129790,243965.4,1332350,81330,141631.6,555250,48460,102333.8,777100
131800,305433.9,1332350,83610,178049.9,555250,48190,127384,777100
133710,306645.7,1332350,85890,180271.2,555250,47820,126374.5,777100
135660,301244.1,1332350,88180,177686.7,555250,47480,123557.4,777100
139300,367434.9,1332350,91200,217299.1,555250,48100,150135.8,777100
142820,376356.6,1332350,94210,223956.5,555250,48610,152400.1,777100
146310,334221.1,1332350,97260,201270.8,555250,49050,132950.3,777100
225580,340052.9,1332350,130900,202033.2,555250,94680,138019.7,777100
226570,324720.4,1332350,131430,193835.1,555250,95140,130885.3,777100
227560,314640.4,1332350,131950,190503.4,555250,95610,124137,777100
228500,292747,1332350,132460,178447.2,555250,96040,114299.8,777100
229440,278589.3,1332350,132970,169861.6,555250,96470,108727.7,777100
230840,255019.2,1332350,133900,156691.9,555250,96940,98327.3,777100
232210,259749,1332350,134810,161429.1,555250,97400,98319.9,777100
233510,260061.7,1332350,135720,162005,555250,97790,98056.7,777100
234910,282308,1332350,136620,174672.7,555250,98290,107635.3,777100
232660,272109.4,1332350,135660,169962.1,555250,97000,102147.3,777100
230320,272461.5,1332350,134660,168713.7,555250,95660,103747.8,777100
228000,269249.8,1332350,133690,166440.6,555250,94310,102809.2,777100
225680,271733.5,1332350,132680,167622.6,555250,93000,104110.9,777100
223280,287740.7,1332350,131660,177609.4,555250,91620,110131.3,777100
220750,283351.8,1332350,130610,172730.2,555250,90140,110621.6,777100
218240,275843.4,1332350,129530,167971.7,555250,88710,107871.7,777100
215810,244695,1332350,128500,148098.4,555250,87310,96596.6,777100
212980,205701.5,1332350,127090,125656.8,555250,85890,80044.7,777100
210360,182222.2,1332350,125700,110427.8,555250,84660,71794.4,777100
207690,149374.8,1332350,124300,92963.9,555250,83390,56410.9,777100
204870,139197.1,1332350,122890,88667.5,555250,81980,50529.6,777100
202500,137562.5,1332350,121330,86730.4,555250,81170,50832.1,777100
200120,132100.1,1332350,119780,83384.4,555250,80340,48715.7,777100
197680,116463.2,1332350,118230,71771.5,555250,79450,44691.7,777100
195280,104473.3,1332350,116680,64030.1,555250,78600,40443.2,777100
191890,89100.4,1332350,114210,55207.1,555250,77680,33893.3,777100
188480,75487.6,1332350,111730,45902.5,555250,76750,29585.1,777100
185190,70034.7,1332350,109280,42196.3,555250,75910,27838.4,777100
181830,70533.1,1332350,106780,42562.3,555250,75050,27970.8,777100
178670,73973.3,1332350,104790,45067.6,555250,73880,28905.7,777100
175620,68671.9,1332350,102800,39224.4,555250,72820,29447.5,777100
172540,58573.1,1332350,100800,31353,555250,71740,27220.1,777100
169480,48710.6,1332350,98800,24774.4,555250,70680,23936.2,777100
164050,45440.1,1332350,96040,22749.4,555250,68010,22690.7,777100
158610,39034.8,1332350,93270,18746.1,555250,65340,20288.7,777100
153210,37180.4,1332350,90540,18177.7,555250,62670,19002.7,777100
147800,38045.3,1332350,87760,19983.8,555250,60040,18061.5,777100
144100,38522,1332350,86500,21134.8,555250,57600,17387.2,777100
140360,40664.6,1332350,85250,23067.5,555250,55110,17597.1,777100
136630,35432.2,1332350,83950,21022.7,555250,52680,14409.5,777100
132860,38526.2,1332350,82710,23959.6,555250,50150,14566.6,777100
128890,46396.9,1332350,81140,30832.1,555250,47750,15564.8,777100
124730,45699.1,1332350,79520,30110,555250,45210,15589.1,777100
120740,41586.7,1332350,77930,27821.5,555250,42810,13765.2,777100
116600,33997,1332350,76340,22367.9,555250,40260,11629.1,777100
114680,30851.4,1332350,75220,19638.3,555250,39460,11213.1,777100
112620,26283.2,1332350,74090,16339.3,555250,38530,9943.9,777100
110680,24545.6,1332350,72980,13576,555250,37700,10969.6,777100
108600,20785.6,1332350,71850,10286.8,555250,36750,10498.8,777100
107290,21391.8,1332350,71150,11849.7,555250,36140,9542.1,777100
106030,18273.3,1332350,70460,9001.4,555250,35570,9271.9,777100
104580,13765,1332350,69730,4515.2,555250,34850,9249.8,777100
103230,15320.2,1332350,69030,6084.4,555250,34200,9235.8,777100
101870,16653.2,1332350,68180,8115.9,555250,33690,8537.3,777100
100630,14539.2,1332350,67320,5856.7,555250,33310,8682.5,777100
99290,19734.4,1332350,66510,10364.3,555250,32780,9370.1,777100
98000,26045.5,1332350,65710,15828.8,555250,32290,10216.7,777100
98040,38522.8,1332350,65990,27010.8,555250,32050,11512,777100
98020,52010.7,1332350,66270,38358.8,555250,31750,13651.9,777100
98070,56913.8,1332350,66610,40898.6,555250,31460,16015.2,777100
98110,50804.9,1332350,66920,35135.2,555250,31190,15669.7,777100
98570,47402.9,1332350,67800,32417.5,555250,30770,14985.4,777100
99050,38044.3,1332350,68720,25601.2,555250,30330,12443.1,777100
99570,31614.8,1332350,69650,20337.7,555250,29920,11277.1,777100
100100,34745,1332350,70570,23581.6,555250,29530,11163.4,777100
102060,48722.7,1332350,72810,34767.5,555250,29250,13955.2,777100
103910,60193.2,1332350,75050,44437,555250,28860,15756.2,777100
105820,61642.3,1332350,77270,45133.3,555250,28550,16509,777100
107710,59067.9,1332350,79500,44782.6,555250,28210,14285.3,777100
109910,75769.9,1332350,80960,59325.7,555250,28950,16444.2,777100
112020,85567.4,1332350,82390,67171.7,555250,29630,18395.7,777100
114190,86462.6,1332350,83820,67998.2,555250,30370,18464.4,777100
116280,93209.5,1332350,85260,73565.4,555250,31020,19644.1,777100
120370,103346.4,1332350,88300,81597.8,555250,32070,21748.6,777100
124390,123847,1332350,91310,95350.3,555250,33080,28496.7,777100
128400,146223.1,1332350,94370,109387.5,555250,34030,36835.6,777100
132450,131885.9,1332350,97400,99675.7,555250,35050,32210.2,777100
133030,132231.6,1332350,97770,98546.5,555250,35260,33685.1,777100
133620,146129.6,1332350,98140,108219.3,555250,35480,37910.3,777100
134150,162880.2,1332350,98500,119531.5,555250,35650,43348.7,777100
134710,154707.9,1332350,98870,114187.2,555250,35840,40520.7,777100
141410,106056.3,1332350,102520,83726.7,555250,38890,22329.6,777100
148150,87613.8,1332350,106160,69600.4,555250,41990,18013.4,777100
154820,91687.1,1332350,109800,73342,555250,45020,18345.1,777100
161500,92552.4,1332350,113460,73316.1,555250,48040,19236.3,777100
167130,106505.1,1332350,115800,84202.7,555250,51330,22302.4,777100
172750,140758.8,1332350,118140,105821.3,555250,54610,34937.5,777100
178470,155394.7,1332350,120510,113231.8,555250,57960,42162.9,777100
184010,124009.1,1332350,122870,90933.7,555250,61140,33075.4,777100
191390,106363,1332350,126260,77521.1,555250,65130,28841.9,777100
198790,100773.9,1332350,129670,72004.7,555250,69120,28769.2,777100
206230,97813.7,1332350,133070,70162.8,555250,73160,27650.9,777100
213600,119232.5,1332350,136470,84931.5,555250,77130,34301,777100
221100,142959.2,1332350,139790,99422.3,555250,81310,43536.9,777100
228490,144150.1,1332350,143100,98616.6,555250,85390,45533.5,777100
235870,154101,1332350,146390,104727.1,555250,89480,49373.9,777100
208590,193102.8,1332350,125590,122169.2,555250,83000,70933.6,777100
216310,193744.1,1332350,129140,118396.8,555250,87170,75347.3,777100
223890,194792.3,1332350,132670,117454.4,555250,91220,77337.9,777100
231640,198551.3,1332350,136200,117410.2,555250,95440,81141.1,777100
239360,191921.2,1332350,139750,111685.8,555250,99610,80235.4,777100
246270,214277,1332350,143330,124347,555250,102940,89930,777100
253200,219124.6,1332350,146930,125672.5,555250,106270,93452.1,777100
260210,227937.7,1332350,150520,129224.2,555250,109690,98713.5,777100
267220,254643.4,1332350,154120,143261.3,555250,113100,111382.1,777100
278920,268972.4,1332350,160690,153859.2,555250,118230,115113.2,777100
290610,289546.3,1332350,167290,167304.2,555250,123320,122242.1,777100
302350,350947.4,1332350,173860,204484,555250,128490,146463.4,777100
314070,366540.9,1332350,180440,215038.1,555250,133630,151502.8,777100
327360,357208.7,1332350,187930,210668,555250,139430,146540.7,777100
340620,359310.7,1332350,195450,210468,555250,145170,148842.7,777100
353850,399520.7,1332350,202930,230966.5,555250,150920,168554.2,777100
367050,403010.3,1332350,210420,232259.5,555250,156630,170750.8,777100
380950,381440.7,1332350,218420,216347.4,555250,162530,165093.3,777100
394910,404595.5,1332350,226440,231009.5,555250,168470,173586,777100
408850,427789.4,1332350,234430,244364,555250,174420,183425.4,777100
422720,460688.2,1332350,242410,269386.5,555250,180310,191301.7,777100
436330,471108.1,1332350,247250,274182.4,555250,189080,196925.7,777100
449850,488798.2,1332350,252060,280941.8,555250,197790,207856.4,777100
463430,529931,1332350,256900,297626.7,555250,206530,232304.3,777100
477030,538135.6,1332350,261730,299045.2,555250,215300,239090.4,777100
493820,523341.3,1332350,269580,293187.9,555250,224240,230153.4,777100
510710,573533.8,1332350,277440,320377.4,555250,233270,253156.4,777100
527510,572222.6,1332350,285300,324109.2,555250,242210,248113.4,777100
544350,577721.8,1332350,293150,329146.2,555250,251200,248575.6,777100
559910,594457.9,1332350,299440,341114.3,555250,260470,253343.6,777100
575510,614026.8,1332350,305760,346706.4,555250,269750,267320.4,777100
591170,639993.3,1332350,312090,358956.5,555250,279080,281036.8,777100
606780,641715.4,1332350,318390,362231.1,555250,288390,279484.3,777100
610200,640623.1,1332350,317380,354130.2,555250,292820,286492.9,777100
613640,649960.4,1332350,316380,357140.5,555250,297260,292819.9,777100
616900,652982.6,1332350,315350,357283.7,555250,301550,295698.9,777100
620330,656960.7,1332350,314320,359875,555250,306010,297085.7,777100
624400,625960.4,1332350,315080,340510.4,555250,309320,285450,777100
628320,604152.7,1332350,315820,325923.2,555250,312500,278229.5,777100
632330,584461.9,1332350,316580,314519.9,555250,315750,269942,777100
636340,594024,1332350,317340,319501.6,555250,319000,274522.4,777100
639560,604988.8,1332350,317660,320807.5,555250,321900,284181.3,777100
642860,624436.2,1332350,317980,336853.4,555250,324880,287582.8,777100
646060,662194.6,1332350,318300,350265.5,555250,327760,311929.1,777100
649250,652508.9,1332350,318610,344468.6,555250,330640,308040.3,777100
657160,658178.6,1332350,317990,348869.3,555250,339170,309309.3,777100
665020,672461.1,1332350,317360,354081.5,555250,347660,318379.6,777100
672920,687282.6,1332350,316750,359157.4,555250,356170,328125.2,777100
680870,710228.5,1332350,316150,371665.4,555250,364720,338563.1,777100
691330,751166.2,1332350,317600,390442.2,555250,373730,360724,777100
701810,788289.7,1332350,319050,405442.1,555250,382760,382847.6,777100
712260,813061.2,1332350,320530,410123.5,555250,391730,402937.7,777100
722720,823895.1,1332350,322000,406727.8,555250,400720,417167.3,777100
730620,838500.6,1332350,321050,410956,555250,409570,427544.6,777100
738490,861796.2,1332350,320120,418139.5,555250,418370,443656.7,777100
746350,848295.8,1332350,319190,406418.7,555250,427160,441877.1,777100
754240,843403.4,1332350,318250,402998.1,555250,435990,440405.3,777100
767180,875045.3,1332350,321610,419264.8,555250,445570,455780.5,777100
780190,867700.2,1332350,324960,417112.6,555250,455230,450587.6,777100
793140,867116.1,1332350,328320,414443,555250,464820,452673.1,777100
806110,873185.7,1332350,331670,413513.1,555250,474440,459672.6,777100
819060,880379.2,1332350,335050,414698.6,555250,484010,465680.6,777100
831950,855044.8,1332350,338410,395176.8,555250,493540,459868,777100
844790,818375.8,1332350,341750,372052.7,555250,503040,446323.1,777100
857690,783505.2,1332350,345120,352748.5,555250,512570,430756.7,777100
869650,753419.3,1332350,347640,328185,555250,522010,425234.3,777100
881680,750999.2,1332350,350110,324234.9,555250,531570,426764.3,777100
893660,730225.6,1332350,352640,305435.6,555250,541020,424790,777100
905610,719284.1,1332350,355140,293597.3,555250,550470,425686.8,777100
895150,715120.6,1332350,349490,284228,555250,545660,430892.6,777100
884590,682085.4,1332350,343800,261421.7,555250,540790,420663.7,777100
874080,673134.4,1332350,338150,251084.4,555250,535930,422050,777100
863530,662676.5,1332350,332480,243402.4,555250,531050,419274.1,777100
852180,657782,1332350,326710,243335.4,555250,525470,414446.6,777100
840780,646313.1,1332350,320950,236961,555250,519830,409352.1,777100
829400,639830.6,1332350,315150,235249,555250,514250,404581.6,777100
817940,631293,1332350,309390,227237.3,555250,508550,404055.7,777100
806320,609714.8,1332350,303870,222009.1,555250,502450,387705.7,777100
794530,574194.8,1332350,298300,210321.7,555250,496230,363873.1,777100
782950,569230,1332350,292790,209152,555250,490160,360078,777100
771190,563554.8,1332350,287240,206885.9,555250,483950,356668.9,777100
749900,496427.5,1332350,279180,174531.8,555250,470720,321895.7,777100
728700,502264.7,1332350,271130,170141.3,555250,457570,332123.4,777100
707420,479796.6,1332350,263080,169016.9,555250,444340,310779.7,777100
686220,459646.2,1332350,255030,155116.5,555250,431190,304529.7,777100
666800,465940.9,1332350,248970,156283.2,555250,417830,309657.7,777100
647340,414299.3,1332350,242910,137201.9,555250,404430,277097.4,777100
627900,401045.8,1332350,236820,131751.8,555250,391080,269294,777100
608510,377606.3,1332350,230770,126675.6,555250,377740,250930.7,777100
586210,386999.7,1332350,221700,133427.7,555250,364510,253572,777100
563920,421171.7,1332350,212620,153123.3,555250,351300,268048.4,777100
541660,441432.4,1332350,203540,166099.6,555250,338120,275332.8,777100
519390,441624.9,1332350,194460,171663.7,555250,324930,269961.2,777100
513980,414382.6,1332350,195980,156293.9,555250,318000,258088.7,777100
508540,379620.3,1332350,197520,139015.3,555250,311020,240605,777100
503180,355594.8,1332350,199010,129063,555250,304170,226531.8,777100
522420,344545.8,1332350,207060,122151.5,555250,315360,222394.3,777100
517480,308805,1332350,207760,107140.3,555250,309720,201664.7,777100
512470,287893.7,1332350,208440,97623.9,555250,304030,190269.8,777100
507470,276815.7,1332350,209130,90864.9,555250,298340,185950.8,777100
502440,275049.3,1332350,209840,88740.2,555250,292600,186309.1,777100
498920,267468.8,1332350,210860,91011.8,555250,288060,176457,777100
495530,274179.6,1332350,211890,99628.4,555250,283640,174551.2,777100
492110,292782.8,1332350,212920,116857.8,555250,279190,175925,777100
488680,270416.7,1332350,213950,111849,555250,274730,158567.7,777100
490290,262137.3,1332350,217560,109430.8,555250,272730,152706.5,777100
491860,277879.3,1332350,221150,120110.1,555250,270710,157769.2,777100
493440,303924.3,1332350,224770,135766.3,555250,268670,168158,777100
495060,332635.6,1332350,228390,159562,555250,266670,173073.6,777100
495170,393319.9,1332350,230630,200610.2,555250,264540,192709.7,777100
495360,436957.5,1332350,232890,231338.5,555250,262470,205619,777100
495520,459035.1,1332350,235160,246700.6,555250,260360,212334.5,777100
495730,422826.8,1332350,237410,225633.9,555250,258320,197192.9,777100
495410,395036.5,1332350,239230,206356.5,555250,256180,188680,777100
495170,386035,1332350,241030,204720,555250,254140,181315,777100
494910,411122.6,1332350,242830,218376.5,555250,252080,192746.1,777100
494590,426783.3,1332350,244620,228481.2,555250,249970,198302.1,777100
493640,407985.5,1332350,245000,215046.2,555250,248640,192939.3,777100
492650,417153.7,1332350,245370,222729.7,555250,247280,194424,777100
491600,406964.6,1332350,245730,221951.1,555250,245870,185013.5,777100
490600,418782.3,1332350,246080,224181.3,555250,244520,194601,777100
487460,385383.3,1332350,245170,206270.3,555250,242290,179113,777100
484320,340378.7,1332350,244260,182929.3,555250,240060,157449.4,777100
481240,295224.9,1332350,243380,154145.8,555250,237860,141079.1,777100
478170,262222.1,1332350,242490,137222,555250,235680,125000.1,777100
477800,244397.1,1332350,243540,124822.1,555250,234260,119575,777100
477410,240048.6,1332350,244600,126341.3,555250,232810,113707.3,777100
477150,243686.4,1332350,245680,134899.4,555250,231470,108787,777100
476870,267017.4,1332350,246760,143440.5,555250,230110,123576.9,777100
479250,293358.3,1332350,247960,155888.2,555250,231290,137470.1,777100
481610,297142.4,1332350,249170,157479.2,555250,232440,139663.2,777100
483980,309660.7,1332350,250360,168525.5,555250,233620,141135.2,777100
486390,312139.7,1332350,251550,168145.4,555250,234840,143994.3,777100
486940,280702,1332350,250740,148001.5,555250,236200,132700.5,777100
487510,242284.8,1332350,249910,127787.7,555250,237600,114497.1,777100
488160,233245.8,1332350,249110,117994,555250,239050,115251.8,777100
488730,221585.1,1332350,248260,110626.5,555250,240470,110958.6,777100
488430,198261.4,1332350,246430,96597.8,555250,242000,101663.6,777100
488250,191309.5,1332350,244630,88238.9,555250,243620,103070.6,777100
487930,185604.8,1332350,242760,85206.4,555250,245170,100398.4,777100
487710,193745.3,1332350,240950,90982.7,555250,246760,102762.6,777100
500940,211255.2,1332350,243030,94367,555250,257910,116888.2,777100
514150,228560.1,1332350,245090,99987.2,555250,269060,128572.9,777100
527390,243050.6,1332350,247180,103649.7,555250,280210,139400.9,777100
540630,246933.7,1332350,249250,105504.6,555250,291380,141429.1,777100
555880,257145.8,1332350,253290,109503.3,555250,302590,147642.5,777100
571010,281314.7,1332350,257320,116801.1,555250,313690,164513.6,777100
586180,288358.2,1332350,261340,120160,555250,324840,168198.2,777100
601350,288614.5,1332350,265380,122530.7,555250,335970,166083.8,777100
614520,288648.3,1332350,268680,115774.2,555250,345840,172874.1,777100
627620,281081.6,1332350,271980,109533,555250,355640,171548.6,777100
640750,314347.7,1332350,275240,119180.4,555250,365510,195167.3,777100
653930,323407.3,1332350,278550,124093.2,555250,375380,199314.1,777100
663950,368256.1,1332350,282570,144641.1,555250,381380,223615,777100
673990,395251.5,1332350,286580,164892.6,555250,387410,230358.9,777100
684080,431373.7,1332350,290590,183047.6,555250,393490,248326.1,777100
694090,451359.1,1332350,294620,190530,555250,399470,260829.1,777100
704460,506117.3,1332350,298180,226208.9,555250,406280,279908.4,777100
714870,521425.7,1332350,301800,227848.3,555250,413070,293577.4,777100
725250,521141.7,1332350,305370,228776.9,555250,419880,292364.8,777100
735640,516481.7,1332350,308980,219806.7,555250,426660,296675,777100
744940,511153.5,1332350,311430,219946,555250,433510,291207.5,777100
754170,501163.3,1332350,313850,215667,555250,440320,285496.3,777100
763390,540586.3,1332350,316300,235673.5,555250,447090,304912.8,777100
772730,575635,1332350,318730,256586,555250,454000,319049,777100
765830,597077.3,1332350,315020,270012.7,555250,450810,327064.6,777100
759000,577078.8,1332350,311340,260347.6,555250,447660,316731.2,777100
752100,562318.5,1332350,307620,249534.5,555250,444480,312784,777100
745300,542020.8,1332350,303930,238869.5,555250,441370,303151.3,777100
738070,516679.4,1332350,300790,220093.7,555250,437280,296585.7,777100
730930,504413.6,1332350,297610,215584.3,555250,433320,288829.3,777100
723690,522227.5,1332350,294440,229689.9,555250,429250,292537.6,777100
716590,505522.8,1332350,291300,221371.9,555250,425290,284150.9,777100
710030,501847.5,1332350,287880,217379.7,555250,422150,284467.8,777100
703430,480338.4,1332350,284410,202228.5,555250,419020,278109.9,777100
696900,452009.6,1332350,280960,182878.2,555250,415940,269131.4,777100
690350,456728.4,1332350,277540,189950,555250,412810,266778.4,777100
671470,423198.4,1332350,267130,170086.7,555250,404340,253111.7,777100
652740,415082.5,1332350,256730,175172.8,555250,396010,239909.7,777100
633970,410310.8,1332350,246340,171327.6,555250,387630,238983.2,777100
615140,405035.4,1332350,235920,166191.1,555250,379220,238844.3,777100
594900,386300.6,1332350,225050,160250.3,555250,369850,226050.3,777100
574660,387677.4,1332350,214170,157647.6,555250,360490,230029.8,777100
554420,367414.5,1332350,203280,145089.9,555250,351140,222324.6,777100
534110,366220.3,1332350,192380,141713.6,555250,341730,224506.7,777100
513990,333127.4,1332350,181930,127620.5,555250,332060,205506.9,777100
493970,313773.2,1332350,171450,115772.9,555250,322520,198000.3,777100
473870,318508.9,1332350,160970,108771,555250,312900,209737.9,777100
453770,301767.9,1332350,150500,101910.5,555250,303270,199857.4,777100
439450,278147.3,1332350,145650,90125.1,555250,293800,188022.2,777100
424990,261103.4,1332350,140790,85569.7,555250,284200,175533.7,777100
410630,234726,1332350,135940,72076,555250,274690,162650,777100
379380,181159.9,1332350,147450,56874.8,555250,231930,124285.1,777100
363010,172819.2,1332350,137830,52398.5,555250,225180,120420.7,777100
346670,170882.2,1332350,128160,53836.7,555250,218510,117045.5,777100
330250,186001.3,1332350,118530,59313.2,555250,211720,126688.1,777100
313890,201623,1332350,108860,64229.7,555250,205030,137393.3,777100
300640,196917.9,1332350,102150,62001.1,555250,198490,134916.8,777100
287510,178796.1,1332350,95450,52135.3,555250,192060,126660.8,777100
274370,165321,1332350,88770,44646.5,555250,185600,120674.5,777100
261090,159557,1332350,82040,36882.9,555250,179050,122674.1,777100
259910,146782.3,1332350,82730,30134.4,555250,177180,116647.9,777100
258700,135871.6,1332350,83440,26379.2,555250,175260,109492.4,777100
257350,127415.4,1332350,84130,24407.7,555250,173220,103007.7,777100
256100,127969.3,1332350,84850,26193.4,555250,171250,101775.9,777100
256220,121291.8,1332350,85770,23703.2,555250,170450,97588.6,777100
256430,126422,1332350,86770,28131.4,555250,169660,98290.6,777100
256590,122554.7,1332350,87730,29321.9,555250,168860,93232.8,777100
256730,125259.8,1332350,88680,30832.7,555250,168050,94427.1,777100
256470,123010.1,1332350,90000,33246,555250,166470,89764.1,777100
256130,121766.8,1332350,91260,32821.7,555250,164870,88945.1,777100
255860,119464.7,1332350,92540,32307.4,555250,163320,87157.3,777100
255650,109794.4,1332350,93850,25832.7,555250,161800,83961.7,777100
252670,103364.5,1332350,92020,23732.7,555250,160650,79631.8,777100
249660,104206.5,1332350,90210,23978.9,555250,159450,80227.6,777100
246730,123214.1,1332350,88360,32961.4,555250,158370,90252.7,777100
243830,129147.4,1332350,86540,38245.7,555250,157290,90901.7,777100
240760,134640.2,1332350,84260,40850.8,555250,156500,93789.4,777100
237760,156200.3,1332350,81990,49261.7,555250,155770,106938.6,777100
234740,179994.5,1332350,79700,58335.3,555250,155040,121659.2,777100
231780,182546.2,1332350,77400,59942.2,555250,154380,122604,777100
228350,154117.1,1332350,74900,46960.9,555250,153450,107156.2,777100
225030,149017.7,1332350,72430,44284,555250,152600,104733.7,777100
221720,135676.5,1332350,69940,39100.9,555250,151780,96575.6,777100
218320,127643.8,1332350,67450,35208.8,555250,150870,92435,777100
219610,131071,1332350,67100,32359.5,555250,152510,98711.5,777100
221020,134279.5,1332350,66770,29296.8,555250,154250,104982.7,777100
222410,126074,1332350,66470,23812,555250,155940,102262,777100
223770,143213.6,1332350,66150,27807.7,555250,157620,115405.9,777100
227790,156405.8,1332350,66310,31559.8,555250,161480,124846,777100
231840,173527.4,1332350,66520,35365.8,555250,165320,138161.6,777100
235790,173400.4,1332350,66670,30470.5,555250,169120,142929.9,777100
239860,191209.8,1332350,66840,32342.9,555250,173020,158866.9,777100
244140,186405.5,1332350,67630,35625,555250,176510,150780.5,777100
248510,194734.9,1332350,68400,36612.7,555250,180110,158122.2,777100
252830,211039.9,1332350,69160,44213.3,555250,183670,166826.6,777100
257090,219461.3,1332350,69900,52578.5,555250,187190,166882.8,777100
262330,209858.1,1332350,71250,51497.9,555250,191080,158360.2,777100
267530,202130.6,1332350,72570,47768.3,555250,194960,154362.3,777100
272750,206194.3,1332350,73930,46516.6,555250,198820,159677.7,777100
277950,200552.6,1332350,75240,44235.4,555250,202710,156317.2,777100
283110,200343,1332350,77150,45299.6,555250,205960,155043.4,777100
288140,205377.4,1332350,79010,47294.2,555250,209130,158083.2,777100
293220,219327.5,1332350,80890,51865.1,555250,212330,167462.4,777100
298220,237398.4,1332350,82780,63065.8,555250,215440,174332.6,777100
303750,234756.4,1332350,84840,64614.3,555250,218910,170142.1,777100
309180,249205.7,1332350,86880,72182.9,555250,222300,177022.8,777100
314620,270475.4,1332350,88940,79292.1,555250,225680,191183.3,777100
320020,274250.4,1332350,90980,82049.9,555250,229040,192200.5,777100
323180,287112.3,1332350,91130,87310.3,555250,232050,199802,777100
326300,300756.5,1332350,91250,94981.5,555250,235050,205775,777100
329460,287733,1332350,91410,86245.6,555250,238050,201487.4,777100
332580,270350.3,1332350,91550,75514.2,555250,241030,194836.1,777100
335410,257495.9,1332350,91360,66123,555250,244050,191372.9,777100
338290,254280.7,1332350,91120,60921,555250,247170,193359.7,777100
341140,249393.3,1332350,90920,61305.6,555250,250220,188087.7,777100
344010,257062.8,1332350,90720,61873.6,555250,253290,195189.2,777100
347220,272220.4,1332350,90740,67157.1,555250,256480,205063.3,777100
350460,285415.1,1332350,90780,73380.5,555250,259680,212034.6,777100
353630,283836.8,1332350,90760,70376.9,555250,262870,213459.9,777100
356800,286342.9,1332350,90810,71717.3,555250,265990,214625.6,777100
355670,293125.7,1332350,92770,77713.9,555250,262900,215411.8,777100
354410,309311.2,1332350,94730,89205.5,555250,259680,220105.7,777100
353220,324417.5,1332350,96710,100626.3,555250,256510,223791.2,777100
351940,316821.5,1332350,98660,97807,555250,253280,219014.5,777100
349920,325226,1332350,100420,104342,555250,249500,220884,777100
347850,335110.2,1332350,102190,109672.2,555250,245660,225438,777100
345730,321608.3,1332350,103950,102379.7,555250,241780,219228.6,777100
343720,322939.2,1332350,105720,103581.1,555250,238000,219358.1,777100
340170,335014.9,1332350,106720,116146.9,555250,233450,218868,777100
336580,361977.8,1332350,107720,134547.2,555250,228860,227430.6,777100
332990,378685.1,1332350,108730,150930.4,555250,224260,227754.7,777100
329390,399250.5,1332350,109720,160844.9,555250,219670,238405.6,777100
323470,415700.4,1332350,109120,175157.8,555250,214350,240542.6,777100
317570,434032.5,1332350,108490,186796.1,555250,209080,247236.4,777100
311620,445351.1,1332350,107860,196863.8,555250,203760,248487.3,777100
305740,460409,1332350,107220,207683.2,555250,198520,252725.8,777100
299990,475106.2,1332350,106400,216867.2,555250,193590,258239,777100
294230,457863.8,1332350,105570,208636,555250,188660,249227.8,777100
288570,441514.1,1332350,104750,203090.9,555250,183820,238423.2,777100
282870,449894.2,1332350,103950,206307.2,555250,178920,243587,777100
277460,420050.3,1332350,103150,191638.8,555250,174310,228411.5,777100
272060,388488.1,1332350,102330,175137,555250,169730,213351.1,777100
266630,363880.3,1332350,101520,166268.1,555250,165110,197612.2,777100
261230,364497.9,1332350,100680,170435.2,555250,160550,194062.7,777100
252520,331828.5,1332350,96490,153026.4,555250,156030,178802.1,777100
243840,333676.6,1332350,92310,155853.4,555250,151530,177823.2,777100
235120,326233.7,1332350,88110,151122.7,555250,147010,175111,777100
259490,299592.1,1332350,112540,145033.7,555250,146950,154558.4,777100
250490,292276.4,1332350,106790,139890.3,555250,143700,152386.1,777100
241430,290719.8,1332350,101030,138017.6,555250,140400,152702.2,777100
232470,300629.8,1332350,95290,141447.4,555250,137180,159182.4,777100
223480,306139.8,1332350,89550,142753.4,555250,133930,163386.4,777100
214510,291581.9,1332350,83790,133850.5,555250,130720,157731.4,777100
205470,267425,1332350,78040,120215.1,555250,127430,147209.9,777100
196390,250252.1,1332350,72240,112081.7,555250,124150,138170.4,777100
187400,250586.5,1332350,66470,111995.1,555250,120930,138591.4,777100
183260,245747.1,1332350,64520,109383.6,555250,118740,136363.5,777100
179120,231419.1,1332350,62590,100705.6,555250,116530,130713.5,777100
174960,221892.5,1332350,60660,92135.1,555250,114300,129757.4,777100
170860,214254.3,1332350,58710,90660.9,555250,112150,123593.4,777100
167180,221098.4,1332350,57230,95209.5,555250,109950,125888.9,777100
163460,225888.5,1332350,55710,99244.6,555250,107750,126643.9,777100
159750,228543.1,1332350,54200,101257.5,555250,105550,127285.6,777100
156140,225094.1,1332350,52710,99032.4,555250,103430,126061.7,777100
152860,212219.4,1332350,51370,91154.6,555250,101490,121064.8,777100
149530,202195.1,1332350,50020,86715.4,555250,99510,115479.7,777100
146320,205034.1,1332350,48680,88129.4,555250,97640,116904.7,777100
143060,198811.8,1332350,47320,85483.6,555250,95740,113328.2,777100
146250,185709.7,1332350,51180,80245.1,555250,95070,105464.6,777100
149470,185133.5,1332350,54990,79886.8,555250,94480,105246.7,777100
152730,186565.1,1332350,58810,84327.8,555250,93920,102237.3,777100
155900,193513.4,1332350,62660,90460.9,555250,93240,103052.5,777100
159790,197017.5,1332350,66630,94112.1,555250,93160,102905.4,777100
163750,212748.5,1332350,70620,105274.4,555250,93130,107474.1,777100
167520,232271.1,1332350,74560,119421.3,555250,92960,112849.8,777100
171330,272631.1,1332350,78540,145419.5,555250,92790,127211.6,777100
175370,287801.9,1332350,83390,156565.6,555250,91980,131236.3,777100
179410,297156.7,1332350,88290,164240,555250,91120,132916.7,777100
183380,282961.8,1332350,93140,160408.2,555250,90240,122553.6,777100
187340,272159,1332350,98000,156859.5,555250,89340,115299.5,777100
194820,277731.3,1332350,101570,158957.4,555250,93250,118773.9,777100
202240,268960.2,1332350,105130,151666.9,555250,97110,117293.3,777100
209680,258630,1332350,108710,143274,555250,100970,115356,777100
217120,289414.3,1332350,112260,156666.4,555250,104860,132747.9,777100
226260,251028.4,1332350,115190,132015.4,555250,111070,119013,777100
235360,237543,1332350,118130,121656.9,555250,117230,115886.1,777100
244480,225902.6,1332350,121040,113507.4,555250,123440,112395.2,777100
253620,223981.5,1332350,123970,110177.2,555250,129650,113804.3,777100
261580,229184.5,1332350,126490,109283.5,555250,135090,119901,777100
269530,240055.1,1332350,129010,113877.7,555250,140520,126177.4,777100
277580,235173.8,1332350,131520,111989.2,555250,146060,123184.6,777100
285440,241725.9,1332350,134040,115003.3,555250,151400,126722.6,777100
290780,259127.5,1332350,136600,127925.1,555250,154180,131202.4,777100
296020,261938.7,1332350,139130,127167.1,555250,156890,134771.6,777100
301350,240086.6,1332350,141690,113832,555250,159660,126254.6,777100
306490,201957.5,1332350,144220,92363.9,555250,162270,109593.6,777100
311890,196629.7,1332350,147160,92744.1,555250,164730,103885.6,777100
317310,202004.4,1332350,150100,94796.1,555250,167210,107208.3,777100
322740,211694.4,1332350,153040,101277.3,555250,169700,110417.1,777100
328110,197001.2,1332350,155990,91695.8,555250,172120,105305.4,777100
334710,212717.2,1332350,159720,100419.8,555250,174990,112297.4,777100
341320,216825.7,1332350,163480,105425.1,555250,177840,111400.6,777100
347970,207401.8,1332350,167240,102038.7,555250,180730,105363.1,777100
354620,198504,1332350,170990,98650.5,555250,183630,99853.5,777100
361380,209249.3,1332350,174430,103181.2,555250,186950,106068.1,777100
368150,230714.3,1332350,177870,115651.5,555250,190280,115062.8,777100
374940,233293,1332350,181310,119751.4,555250,193630,113541.6,777100
381680,253216.7,1332350,184720,130094.3,555250,196960,123122.4,777100
389280,275658.8,1332350,188400,139179,555250,200880,136479.8,777100
396880,293322.6,1332350,192070,149947.7,555250,204810,143374.9,777100
404480,321915.1,1332350,195730,162007.1,555250,208750,159908,777100
412120,341419.8,1332350,199420,174318.5,555250,212700,167101.3,777100
420860,361531.6,1332350,203590,185431.5,555250,217270,176100.1,777100
429630,400430.6,1332350,207770,207086.1,555250,221860,193344.5,777100
438460,412960.7,1332350,211930,213451.8,555250,226530,199508.9,777100
447250,442523.3,1332350,216130,228748.6,555250,231120,213774.7,777100
450270,455883.9,1332350,217110,233230.1,555250,233160,222653.8,777100
453100,489216.7,1332350,218040,244401.4,555250,235060,244815.3,777100
456220,519786.2,1332350,219050,265046.1,555250,237170,254740.1,777100
459200,522812.6,1332350,220040,269859.7,555250,239160,252952.9,777100
462060,517416.9,1332350,221780,267673.3,555250,240280,249743.6,777100
465010,542229.6,1332350,223540,274491.7,555250,241470,267737.9,777100
467950,588651.8,1332350,225300,298683.2,555250,242650,289968.6,777100
470830,586678.9,1332350,227050,302692.7,555250,243780,283986.2,777100
472110,584349.9,1332350,228800,306127,555250,243310,278222.9,777100
473380,573029.2,1332350,230480,299031.7,555250,242900,273997.5,777100
474680,556296,1332350,232230,292353.3,555250,242450,263942.7,777100
475890,517616.5,1332350,233950,271997.1,555250,241940,245619.4,777100
471810,488042.3,1332350,233170,265664.7,555250,238640,222377.6,777100
467670,506121.9,1332350,232370,272274.6,555250,235300,233847.3,777100
463650,455023.4,1332350,231600,247510.2,555250,232050,207513.2,777100
459540,461234.1,1332350,230830,252823.3,555250,228710,208410.8,777100
456190,436649.9,1332350,230370,240272.6,555250,225820,196377.3,777100
452770,424069,1332350,229870,234372.2,555250,222900,189696.8,777100
449390,438647.8,1332350,229400,236793.8,555250,219990,201854,777100
446050,437935.2,1332350,228960,235291.9,555250,217090,202643.3,777100
443090,422266.4,1332350,229390,226006.9,555250,213700,196259.5,777100
440150,398437.4,1332350,229830,211165.3,555250,210320,187272.1,777100
437130,418417.8,1332350,230280,224985.2,555250,206850,193432.6,777100
434220,415192.5,1332350,230720,224511.6,555250,203500,190680.9,777100
423740,413184.2,1332350,225530,223154.4,555250,198210,190029.8,777100
413310,417357.1,1332350,220380,224712.9,555250,192930,192644.2,777100
402860,415075.8,1332350,215210,220304.5,555250,187650,194771.3,777100
424600,430774.3,1332350,228750,232220.2,555250,195850,198554.1,777100
416020,437104.1,1332350,224960,233525.5,555250,191060,203578.6,777100
407560,447498.8,1332350,221190,240262.1,555250,186370,207236.7,777100
398970,463190.2,1332350,217410,249518.9,555250,181560,213671.3,777100
390530,499062.2,1332350,213670,271038.1,555250,176860,228024.1,777100
380950,515795.9,1332350,209010,285793.6,555250,171940,230002.3,777100
371410,462826.8,1332350,204340,258891.5,555250,167070,203935.3,777100
361800,451719.5,1332350,199670,250605.4,555250,162130,201114.1,777100
352180,436800.5,1332350,195030,238766.8,555250,157150,198033.7,777100
343220,398091.3,1332350,191400,219118.9,555250,151820,178972.4,777100
334300,342290.3,1332350,187800,186926.6,555250,146500,155363.7,777100
325210,290412.3,1332350,184170,159651.1,555250,141040,130761.2,777100
316360,244055.8,1332350,180560,136698.6,555250,135800,107357.2,777100
307820,207051.8,1332350,177300,115264.5,555250,130520,91787.3,777100
299300,194138,1332350,174020,111742.1,555250,125280,82395.9,777100
290810,188682.2,1332350,170760,111277.6,555250,120050,77404.6,777100
282260,175113.6,1332350,167480,103830.5,555250,114780,71283.1,777100
275390,176581.4,1332350,165290,106454.5,555250,110100,70126.9,777100
268500,187059.2,1332350,163130,114822.3,555250,105370,72236.9,777100
261510,208290.8,1332350,160930,127664.8,555250,100580,80626,777100
254570,254941.3,1332350,158740,153405.2,555250,95830,101536.1,777100
255310,273266.7,1332350,161150,165273.5,555250,94160,107993.2,777100
256080,294163,1332350,163560,179049.5,555250,92520,115113.5,777100
256910,300206.4,1332350,165970,187609.9,555250,90940,112596.5,777100
257680,297596.3,1332350,168380,187305.7,555250,89300,110290.6,777100
257190,310873.9,1332350,169990,199473.1,555250,87200,111400.8,777100
256630,316464.2,1332350,171550,205917.4,555250,85080,110546.8,777100
256120,292797.7,1332350,173160,196831.8,555250,82960,95965.9,777100
255560,261397.6,1332350,174750,182453.4,555250,80810,78944.2,777100
252840,269190.6,1332350,174310,185374.1,555250,78530,83816.5,777100
249990,267857.4,1332350,173830,184774.3,555250,76160,83083.1,777100
247290,238318.4,1332350,173390,169328.2,555250,73900,68990.2,777100
244470,233696,1332350,172920,168853.6,555250,71550,64842.4,777100
240230,246375.2,1332350,169950,175811.6,555250,70280,70563.6,777100
236100,225632.4,1332350,167010,162322.9,555250,69090,63309.5,777100
231960,244646.3,1332350,164060,169840.5,555250,67900,74805.8,777100
227710,247963.5,1332350,161090,173039.8,555250,66620,74923.7,777100
224420,222637.7,1332350,158710,159302.2,555250,65710,63335.5,777100
221160,231679.4,1332350,156330,161877.1,555250,64830,69802.3,777100
217920,232089.2,1332350,153950,162400.6,555250,63970,69688.6,777100
214690,220814.3,1332350,151590,154773.3,555250,63100,66041,777100
210540,212904.3,1332350,148440,150933.2,555250,62100,61971.1,777100
206450,208474.7,1332350,145310,147560.2,555250,61140,60914.5,777100
202280,222855.3,1332350,142120,154315.1,555250,60160,68540.2,777100
198100,200794.9,1332350,139000,142018.8,555250,59100,58776.1,777100
199980,187921.6,1332350,139260,132713.9,555250,60720,55207.7,777100
201820,192527.6,1332350,139550,135714.2,555250,62270,56813.4,777100
203640,205680.5,1332350,139810,142646.9,555250,63830,63033.6,777100
205450,201381.6,1332350,140070,139719.9,555250,65380,61661.7,777100
208690,191333.8,1332350,140980,134645.2,555250,67710,56688.6,777100
211920,200369.5,1332350,141900,137981.8,555250,70020,62387.7,777100
215210,193431.4,1332350,142800,132644.4,555250,72410,60787,777100
218420,177487.4,1332350,143690,122543.4,555250,74730,54944,777100
222690,163216.1,1332350,145370,114078.7,555250,77320,49137.4,777100
226910,144851.4,1332350,147070,102164.5,555250,79840,42686.9,777100
231080,156256.9,1332350,148760,108122.4,555250,82320,48134.5,777100
235360,145850.1,1332350,150440,98086.1,555250,84920,47764,777100
244550,144466.6,1332350,156100,95179.6,555250,88450,49287,777100
253880,151642.1,1332350,161780,102095.8,555250,92100,49546.3,777100
263140,156772.3,1332350,167440,104594.4,555250,95700,52177.9,777100
272430,175058.9,1332350,173100,115270.4,555250,99330,59788.5,777100
280350,197032.5,1332350,177610,130683.8,555250,102740,66348.7,777100
288370,208603.2,1332350,182090,135731.2,555250,106280,72872,777100
296330,213270.7,1332350,186610,140273,555250,109720,72997.7,777100
304260,230215,1332350,191090,148467.8,555250,113170,81747.2,777100
311230,243488.3,1332350,194770,154920.9,555250,116460,88567.4,777100
318170,267135.1,1332350,198480,169483.7,555250,119690,97651.4,777100
325040,283500.4,1332350,202140,180872.4,555250,122900,102628,777100
331910,293174.8,1332350,205830,184540.4,555250,126080,108634.4,777100
335750,296649.7,1332350,209840,184514.3,555250,125910,112135.4,777100
339560,303777.1,1332350,213860,191787.7,555250,125700,111989.4,777100
343460,318497.7,1332350,217850,201801.4,555250,125610,116696.3,777100
347250,347916.5,1332350,221860,218974,555250,125390,128942.5,777100
349970,379743.6,1332350,225450,244548,555250,124520,135195.6,777100
352670,401133.1,1332350,229050,255805.7,555250,123620,145327.4,777100
355390,384388.9,1332350,232600,245647.8,555250,122790,138741.1,777100
357980,376166.5,1332350,236160,245115.7,555250,121820,131050.8,777100
359240,347353.3,1332350,238990,231142,555250,120250,116211.3,777100
360460,328912.1,1332350,241840,223771.6,555250,118620,105140.5,777100
361600,326145.2,1332350,244660,228548.1,555250,116940,97597.1,777100
362780,316881.6,1332350,247470,226210.8,555250,115310,90670.8,777100
367130,324863.7,1332350,248550,230635.6,555250,118580,94228.1,777100
371420,352516.6,1332350,249610,246578.7,555250,121810,105937.9,777100
375670,370796.9,1332350,250680,253241.9,555250,124990,117555,777100
379990,403527.9,1332350,251750,273569.2,555250,128240,129958.7,777100
382410,429458.8,1332350,251640,287624.7,555250,130770,141834.1,777100
384790,433361.8,1332350,251540,291191.8,555250,133250,142170,777100
387140,435061.3,1332350,251430,290908.8,555250,135710,144152.5,777100
389590,418195,1332350,251340,278258.6,555250,138250,139936.4,777100
390700,421736,1332350,250350,278190.4,555250,140350,143545.6,777100
391690,411115.8,1332350,249340,269895.5,555250,142350,141220.3,777100
392730,398765.2,1332350,248360,261590.5,555250,144370,137174.7,777100
393780,369699.8,1332350,247360,244378.8,555250,146420,125321,777100
387610,326113.5,1332350,242060,215281.7,555250,145550,110831.8,777100
381480,302400.5,1332350,236790,201418.2,555250,144690,100982.3,777100
375360,281710.7,1332350,231500,186717.8,555250,143860,94992.9,777100
316770,275441.2,1332350,209260,186913.4,555250,107510,88527.8,777100
310250,280395.6,1332350,203420,187243.4,555250,106830,93152.2,777100
303810,276358.6,1332350,197620,182783,555250,106190,93575.6,777100
297280,259745.8,1332350,191790,167053,555250,105490,92692.8,777100
290750,251588.3,1332350,185990,160251.8,555250,104760,91336.5,777100
284860,253477.3,1332350,180700,157710.2,555250,104160,95767.1,777100
278900,240671.7,1332350,175390,146895.5,555250,103510,93776.2,777100
273040,239803.2,1332350,170110,142684.7,555250,102930,97118.5,777100
267120,236401.7,1332350,164800,139970.8,555250,102320,96430.9,777100
259720,218868.7,1332350,159700,128992.7,555250,100020,89876,777100
252420,219186.7,1332350,154610,128653.8,555250,97810,90532.9,777100
245020,231079.6,1332350,149500,134734,555250,95520,96345.6,777100
237690,230763.5,1332350,144420,137247.9,555250,93270,93515.6,777100
231230,236923.9,1332350,140060,140138.2,555250,91170,96785.7,777100
224750,232330.1,1332350,135680,139026.8,555250,89070,93303.3,777100
218300,215060.3,1332350,131320,128100.5,555250,86980,86959.8,777100
211740,208596.6,1332350,126960,128204,555250,84780,80392.6,777100
204470,205477.8,1332350,121840,127053.9,555250,82630,78423.9,777100
197170,190652.6,1332350,116720,118220.5,555250,80450,72432.1,777100
189850,195547.3,1332350,111580,121259.8,555250,78270,74287.5,777100
182530,197203.1,1332350,106460,120750.5,555250,76070,76452.6,777100
175590,190868.2,1332350,103030,116362.8,555250,72560,74505.4,777100
168650,183852.1,1332350,99610,111357.3,555250,69040,72494.8,777100
161730,184589.5,1332350,96170,113268.6,555250,65560,71320.9,777100
154780,181976.5,1332350,92760,112404.4,555250,62020,69572.1,777100
148180,181726.6,1332350,89580,113004.5,555250,58600,68722.1,777100
141500,182104.4,1332350,86380,113823.3,555250,55120,68281.1,777100
134860,171202.1,1332350,83200,107896.4,555250,51660,63305.7,777100
128180,165059.7,1332350,80030,103607.2,555250,48150,61452.5,777100
121970,169631.5,1332350,77400,106898.9,555250,44570,62732.6,777100
115740,179965.9,1332350,74800,113450.3,555250,40940,66515.6,777100
109460,170942.3,1332350,72170,110433.1,555250,37290,60509.2,777100
103280,169066.1,1332350,69580,111209.3,555250,33700,57856.8,777100
100950,157795.2,1332350,68750,107720.4,555250,32200,50074.8,777100
98670,153037.4,1332350,67950,107270.2,555250,30720,45767.2,777100
96370,153406.8,1332350,67140,108299.1,555250,29230,45107.7,777100
94040,154238.5,1332350,66340,108826.5,555250,27700,45412,777100
92420,148474.4,1332350,65440,105428.7,555250,26980,43045.7,777100
90700,155491.2,1332350,64510,108424.7,555250,26190,47066.5,777100
88960,169157.1,1332350,63620,114923.8,555250,25340,54233.3,777100
87310,189494.2,1332350,62710,125608.8,555250,24600,63885.4,777100
87810,198543.5,1332350,63350,128644.6,555250,24460,69898.9,777100
88350,190855.2,1332350,64000,126536.2,555250,24350,64319,777100
88930,184727.4,1332350,64660,123543.9,555250,24270,61183.5,777100
89490,168231,1332350,65310,114619.6,555250,24180,53611.4,777100
92620,182525.3,1332350,67070,123075.2,555250,25550,59450.1,777100
95710,168440.6,1332350,68830,114582.9,555250,26880,53857.7,777100
98840,147653.8,1332350,70590,102001.7,555250,28250,45652.1,777100
101910,132518.9,1332350,72370,92247.8,555250,29540,40271.1,777100
104300,116360.4,1332350,73830,82618,555250,30470,33742.4,777100
106790,115335.3,1332350,75340,81281.8,555250,31450,34053.5,777100
109250,112786.3,1332350,76810,78773.9,555250,32440,34012.4,777100
111700,110818,1332350,78270,78026.7,555250,33430,32791.3,777100
114640,99366.7,1332350,80980,73029.4,555250,33660,26337.3,777100
117620,94109.5,1332350,83700,70386.6,555250,33920,23722.9,777100
120540,97376.2,1332350,86390,73240.7,555250,34150,24135.5,777100
123570,102008.4,1332350,89130,75564,555250,34440,26444.4,777100
131500,99369.6,1332350,96740,78386.8,555250,34760,20982.8,777100
139450,101154.1,1332350,104360,82689.9,555250,35090,18464.2,777100
147360,105572,1332350,111990,86705.3,555250,35370,18866.7,777100
155310,113519.9,1332350,119630,95386.5,555250,35680,18133.4,777100
162970,118826.1,1332350,126800,102586,555250,36170,16240.1,777100
170590,124653.5,1332350,134010,105461.4,555250,36580,19192.1,777100
178270,134601.5,1332350,141190,114873.1,555250,37080,19728.4,777100
185910,132696.1,1332350,148410,114215.4,555250,37500,18480.7,777100
193960,144948.5,1332350,155900,123216.8,555250,38060,21731.7,777100
201930,145362.8,1332350,163380,125894.8,555250,38550,19468,777100
210020,147466.1,1332350,170920,129050.8,555250,39100,18415.3,777100
218050,166110.7,1332350,178460,142691.7,555250,39590,23419,777100
223660,172546.7,1332350,180940,147161.2,555250,42720,25385.5,777100
229330,173881,1332350,183480,148717.9,555250,45850,25163.1,777100
234990,163860.7,1332350,185980,141020.1,555250,49010,22840.6,777100
240640,168624.1,1332350,188470,144223.4,555250,52170,24400.7,777100
246270,171505.6,1332350,191180,145996.4,555250,55090,25509.2,777100
251860,185517.7,1332350,193910,154157.9,555250,57950,31359.8,777100
257500,213863.6,1332350,196600,174084.2,555250,60900,39779.4,777100
263140,217667.1,1332350,199300,175177.5,555250,63840,42489.6,777100
268850,207511,1332350,201860,168421.7,555250,66990,39089.3,777100
274530,212542.3,1332350,204430,171951.2,555250,70100,40591.1,777100
280290,207329.6,1332350,207010,167369.7,555250,73280,39959.9,777100
286000,220689.5,1332350,209610,175691,555250,76390,44998.5,777100
294290,209644.2,1332350,213100,168527.7,555250,81190,41116.5,777100
302530,224792.8,1332350,216590,178088.4,555250,85940,46704.4,777100
310740,240176.7,1332350,220100,186363.2,555250,90640,53813.5,777100
318980,236488,1332350,223610,184690.4,555250,95370,51797.6,777100
326170,261221.6,1332350,226830,199399,555250,99340,61822.6,777100
333310,283090.3,1332350,230080,211812.8,555250,103230,71277.5,777100
340580,279090.1,1332350,233300,206771.4,555250,107280,72318.7,777100
347690,278235.1,1332350,236520,203032.6,555250,111170,75202.5,777100
353730,314745.5,1332350,238880,221857.7,555250,114850,92887.8,777100
359830,316305.2,1332350,241190,220529.9,555250,118640,95775.3,777100
365800,318301.8,1332350,243510,222042.4,555250,122290,96259.4,777100
371960,194537.7,1332350,245880,164036.7,555250,126080,30501,777100
370150,352720,1332350,245020,240890.2,555250,125130,111829.8,777100
368390,368126.9,1332350,244180,245806,555250,124210,122320.9,777100
366700,375914.3,1332350,243360,248926.3,555250,123340,126988,777100
366840,399667.4,1332350,230070,255961.4,555250,136770,143706,777100
366800,387408.8,1332350,231500,251049.2,555250,135300,136359.6,777100
366690,365818.1,1332350,232920,240471.5,555250,133770,125346.6,777100
366640,327840.8,1332350,234330,222028.1,555250,132310,105812.7,777100
366570,297887.4,1332350,235750,204752.7,555250,130820,93134.7,777100
367270,262483.2,1332350,237240,185030,555250,130030,77453.2,777100
367950,233937.2,1332350,238760,169911.1,555250,129190,64026.1,777100
368640,213407.5,1332350,240260,158815.4,555250,128380,54592.1,777100
369380,189502.1,1332350,241800,141875.5,555250,127580,47626.6,777100
363760,197802.9,1332350,237330,145536.9,555250,126430,52266,777100
358290,200666.5,1332350,232890,146717.1,555250,125400,53949.4,777100
352660,204836.2,1332350,228410,145639.2,555250,124250,59197,777100
347170,208375.9,1332350,223980,146543.4,555250,123190,61832.5,777100
341250,219261.2,1332350,219790,153899,555250,121460,65362.2,777100
335380,226413.2,1332350,215590,158929.8,555250,119790,67483.4,777100
329430,242198.1,1332350,211390,166845.4,555250,118040,75352.7,777100
323450,251993.2,1332350,207210,171601.2,555250,116240,80392,777100
315800,254611.4,1332350,202000,172305.9,555250,113800,82305.5,777100
308150,273204.6,1332350,196830,181604.4,555250,111320,91600.2,777100
300450,284420.8,1332350,191640,185646,555250,108810,98774.8,777100
292870,282744.7,1332350,186450,182983.9,555250,106420,99760.8,777100
285990,294479.5,1332350,183720,192590.2,555250,102270,101889.3,777100
279150,317193.3,1332350,180960,209165.9,555250,98190,108027.4,777100
272320,328856.8,1332350,178200,219509,555250,94120,109347.8,777100
265440,318061.6,1332350,175450,214852.5,555250,89990,103209.1,777100
259220,301043.5,1332350,173080,205010.4,555250,86140,96033.1,777100
252920,311440.2,1332350,170740,212512.9,555250,82180,98927.3,777100
246670,304345.1,1332350,168380,208772.9,555250,78290,95572.2,777100
240440,303791.3,1332350,166060,207311.4,555250,74380,96479.9,777100
234200,298437.3,1332350,163590,205859.4,555250,70610,92577.9,777100
227940,286930.9,1332350,161110,200142.4,555250,66830,86788.5,777100
221700,282796,1332350,158650,201191,555250,63050,81605,777100
215420,285077.8,1332350,156160,205007,555250,59260,80070.8,777100
212330,277298.1,1332350,155790,202983.2,555250,56540,74314.9,777100
209110,281116.6,1332350,155420,206679.4,555250,53690,74437.2,777100
206060,286122.3,1332350,155050,214004.2,555250,51010,72118.1,777100
202920,280913.6,1332350,154680,212709.1,555250,48240,68204.5,777100
200760,281871.5,1332350,154790,215400.6,555250,45970,66470.9,777100
198570,289530.2,1332350,154860,220807,555250,43710,68723.2,777100
196380,119779.5,1332350,154970,117091.3,555250,41410,2688.2,777100
194190,290575.4,1332350,155050,222652.9,555250,39140,67922.5,777100
194270,284879.7,1332350,156540,218956.3,555250,37730,65923.4,777100
194410,279046.5,1332350,158060,215531.3,555250,36350,63515.2,777100
194520,282354.9,1332350,159590,217200.9,555250,34930,65154,777100
194630,277371.1,1332350,161100,213548.2,555250,33530,63822.9,777100
200550,296906.2,1332350,165510,225831.7,555250,35040,71074.5,777100
206480,300631.2,1332350,169930,228727.1,555250,36550,71904.1,777100
212380,298760.7,1332350,174350,228095.1,555250,38030,70665.6,777100
218270,309148.8,1332350,178760,235630.3,555250,39510,73518.5,777100
224090,298205.6,1332350,183020,231227,555250,41070,66978.6,777100
229890,291289.9,1332350,187360,226460.3,555250,42530,64829.6,777100
235780,286616.5,1332350,191660,225453.1,555250,44120,61163.4,777100
241500,284813.4,1332350,195960,226210.5,555250,45540,58602.9,777100
245920,263653.8,1332350,199130,213814.1,555250,46790,49839.7,777100
250130,253960.1,1332350,202280,209996.5,555250,47850,43963.6,777100
254560,239421.1,1332350,205460,201251.7,555250,49100,38169.4,777100
258830,241620.7,1332350,208650,202672,555250,50180,38948.7,777100
259880,238745.5,1332350,210250,201378,555250,49630,37367.5,777100
261020,244308.5,1332350,211920,204193.7,555250,49100,40114.8,777100
262070,263315.2,1332350,213550,217337.7,555250,48520,45977.5,777100
263130,284956.2,1332350,215170,230601,555250,47960,54355.2,777100
265000,279793.1,1332350,217540,228080.7,555250,47460,51712.4,777100
266860,285948.5,1332350,219870,232530.8,555250,46990,53417.7,777100
268690,294500.2,1332350,222210,238414.2,555250,46480,56086,777100
270480,305837.5,1332350,224550,245963.2,555250,45930,59874.3,777100
272570,321819.6,1332350,226720,256927.2,555250,45850,64892.4,777100
274530,378165.7,1332350,228870,291270.3,555250,45660,86895.4,777100
276480,400216.7,1332350,231040,305477.5,555250,45440,94739.2,777100
278500,426220.4,1332350,233200,319331.7,555250,45300,106888.7,777100
285430,446764.9,1332350,236960,330969.7,555250,48470,115795.2,777100
292380,457371.9,1332350,240660,338112.2,555250,51720,119259.7,777100
299340,472162,1332350,244400,346618,555250,54940,125544,777100
306330,499980,1332350,248130,362585,555250,58200,137395,777100
313370,508731.5,1332350,251540,366825.8,555250,61830,141905.7,777100
320430,518008.6,1332350,254950,372708.3,555250,65480,145300.3,777100
327440,551208.7,1332350,258330,391132.2,555250,69110,160076.5,777100
334530,565546.5,1332350,261770,397716.6,555250,72760,167829.9,777100
342330,581353.5,1332350,265340,404288.1,555250,76990,177065.4,777100
350100,579376.1,1332350,268900,406421.5,555250,81200,172954.6,777100
357850,587529.2,1332350,272480,409914.7,555250,85370,177614.5,777100
365600,600310.3,1332350,276040,414898.3,555250,89560,185412,777100
376300,612298.2,1332350,280220,418077.7,555250,96080,194220.5,777100
386910,615323.5,1332350,284410,420532.8,555250,102500,194790.7,777100
397540,624152.3,1332350,288590,425884.4,555250,108950,198267.9,777100
408160,623219.7,1332350,292760,426495.3,555250,115400,196724.4,777100
417310,617880.6,1332350,296900,422841.1,555250,120410,195039.5,777100
426540,607965.3,1332350,301090,415315.8,555250,125450,192649.5,777100
435850,597674.7,1332350,305280,405615.8,555250,130570,192058.9,777100
445030,590273.5,1332350,309410,399557.5,555250,135620,190716,777100
454160,583632.6,1332350,313630,394457,555250,140530,189175.6,777100
463310,573282.4,1332350,317840,387441.1,555250,145470,185841.3,777100
472330,554848.2,1332350,322070,380025.5,555250,150260,174822.7,777100
481420,538345.1,1332350,326270,369869.1,555250,155150,168476,777100
476360,535433.5,1332350,322480,367184.1,555250,153880,168249.4,777100
471190,529128.1,1332350,318710,365557.1,555250,152480,163571,777100
466130,508542.1,1332350,314930,355909.6,555250,151200,152632.5,777100
403830,497041.9,1332350,275280,343413.9,555250,128550,153628,777100
397740,468940.5,1332350,271990,325918.6,555250,125750,143021.9,777100
391610,437678.1,1332350,268660,304763.5,555250,122950,132914.6,777100
385560,435683.3,1332350,265400,300181.1,555250,120160,135502.2,777100
379520,427472.1,1332350,262100,296292.3,555250,117420,131179.8,777100
373460,432773.5,1332350,258560,300716.3,555250,114900,132057.2,777100
367400,434977.6,1332350,255010,304462.3,555250,112390,130515.3,777100
361340,420309.3,1332350,251420,297385.2,555250,109920,122924.1,777100
355320,388950.1,1332350,247890,281070.6,555250,107430,107879.5,777100
348740,348875.5,1332350,244830,258943.3,555250,103910,89932.2,777100
342140,332498.3,1332350,241740,249783,555250,100400,82715.3,777100
335670,341746,1332350,238690,257067.8,555250,96980,84678.2,777100
329090,337468.6,1332350,235600,254307.9,555250,93490,83160.7,777100
321970,300340.6,1332350,232320,232212,555250,89650,68128.6,777100
314850,291367,1332350,229040,227471,555250,85810,63896,777100
307770,299377.5,1332350,225760,232151.9,555250,82010,67225.6,777100
300620,283414.8,1332350,222460,221761.1,555250,78160,61653.7,777100
294560,261099.9,1332350,219960,208119.1,555250,74600,52980.8,777100
288440,268055.3,1332350,217410,213437.8,555250,71030,54617.5,777100
282360,280547.4,1332350,214900,221869.6,555250,67460,58677.8,777100
276310,260432.9,1332350,212390,210117.1,555250,63920,50315.8,777100
270510,253606.9,1332350,209280,203847.8,555250,61230,49759.1,777100
264660,236177.9,1332350,206160,193014.1,555250,58500,43163.8,777100
258750,236982.2,1332350,203030,191682.3,555250,55720,45299.9,777100
252980,251007.6,1332350,199950,199680.3,555250,53030,51327.3,777100
247910,256568.5,1332350,197090,201621.5,555250,50820,54947,777100
242840,244152.4,1332350,194230,194539.1,555250,48610,49613.3,777100
237860,260893.8,1332350,191410,205373.9,555250,46450,55519.9,777100
232770,259898,1332350,188560,204184.8,555250,44210,55713.2,777100
228680,262890.2,1332350,186210,205512.6,555250,42470,57377.6,777100
224610,263931.6,1332350,183850,206463.8,555250,40760,57467.8,777100
220500,262982.9,1332350,181470,207182.8,555250,39030,55800.1,777100
216400,263599.7,1332350,179150,208091.8,555250,37250,55507.9,777100
216340,253598.9,1332350,179840,204341.1,555250,36500,49257.8,777100
216180,256746.1,1332350,180510,209320,555250,35670,47426.1,777100
215990,269859.5,1332350,181220,219975.4,555250,34770,49884.1,777100
215910,266112.9,1332350,181890,219307.6,555250,34020,46805.3,777100
215900,261050.1,1332350,182570,217104.9,555250,33330,43945.2,777100
215910,272113,1332350,183270,223144,555250,32640,48969,777100
215930,268480.1,1332350,183950,220888.6,555250,31980,47591.5,777100
215910,272715.1,1332350,184630,222108.4,555250,31280,50606.7,777100
217140,301978.3,1332350,185370,238141.3,555250,31770,63837,777100
218380,301192.5,1332350,186060,236364.3,555250,32320,64828.2,777100
219750,293006.6,1332350,186810,228921.1,555250,32940,64085.5,777100
221010,295060.3,1332350,187550,232505.9,555250,33460,62554.4,777100
225380,298945.9,1332350,190050,234737.4,555250,35330,64208.5,777100
229720,299623.2,1332350,192540,234631,555250,37180,64992.2,777100
234000,299053.9,1332350,195080,233828.9,555250,38920,65225,777100
238310,306415.6,1332350,197570,238458.2,555250,40740,67957.4,777100
243160,301730.6,1332350,200480,236014.7,555250,42680,65715.9,777100
248000,336517.8,1332350,203390,257875.7,555250,44610,78642.1,777100
252840,371774.1,1332350,206290,278145,555250,46550,93629.1,777100
257660,368959.2,1332350,209210,274578.5,555250,48450,94380.7,777100
261590,351475.3,1332350,211850,265546,555250,49740,85929.3,777100
265520,334759,1332350,214490,254095.2,555250,51030,80663.8,777100
269510,335724.5,1332350,217120,255483.9,555250,52390,80240.6,777100
273400,328343.7,1332350,219760,252040.4,555250,53640,76303.3,777100
280450,327645.7,1332350,224270,250839.3,555250,56180,76806.4,777100
287490,322165.5,1332350,228720,250543.1,555250,58770,71622.4,777100
294550,319832.5,1332350,233220,249533.8,555250,61330,70298.7,777100
301620,329376.2,1332350,237710,253870.2,555250,63910,75506,777100
308770,324021.9,1332350,242350,250621,555250,66420,73400.9,777100
315910,308495,1332350,247000,240937.9,555250,68910,67557.1,777100
323080,298655.6,1332350,251630,237450.5,555250,71450,61205.1,777100
330260,317017.6,1332350,256300,246690.3,555250,73960,70327.3,777100
337360,363671.1,1332350,260610,276209.9,555250,76750,87461.2,777100
344470,378832.4,1332350,264920,285749.4,555250,79550,93083,777100
351600,414919.9,1332350,269260,307064.9,555250,82340,107855,777100
358730,381332,1332350,273580,284543.7,555250,85150,96788.3,777100
367100,391943.5,1332350,278520,289384.9,555250,88580,102558.6,777100
375580,395119.5,1332350,283480,289793.9,555250,92100,105325.6,777100
384000,382108.5,1332350,288410,283784.3,555250,95590,98324.2,777100
392540,393710.9,1332350,293390,289213.7,555250,99150,104497.2,777100
401100,412695.2,1332350,298460,301895.8,555250,102640,110799.4,777100
409880,424654.7,1332350,303550,311133.2,555250,106330,113521.5,777100
418540,438607.6,1332350,308620,320625,555250,109920,117982.6,777100
427260,457536.3,1332350,313720,335581.3,555250,113540,121955,777100
435930,492823,1332350,318350,356163,555250,117580,136660,777100
444570,510441.3,1332350,322960,369529.4,555250,121610,140911.9,777100
453310,502831.8,1332350,327590,366754.4,555250,125720,136077.4,777100
462010,493705,1332350,332220,362562.5,555250,129790,131142.5,777100
471950,510606.4,1332350,334340,372655.1,555250,137610,137951.3,777100
481770,524900.6,1332350,336450,381147.1,555250,145320,143753.5,777100
491710,567290.6,1332350,338560,407948,555250,153150,159342.6,777100
501590,588989.9,1332350,340680,420222.2,555250,160910,168767.7,777100
510480,616335.3,1332350,342140,433652,555250,168340,182683.3,777100
519400,648575.7,1332350,343610,448235.4,555250,175790,200340.3,777100
528320,670572.3,1332350,345070,454082.4,555250,183250,216489.9,777100
537190,678495.5,1332350,346550,454435.2,555250,190640,224060.3,777100
545050,681989.8,1332350,348180,455947.1,555250,196870,226042.7,777100
552850,681312.4,1332350,349790,453815,555250,203060,227497.4,777100
560710,684798.4,1332350,351410,454324.4,555250,209300,230474,777100
568510,677705.5,1332350,353000,448227.9,555250,215510,229477.6,777100
564390,682166.9,1332350,350830,446319,555250,213560,235847.9,777100
560290,682328.1,1332350,348640,443140.1,555250,211650,239188,777100
556180,669616.6,1332350,346470,436257.8,555250,209710,233358.8,777100
497030,638900,1332350,326470,420835.7,555250,170560,218064.3,777100
493560,629140.4,1332350,324970,411178.7,555250,168590,217961.7,777100
490090,614486.4,1332350,323470,399630.9,555250,166620,214855.5,777100
486620,594393.4,1332350,321940,386520.4,555250,164680,207873,777100
483110,548810.6,1332350,320490,362080,555250,162620,186730.6,777100
478820,540659.4,1332350,317800,355031.6,555250,161020,185627.8,777100
474480,555346.3,1332350,315090,361912.1,555250,159390,193434.2,777100
470180,578393.9,1332350,312410,371921.5,555250,157770,206472.4,777100
465840,566808.6,1332350,309700,364826.6,555250,156140,201982,777100
462370,550545.3,1332350,307780,357593.2,555250,154590,192952.1,777100
458880,550912.8,1332350,305920,362897.9,555250,152960,188014.9,777100
455410,579909.7,1332350,304040,385179.1,555250,151370,194730.6,777100
451940,602369.1,1332350,302130,402860.4,555250,149810,199508.7,777100
450600,597915.2,1332350,302270,405148.8,555250,148330,192766.4,777100
449120,592304.6,1332350,302380,403757.3,555250,146740,188547.3,777100
447690,583000.9,1332350,302500,399310.5,555250,145190,183690.4,777100
446180,565462.5,1332350,302640,389252.3,555250,143540,176210.2,777100
444040,564747.7,1332350,301890,389663.5,555250,142150,175084.2,777100
441900,532642.3,1332350,301170,372895.1,555250,140730,159747.2,777100
439770,535090.3,1332350,300460,374501,555250,139310,160589.3,777100
437610,556470.3,1332350,299740,387666.3,555250,137870,168804,777100
432590,547378.8,1332350,298050,382722.7,555250,134540,164656.1,777100
427540,532757.8,1332350,296400,373721.5,555250,131140,159036.3,777100
422520,535134.7,1332350,294740,376545,555250,127780,158589.7,777100
417510,546506.8,1332350,293080,381871.8,555250,124430,164635,777100
411560,533562.1,1332350,290620,375459.9,555250,120940,158102.2,777100
405600,536837.9,1332350,288180,379993.7,555250,117420,156844.2,777100
399700,496520.8,1332350,285750,359175.3,555250,113950,137345.5,777100
393750,502884.3,1332350,283320,363639.9,555250,110430,139244.4,777100
388010,496726.5,1332350,281410,361669,555250,106600,135057.5,777100
382220,518390.1,1332350,279490,376600,555250,102730,141790.1,777100
376500,529861.9,1332350,277570,384365.6,555250,98930,145496.3,777100
370790,545553.9,1332350,275680,394148.7,555250,95110,151405.2,777100
371310,534780,1332350,276110,387882.2,555250,95200,146897.8,777100
371810,557886.2,1332350,276540,400890.9,555250,95270,156995.3,777100
372340,565833.3,1332350,276990,406796.3,555250,95350,159037,777100
372850,569443.2,1332350,277420,410283.9,555250,95430,159159.3,777100
372980,560170.6,1332350,277470,405615.1,555250,95510,154555.5,777100
373130,560827.9,1332350,277500,405117.2,555250,95630,155710.7,777100
373250,566689.7,1332350,277520,409415.7,555250,95730,157274,777100
373270,562355.7,1332350,277560,406570.2,555250,95710,155785.5,777100
373450,550018.3,1332350,277670,399363.1,555250,95780,150655.2,777100
373550,549384.8,1332350,277750,397848.6,555250,95800,151536.2,777100
373640,545629.8,1332350,277830,395087.3,555250,95810,150542.5,777100
373770,556097,1332350,277950,398751.9,555250,95820,157345.1,777100
380030,559726.4,1332350,279730,401349.2,555250,100300,158377.2,777100
386210,575331.1,1332350,281500,405888.1,555250,104710,169443,777100
392520,567440.8,1332350,283280,400119.3,555250,109240,167321.5,777100
398740,570224.5,1332350,285060,400655.3,555250,113680,169569.2,777100
403500,574951.4,1332350,285760,400206.7,555250,117740,174744.7,777100
408310,601956,1332350,286500,414709.9,555250,121810,187246.1,777100
413070,597552,1332350,287200,410393.9,555250,125870,187158.1,777100
417810,622831.7,1332350,287920,424381.5,555250,129890,198450.2,777100
422850,626571.1,1332350,289190,425767.9,555250,133660,200803.2,777100
427960,614618.5,1332350,290480,415154.8,555250,137480,199463.7,777100
432990,629062,1332350,291760,420788.6,555250,141230,208273.4,777100
438060,633071.2,1332350,293040,421869.9,555250,145020,211201.3,777100
445610,615246.7,1332350,296760,412401.5,555250,148850,202845.2,777100
453200,604594,1332350,300510,405579.2,555250,152690,199014.8,777100
460770,585439.1,1332350,304220,389787.5,555250,156550,195651.6,777100
468330,590772.8,1332350,307930,391626.5,555250,160400,199146.3,777100
475930,600443.9,1332350,311790,398780.1,555250,164140,201663.8,777100
483510,620363.2,1332350,315660,406814.5,555250,167850,213548.7,777100
491150,644124.7,1332350,319520,420483.5,555250,171630,223641.2,777100
498780,665764.4,1332350,323390,431456.5,555250,175390,234307.9,777100
507100,645045.2,1332350,327690,421708.9,555250,179410,223336.3,777100
515350,638521.5,1332350,331980,417172.4,555250,183370,221349.1,777100
523730,652901.9,1332350,336300,423562.9,555250,187430,229339,777100
532000,666807,1332350,340590,430743.1,555250,191410,236063.9,777100
537300,670478.8,1332350,342170,430692.1,555250,195130,239786.7,777100
542700,666277.5,1332350,343770,426337.9,555250,198930,239939.6,777100
548080,668771.4,1332350,345360,430308.5,555250,202720,238462.9,777100
553400,648393.2,1332350,346930,423336.2,555250,206470,225057,777100
558910,671823.8,1332350,348360,435213.8,555250,210550,236610,777100
564470,684288.2,1332350,349790,440630.6,555250,214680,243657.6,777100
570050,692038,1332350,351230,444611.5,555250,218820,247426.5,777100
575530,685824.3,1332350,352630,438709.2,555250,222900,247115.1,777100
581730,693193.7,1332350,356410,441478.1,555250,225320,251715.6,777100
588040,695643.8,1332350,360150,445934.9,555250,227890,249708.9,777100
594250,702536.5,1332350,363920,448725.5,555250,230330,253811,777100
600440,707226.8,1332350,367700,452587.2,555250,232740,254639.6,777100
605180,721434.7,1332350,368590,455316.3,555250,236590,266118.4,777100
609920,727755.4,1332350,369470,457794.7,555250,240450,269960.7,777100
614610,747166.2,1332350,370350,467005.9,555250,244260,280160.3,777100
619300,753164.1,1332350,371240,471384.4,555250,248060,281779.7,777100
623790,754184.6,1332350,371210,476656.7,555250,252580,277527.9,777100
628280,754301.3,1332350,371230,475616.3,555250,257050,278685,777100
632770,743131.2,1332350,371200,470185.9,555250,261570,272945.3,777100
637260,742271.1,1332350,371210,469443.8,555250,266050,272827.3,777100
641460,749689.8,1332350,370040,472142,555250,271420,277547.8,777100
645610,768939.3,1332350,368890,477403.6,555250,276720,291535.7,777100
649840,774129.2,1332350,367710,472536.6,555250,282130,301592.6,777100
653990,786791,1332350,366550,471083.6,555250,287440,315707.4,777100
654310,802867,1332350,365750,470727.6,555250,288560,332139.4,777100
654670,799118.4,1332350,364980,472869.3,555250,289690,326249.1,777100
655000,766227,1332350,364170,459784.2,555250,290830,306442.8,777100
646610,737963.5,1332350,373510,455172.7,555250,273100,282790.8,777100
644610,716821.6,1332350,370990,442418.2,555250,273620,274403.4,777100
642530,718900.3,1332350,368460,437346.3,555250,274070,281554,777100
640540,706005,1332350,365950,424873.3,555250,274590,281131.7,777100
638540,678810,1332350,363430,406854.4,555250,275110,271955.6,777100
638210,687421.2,1332350,362530,409046.9,555250,275680,278374.3,777100
637930,677260.1,1332350,361630,407617.1,555250,276300,269643,777100
637620,712483,1332350,360770,430670.8,555250,276850,281812.2,777100
637370,722259.4,1332350,359860,440321.2,555250,277510,281938.2,777100
631140,711104.5,1332350,357180,431549.8,555250,273960,279554.7,777100
625000,705440,1332350,354510,429073.5,555250,270490,276366.5,777100
618800,665789.9,1332350,351840,405134.8,555250,266960,260655.1,777100
612640,623927.1,1332350,349140,380722.5,555250,263500,243204.6,777100
606040,656852,1332350,345770,398381.9,555250,260270,258470.1,777100
599450,668821.4,1332350,342370,408201.3,555250,257080,260620.1,777100
592810,603882.4,1332350,338990,374821.6,555250,253820,229060.8,777100
586290,596940.4,1332350,335650,374830.3,555250,250640,222110.1,777100
579300,604425.5,1332350,332020,375803.7,555250,247280,228621.8,777100
572330,613855.3,1332350,328380,379888.9,555250,243950,233966.4,777100
565360,594073.7,1332350,324780,364679.9,555250,240580,229393.8,777100
558410,590825.8,1332350,321190,363346.2,555250,237220,227479.6,777100
555040,631678.2,1332350,320440,389499.8,555250,234600,242178.4,777100
551850,606029.6,1332350,319750,376376.4,555250,232100,229653.2,777100
548520,609307.1,1332350,319020,383169.7,555250,229500,226137.4,777100
545230,569467.2,1332350,318310,359803.5,555250,226920,209663.7,777100
542130,552077.4,1332350,317730,353900.4,555250,224400,198177,777100
538980,568879.8,1332350,317150,368306.9,555250,221830,200572.9,777100
535850,543049.8,1332350,316600,356239.2,555250,219250,186810.6,777100
532750,578049.9,1332350,316040,381452.8,555250,216710,196597.1,777100
529150,591445.2,1332350,314640,392036,555250,214510,199409.2,777100
525520,582699.6,1332350,313250,385395.8,555250,212270,197303.8,777100
521960,609540.3,1332350,311910,401171.1,555250,210050,208369.2,777100
518370,611674,1332350,310520,402153.3,555250,207850,209520.7,777100
513700,626350.4,1332350,308030,409720.5,555250,205670,216629.9,777100
509110,612421,1332350,305560,399828.7,555250,203550,212592.3,777100
504490,612466.1,1332350,303090,402572.4,555250,201400,209893.7,777100
499860,572621.2,1332350,300610,378525.8,555250,199250,194095.4,777100
496240,566386.6,1332350,298520,376662.7,555250,197720,189723.9,777100
492570,579295.9,1332350,296450,385694.7,555250,196120,193601.2,777100
488950,531390.4,1332350,294370,353622.6,555250,194580,177767.8,777100
485380,544879.8,1332350,292280,360266.2,555250,193100,184613.6,777100
482860,548043.1,1332350,291270,362889.9,555250,191590,185153.2,777100
480450,517329,1332350,290260,346126.1,555250,190190,171202.9,777100
477930,524287.7,1332350,289210,351462.4,555250,188720,172825.3,777100
475460,532519.6,1332350,288190,355850.8,555250,187270,176668.8,777100
478090,500271.5,1332350,289000,337408.2,555250,189090,162863.3,777100
480770,487558,1332350,289810,328839.3,555250,190960,158718.7,777100
483310,469266.3,1332350,290600,318307.9,555250,192710,150958.4,777100
485990,465785.4,1332350,291400,316404.1,555250,194590,149381.3,777100
489040,462917.2,1332350,291960,311404.9,555250,197080,151512.3,777100
492190,453816.6,1332350,292500,305481.2,555250,199690,148335.4,777100
495290,430421.3,1332350,293090,291697.5,555250,202200,138723.8,777100
498340,451759.1,1332350,293630,306462,555250,204710,145297.1,777100
498570,413859,1332350,292200,283472.6,555250,206370,130386.4,777100
498630,393212.9,1332350,290730,270953.6,555250,207900,122259.3,777100
498800,436343.4,1332350,289310,294654.7,555250,209490,141688.7,777100
498920,425822,1332350,287850,287906.1,555250,211070,137915.9,777100
502370,387710.3,1332350,289640,264366,555250,212730,123344.3,777100
505790,364026.8,1332350,291440,250462.9,555250,214350,113563.9,777100
509260,390742.6,1332350,293240,267910.2,555250,216020,122832.4,777100
512700,404812.9,1332350,295030,278466.9,555250,217670,126346,777100
517900,422276.7,1332350,298570,288314.9,555250,219330,133961.8,777100
523040,387027.5,1332350,302100,267651.8,555250,220940,119375.7,777100
528230,317934.2,1332350,305630,227158.9,555250,222600,90775.3,777100
533320,307933.1,1332350,309150,222029.3,555250,224170,85903.8,777100
537320,318058.9,1332350,310800,227744.8,555250,226520,90314.1,777100
541320,333046.8,1332350,312400,235478.4,555250,228920,97568.4,777100
545240,380268.3,1332350,314030,261932.4,555250,231210,118335.9,777100
549220,380138.8,1332350,315650,263561.5,555250,233570,116577.3,777100
545430,435058.4,1332350,313340,292928.3,555250,232090,142130.1,777100
541560,466993.9,1332350,310970,313299.1,555250,230590,153694.8,777100
537770,495264.1,1332350,308650,327217.5,555250,229120,168046.6,777100
533860,490028.8,1332350,306300,323385.9,555250,227560,166642.9,777100
529410,443705.2,1332350,304730,297398.1,555250,224680,146307.1,777100
525040,455157.1,1332350,303150,304832.3,555250,221890,150324.8,777100
520560,476686.6,1332350,301590,319427.2,555250,218970,157259.4,777100
516100,463467.7,1332350,299990,311522.3,555250,216110,151945.4,777100
512000,451148.3,1332350,299110,304390,555250,212890,146758.3,777100
507850,466028.7,1332350,298230,313882.5,555250,209620,152146.2,777100
503800,463434.6,1332350,297340,313539.1,555250,206460,149895.5,777100
499630,448025.4,1332350,296460,302139.4,555250,203170,145886,777100
497340,462671.3,1332350,293500,308472.8,555250,203840,154198.5,777100
495140,479975.6,1332350,290600,317470.4,555250,204540,162505.2,777100
492820,454958.5,1332350,287680,299630.5,555250,205140,155328,777100
490630,450696.5,1332350,284760,294676.5,555250,205870,156020,777100
488660,431895.2,1332350,282090,283144.6,555250,206570,148750.6,777100
486860,436162.5,1332350,279490,287447.8,555250,207370,148714.7,777100
485000,439460.7,1332350,276820,287859.1,555250,208180,151601.6,777100
483130,446573.2,1332350,274180,291292.8,555250,208950,155280.4,777100
481100,456410.1,1332350,271280,295424.8,555250,209820,160985.3,777100
479030,481390.3,1332350,268350,307762.3,555250,210680,173628,777100
476910,476596.2,1332350,265440,301429.8,555250,211470,175166.4,777100
474830,439228.1,1332350,262530,274134.5,555250,212300,165093.6,777100
462950,405624.6,1332350,254680,250743.1,555250,208270,154881.5,777100
450920,386637.4,1332350,246790,236825.9,555250,204130,149811.5,777100
439040,465270.2,1332350,238920,282016.5,555250,200120,183253.7,777100
425960,460599.8,1332350,231420,279557.8,555250,194540,181042,777100
421020,430291.3,1332350,227200,258530.7,555250,193820,171760.6,777100
416110,390591.1,1332350,223040,232192.8,555250,193070,158398.3,777100
411160,372426.4,1332350,218840,219822.1,555250,192320,152604.3,777100
406150,323437.8,1332350,214630,187319,555250,191520,136118.8,777100
400840,296136.6,1332350,210200,168012.1,555250,190640,128124.5,777100
395580,281161,1332350,205770,159592.7,555250,189810,121568.3,777100
390250,261769.7,1332350,201290,150212.2,555250,188960,111557.5,777100
384950,250911.6,1332350,196860,143630.7,555250,188090,107280.9,777100
368010,239797.8,1332350,187130,137215.6,555250,180880,102582.2,777100
350940,222523.9,1332350,177390,126717,555250,173550,95806.9,777100
333990,214219,1332350,167690,120515.5,555250,166300,93703.5,777100
317000,206894.8,1332350,157960,115061.8,555250,159040,91833,777100
300950,172151.7,1332350,148500,93387.4,555250,152450,78764.3,777100
284960,151392.1,1332350,139030,80898.5,555250,145930,70493.6,777100
268920,116729.5,1332350,129580,60428.7,555250,139340,56300.8,777100
252950,126484.7,1332350,120120,66808.7,555250,132830,59676,777100
237340,140363.7,1332350,111020,73013.8,555250,126320,67349.9,777100
221770,125045.7,1332350,101870,61054.2,555250,119900,63991.5,777100
206180,96420.6,1332350,92750,42725.1,555250,113430,53695.5,777100
190620,106938.8,1332350,83620,47317.6,555250,107000,59621.2,777100
180390,104576.6,1332350,78830,46852,555250,101560,57724.6,777100
170090,107203.9,1332350,73980,50381.8,555250,96110,56822.1,777100
159880,111104.1,1332350,69150,53023,555250,90730,58081.1,777100
149610,117690.7,1332350,64320,57998.3,555250,85290,59692.4,777100
140490,103769.7,1332350,60670,51444.1,555250,79820,52325.6,777100
131360,76203.1,1332350,57000,37537.5,555250,74360,38665.6,777100
122230,66333.6,1332350,53350,33147.4,555250,68880,33186.2,777100
113120,57342.2,1332350,49720,27228,555250,63400,30114.2,777100
104990,67002.1,1332350,47630,33850.2,555250,57360,33151.9,777100
96920,70579.6,1332350,45550,37000,555250,51370,33579.6,777100
88820,54564.6,1332350,43460,28258.9,555250,45360,26305.7,777100
80710,36157.5,1332350,41380,18123,555250,39330,18034.5,777100
77660,24455.2,1332350,40130,10371.2,555250,37530,14084,777100
74710,20219.7,1332350,38860,6943.4,555250,35850,13276.3,777100
71740,24643.9,1332350,37650,11471.9,555250,34090,13172,777100
68790,33064.4,1332350,36390,19403.3,555250,32400,13661.1,777100
66260,45850.1,1332350,34840,26662.7,555250,31420,19187.4,777100
63680,56398.5,1332350,33240,33083.2,555250,30440,23315.3,777100
61090,59370.1,1332350,31680,33958.2,555250,29410,25411.9,777100
58510,59280.5,1332350,30120,33684.6,555250,28390,25595.9,777100
56310,67310.1,1332350,29070,38499.2,555250,27240,28810.9,777100
54000,79801.9,1332350,27980,45088,555250,26020,34713.9,777100
51710,73017.5,1332350,26900,40914.4,555250,24810,32103.1,777100
49450,67048.9,1332350,25820,36959,555250,23630,30089.9,777100
47650,75125.4,1332350,24170,40257.7,555250,23480,34867.7,777100
45790,70731.8,1332350,22500,36604.2,555250,23290,34127.6,777100
44040,54337.7,1332350,20850,25537.6,555250,23190,28800.1,777100
42240,51301.2,1332350,19200,23806.9,555250,23040,27494.3,777100
41810,50630.9,1332350,18780,23690.5,555250,23030,26940.4,777100
41390,46929.4,1332350,18390,22198.9,555250,23000,24730.5,777100
41020,43168.1,1332350,18000,20690.4,555250,23020,22477.7,777100
40690,48278.6,1332350,17600,24524.9,555250,23090,23753.7,777100
40230,45754.3,1332350,17230,23569.5,555250,23000,22184.8,777100
39750,41533,1332350,16850,21490.2,555250,22900,20042.8,777100
39280,32819.9,1332350,16530,15909,555250,22750,16910.9,777100
38890,26777.1,1332350,16170,12316.7,555250,22720,14460.4,777100
38590,27970.7,1332350,15600,12806.6,555250,22990,15164.1,777100
38320,26959.1,1332350,15040,12087.1,555250,23280,14872,777100
38050,25629.2,1332350,14520,10822.1,555250,23530,14807.1,777100
37780,25458.4,1332350,13940,10172.5,555250,23840,15285.9,777100
37290,24151,1332350,13410,9157.2,555250,23880,14993.8,777100
36870,26088.6,1332350,12910,10206.9,555250,23960,15881.7,777100
36450,30003.5,1332350,12420,12252.3,555250,24030,17751.2,777100
35990,29963.1,1332350,11850,12479.3,555250,24140,17483.8,777100
35670,27572.1,1332350,11460,10861.1,555250,24210,16711,777100
35360,27388.7,1332350,11020,9887.5,555250,24340,17501.2,777100
35050,27377.1,1332350,10620,10061.8,555250,24430,17315.3,777100
34810,28899.5,1332350,10190,10571.6,555250,24620,18327.9,777100
35060,27400.4,1332350,10070,10019.2,555250,24990,17381.2,777100
35440,24575.9,1332350,9900,8114.7,555250,25540,16461.2,777100
35750,15874.6,1332350,9750,2904.8,555250,26000,12969.8,777100
36000,16362.6,1332350,9600,3144.8,555250,26400,13217.8,777100
36780,17392.4,1332350,9560,3371.7,555250,27220,14020.7,777100
37530,18847,1332350,9530,3507.2,555250,28000,15339.8,777100
38260,19558.1,1332350,9450,3649.6,555250,28810,15908.5,777100
38990,20179.2,1332350,9400,3785.8,555250,29590,16393.4,777100
39960,21774.9,1332350,9300,4216.2,555250,30660,17558.7,777100
40880,21938.4,1332350,9200,3928.7,555250,31680,18009.7,777100
41860,22779.4,1332350,9090,4188,555250,32770,18591.4,777100
42770,23255.3,1332350,9000,4076,555250,33770,19179.3,777100
44250,24886.1,1332350,8920,3811.2,555250,35330,21074.9,777100
45640,26544.9,1332350,8830,3891.8,555250,36810,22653.1,777100
47020,27655.9,1332350,8730,3710.7,555250,38290,23945.2,777100
48470,29626.6,1332350,8650,3657.9,555250,39820,25968.7,777100
49450,31081.6,1332350,8660,3335.5,555250,40790,27746.1,777100
50630,32208.4,1332350,8710,3320,555250,41920,28888.4,777100
51710,33928,1332350,8720,3220,555250,42990,30708,777100
52690,34895.7,1332350,8760,3120,555250,43930,31775.7,777100
53580,35126.8,1332350,8930,3024,555250,44650,32102.8,777100
54480,35364.3,1332350,9080,3034.1,555250,45400,32330.2,777100
55310,37706.2,1332350,9250,4140.9,555250,46060,33565.3,777100
56060,42739.8,1332350,9410,6934.2,555250,46650,35805.6,777100
52580,45483.9,1332350,8890,9695.6,555250,43690,35788.3,777100
49050,43226.9,1332350,8340,9080.4,555250,40710,34146.5,777100
45540,38878.3,1332350,7820,8665,555250,37720,30213.3,777100
22890,33257.3,1332350,4280,9215.1,555250,18610,24042.2,777100
22080,32215.8,1332350,4300,8871.4,555250,17780,23344.4,777100
21200,33464.7,1332350,4330,9557.1,555250,16870,23907.6,777100
20370,31659.1,1332350,4370,9498.7,555250,16000,22160.4,777100
19500,27758.1,1332350,4410,7742.3,555250,15090,20015.8,777100
18750,22344.4,1332350,4510,5521.2,555250,14240,16823.2,777100
17940,21146.5,1332350,4610,4810.9,555250,13330,16335.6,777100
17200,23122,1332350,4710,6623.4,555250,12490,16498.6,777100
16360,29174.2,1332350,4800,10846.7,555250,11560,18327.5,777100
16520,38509.8,1332350,4720,16743.2,555250,11800,21766.6,777100
16720,40265.3,1332350,4610,17611.8,555250,12110,22653.5,777100
16810,35088.5,1332350,4500,14429.8,555250,12310,20658.7,777100
16940,37643.3,1332350,4390,15894,555250,12550,21749.3,777100
17150,39077.3,1332350,4300,14382.5,555250,12850,24694.8,777100
17320,36703.1,1332350,4210,13324.5,555250,13110,23378.6,777100
17510,36085.9,1332350,4100,13505.4,555250,13410,22580.5,777100
17720,31321,1332350,4010,10557.8,555250,13710,20763.2,777100
18030,34353.9,1332350,3920,12398.2,555250,14110,21955.7,777100
18250,41492.8,1332350,3830,15093.8,555250,14420,26399,777100
18520,49784.9,1332350,3710,19389.1,555250,14810,30395.8,777100
18810,64218.5,1332350,3630,27708,555250,15180,36510.5,777100
19070,71776.9,1332350,3820,31202,555250,15250,40574.9,777100
19360,66952,1332350,4000,26691,555250,15360,40261,777100
19620,59778.4,1332350,4170,20899.5,555250,15450,38878.9,777100
19840,64283,1332350,4340,22250.3,555250,15500,42032.7,777100
20160,77189,1332350,4500,27925.8,555250,15660,49263.2,777100
20420,77312.4,1332350,4670,29143.1,555250,15750,48169.3,777100
20720,77843.2,1332350,4860,29513.8,555250,15860,48329.4,777100
21010,81927.5,1332350,5030,31845.6,555250,15980,50081.9,777100
21410,78622.6,1332350,5330,32153.9,555250,16080,46468.7,777100
21810,75929.1,1332350,5610,32110.9,555250,16200,43818.2,777100
22220,70337.2,1332350,5880,30309.8,555250,16340,40027.4,777100
22600,65537.6,1332350,6160,29284.6,555250,16440,36253,777100
21750,58523.5,1332350,5940,28276.5,555250,15810,30247,777100
20910,52425.1,1332350,5680,24591.3,555250,15230,27833.8,777100
20080,44599,1332350,5410,21058,555250,14670,23541,777100
19250,42965,1332350,5170,20068.2,555250,14080,22896.8,777100
18460,36227.6,1332350,4910,15764.3,555250,13550,20463.3,777100
17620,33302.7,1332350,4610,12941,555250,13010,20361.7,777100
16880,29376.6,1332350,4350,10791.3,555250,12530,18585.3,777100
16050,24802.4,1332350,4070,9323.1,555250,11980,15479.3,777100
15690,24072.6,1332350,3900,8882.3,555250,11790,15190.3,777100
15270,23556.3,1332350,3700,8635.9,555250,11570,14920.4,777100
14840,25841.7,1332350,3530,9092.8,555250,11310,16748.9,777100
14380,29447.5,1332350,3310,11137.5,555250,11070,18310,777100
15460,32182.3,1332350,3900,13154.7,555250,11560,19027.6,777100
16550,38556.2,1332350,4500,16292.5,555250,12050,22263.7,777100
17680,48277.5,1332350,5060,21027,555250,12620,27250.5,777100
18770,54969.7,1332350,5650,22857.2,555250,13120,32112.5,777100
19930,58745.3,1332350,6270,23686.9,555250,13660,35058.4,777100
21090,56981.6,1332350,6930,22080.9,555250,14160,34900.7,777100
22270,59060.4,1332350,7580,20525.3,555250,14690,38535.1,777100
23430,53919.5,1332350,8190,21119.2,555250,15240,32800.3,777100
24430,53550.4,1332350,8770,21445.5,555250,15660,32104.9,777100
25390,60343.4,1332350,9320,26883.4,555250,16070,33460,777100
26310,79664.7,1332350,9860,31847.4,555250,16450,47817.3,777100
27300,97033,1332350,10420,41655.7,555250,16880,55377.3,777100
29270,115483.3,1332350,11860,50624.8,555250,17410,64858.5,777100
31380,105677,1332350,13350,43535.1,555250,18030,62141.9,777100
33440,89116.8,1332350,14810,35721.1,555250,18630,53395.7,777100
35470,81757.9,1332350,16270,31909.6,555250,19200,49848.3,777100
37330,88943.6,1332350,17710,36790.6,555250,19620,52153,777100
39170,104181.8,1332350,19140,48270,555250,20030,55911.8,777100
40970,91299.6,1332350,20550,40239.5,555250,20420,51060.1,777100
42880,84680.6,1332350,22020,38873.9,555250,20860,45806.7,777100
44730,70141.6,1332350,23460,32730.6,555250,21270,37411,777100
46510,53919.8,1332350,24910,24644.6,555250,21600,29275.2,777100
48320,50301.2,1332350,26350,22854.9,555250,21970,27446.3,777100
50170,60601.2,1332350,27820,32459.7,555250,22350,28141.5,777100
49500,70914.9,1332350,27640,39702.6,555250,21860,31212.3,777100
48760,47721.1,1332350,27450,25933.4,555250,21310,21787.7,777100
48060,64532.3,1332350,27270,36361.1,555250,20790,28171.2,777100
47310,67714.2,1332350,27070,37107,555250,20240,30607.2,777100
46600,77962.5,1332350,26900,37563.3,555250,19700,40399.2,777100
45920,60374.4,1332350,26780,34431.1,555250,19140,25943.3,777100
45190,60965.4,1332350,26600,35142.4,555250,18590,25823,777100
44480,58925.1,1332350,26420,32350.1,555250,18060,26575,777100
43890,46165.1,1332350,26250,26196.8,555250,17640,19968.3,777100
43180,42628.9,1332350,26050,23581.4,555250,17130,19047.5,777100
42540,43875.7,1332350,25860,25002.2,555250,16680,18873.5,777100
41850,60827.5,1332350,25660,36047.1,555250,16190,24780.4,777100
42760,58891.2,1332350,26070,33775,555250,16690,25116.2,777100
43560,31817,1332350,26400,15617.7,555250,17160,16199.3,777100
44360,22263.1,1332350,26770,9201.3,555250,17590,13061.8,777100
45270,15109.5,1332350,27170,7418.1,555250,18100,7691.4,777100
46090,15248.6,1332350,27550,6694.1,555250,18540,8554.5,777100
46930,18098.2,1332350,27930,7905.7,555250,19000,10192.5,777100
47770,24858,1332350,28330,11732.1,555250,19440,13125.9,777100
48620,41752.7,1332350,28730,21718.3,555250,19890,20034.4,777100
49790,49280.7,1332350,29190,27177.2,555250,20600,22103.5,777100
51030,65137.3,1332350,29690,36750.4,555250,21340,28386.9,777100
52240,127650.9,1332350,30140,72347.4,555250,22100,55303.5,777100
53480,128675.8,1332350,30640,71960.8,555250,22840,56715,777100
64160,133938.6,1332350,37460,75771.5,555250,26700,58167.1,777100
74890,162555.2,1332350,44300,92332.9,555250,30590,70222.3,777100
85560,169918.3,1332350,51150,97144.1,555250,34410,72774.2,777100
126390,194386.2,1332350,63410,106175.1,555250,62980,88211.1,777100
137820,209493.1,1332350,70090,113602.8,555250,67730,95890.3,777100
149390,199264.8,1332350,76790,110678.8,555250,72600,88586,777100
160890,191401.7,1332350,83460,106937.3,555250,77430,84464.4,777100
172420,217516.6,1332350,90160,123118.5,555250,82260,94398.1,777100
184290,253605.9,1332350,96880,144392.2,555250,87410,109213.7,777100
196230,275574.5,1332350,103630,155840.9,555250,92600,119733.6,777100
208140,307373.8,1332350,110340,174635.6,555250,97800,132738.2,777100
220040,347227.3,1332350,117080,197655.7,555250,102960,149571.6,777100
228780,362939.9,1332350,122840,209890,555250,105940,153049.9,777100
237500,386738.4,1332350,128640,228523.5,555250,108860,158214.9,777100
246320,425715.1,1332350,134410,251116.3,555250,111910,174598.8,777100
255000,466821.7,1332350,140180,276074.3,555250,114820,190747.4,777100
262910,488725.6,1332350,145250,291178.7,555250,117660,197546.9,777100
270800,485854,1332350,150300,291092.3,555250,120500,194761.7,777100
278620,508968,1332350,155360,306389.4,555250,123260,202578.6,777100
286510,541032.7,1332350,160410,326177.5,555250,126100,214855.2,777100
294480,535585.5,1332350,165670,319304,555250,128810,216281.5,777100
302530,516529.7,1332350,170910,306654.9,555250,131620,209874.8,777100
310510,483710.4,1332350,176150,287726.8,555250,134360,195983.6,777100
318600,486804.8,1332350,181410,290982.8,555250,137190,195822,777100
322890,488415,1332350,185250,294593,555250,137640,193822,777100
327250,472537.1,1332350,189100,284745.9,555250,138150,187791.2,777100
331630,479965.2,1332350,192960,289502.6,555250,138670,190462.6,777100
336000,494269.8,1332350,196830,297186.8,555250,139170,197083,777100
340020,468701.1,1332350,200080,282922.9,555250,139940,185778.2,777100
344040,487663.6,1332350,203320,294059.2,555250,140720,193604.4,777100
348080,519061.3,1332350,206580,312818.2,555250,141500,206243.1,777100
352120,503873.8,1332350,209860,306079.1,555250,142260,197794.7,777100
353910,524846.5,1332350,211850,315666.1,555250,142060,209180.4,777100
355780,511328.2,1332350,213860,308120.5,555250,141920,203207.7,777100
357520,498365.1,1332350,215840,301947.8,555250,141680,196417.3,777100
359350,497573.7,1332350,217840,304122.5,555250,141510,193451.2,777100
372440,552074,1332350,221120,332726.5,555250,151320,219347.5,777100
385640,545884.1,1332350,224420,330353.8,555250,161220,215530.3,777100
398810,537183.8,1332350,227710,322956.3,555250,171100,214227.5,777100
412050,495432.9,1332350,231000,296540.7,555250,181050,198892.2,777100
425200,454987.9,1332350,233450,266610.9,555250,191750,188377,777100
438400,448122.8,1332350,235890,259175.2,555250,202510,188947.6,777100
451620,462460.5,1332350,238350,263066.4,555250,213270,199394.1,777100
464750,482617.6,1332350,240790,277335.5,555250,223960,205282.1,777100
481220,519520.6,1332350,246250,292370.7,555250,234970,227149.9,777100
497630,573715.4,1332350,251690,322179.2,555250,245940,251536.2,777100
514040,625394.4,1332350,257130,355719.4,555250,256910,269675,777100
530470,657021.9,1332350,262570,368125.1,555250,267900,288896.8,777100
535800,625917.4,1332350,265400,346869.1,555250,270400,279048.3,777100
541150,632837.2,1332350,268270,356393.5,555250,272880,276443.7,777100
546540,650972.5,1332350,271100,360289.7,555250,275440,290682.8,777100
551900,687942,1332350,273970,382760.5,555250,277930,305181.5,777100
557210,703728.4,1332350,277900,398840.2,555250,279310,304888.2,777100
562630,721058.5,1332350,281840,401065.8,555250,280790,319992.7,777100
567990,721912.7,1332350,285760,410510.5,555250,282230,311402.2,777100
573360,723556,1332350,289740,411069.6,555250,283620,312486.4,777100
579610,691977.9,1332350,295260,393726.2,555250,284350,298251.7,777100
585910,723387.9,1332350,300850,411125.5,555250,285060,312262.4,777100
592180,730662.7,1332350,306390,416315.2,555250,285790,314347.5,777100
598470,711839,1332350,311950,411645.4,555250,286520,300193.6,777100
595200,724879.8,1332350,311550,418803.3,555250,283650,306076.5,777100
591960,685537.7,1332350,311170,395994,555250,280790,289543.7,777100
588580,666797.1,1332350,310730,388808.4,555250,277850,277988.7,777100
585350,620380.4,1332350,310350,356425.6,555250,275000,263954.8,777100
582690,649594.6,1332350,310140,375630.4,555250,272550,273964.2,777100
580010,668500.2,1332350,309930,385326.8,555250,270080,283173.4,777100
577400,661479.3,1332350,309750,383401,555250,267650,278078.3,777100
574710,748891.1,1332350,309510,434402.6,555250,265200,314488.5,777100
572630,804745.9,1332350,310050,465180.8,555250,262580,339565.1,777100
570600,811942.1,1332350,310580,473025.2,555250,260020,338916.9,777100
568550,801924,1332350,311090,469082.8,555250,257460,332841.2,777100
566570,793436.7,1332350,311630,465017.6,555250,254940,328419.1,777100
555960,682793.5,1332350,307700,402695.5,555250,248260,280098,777100
545380,613206.3,1332350,303790,363878.1,555250,241590,249328.2,777100
534750,661381,1332350,299850,384286.9,555250,234900,277094.1,777100
524230,598686.7,1332350,295940,350465.7,555250,228290,248221,777100
511900,543975.9,1332350,291060,322004.9,555250,220840,221971,777100
499540,598864.2,1332350,286210,351469.1,555250,213330,247395.1,777100
487160,563682.3,1332350,281340,332502.6,555250,205820,231179.7,777100
474860,523534.8,1332350,276470,308837.6,555250,198390,214697.2,777100
463850,448651.2,1332350,272500,270076,555250,191350,178575.2,777100
452920,447916.6,1332350,268500,271964.1,555250,184420,175952.5,777100
442010,323799.1,1332350,264540,198763.2,555250,177470,125035.9,777100
431060,310230.2,1332350,260560,190378.3,555250,170500,119851.9,777100
443390,347642.4,1332350,265590,211350,555250,177800,136292.4,777100
455800,374454.1,1332350,270660,223734.5,555250,185140,150719.6,777100
468160,377213.2,1332350,275670,223071.2,555250,192490,154142,777100
480520,376328.2,1332350,280730,222476.2,555250,199790,153852,777100
492150,359052.7,1332350,285560,212256.6,555250,206590,146796.1,777100
503770,450537.8,1332350,290380,262082.5,555250,213390,188455.3,777100
515470,622031.6,1332350,295210,369904.1,555250,220260,252127.5,777100
527100,705803.4,1332350,300020,419217.7,555250,227080,286585.7,777100
539130,736808.5,1332350,304780,435976,555250,234350,300832.5,777100
551170,740281.3,1332350,309490,439438.7,555250,241680,300842.6,777100
563130,697572.8,1332350,314210,411948.2,555250,248920,285624.6,777100
575240,675040.9,1332350,318930,398989,555250,256310,276051.9,777100
587630,725656.5,1332350,324830,426589.7,555250,262800,299066.8,777100
600230,739492.4,1332350,330740,434740.4,555250,269490,304752,777100
612710,683185.1,1332350,336630,405012.1,555250,276080,278173,777100
684660,712968.2,1332350,347420,407706,555250,337240,305262.2,777100
692860,644634.7,1332350,352070,363654.9,555250,340790,280979.8,777100
701080,605478.2,1332350,356760,334706.4,555250,344320,270771.8,777100
709290,642009.2,1332350,361410,356653.7,555250,347880,285355.5,777100
717510,624315.4,1332350,366080,349365.7,555250,351430,274949.7,777100
724840,614711.7,1332350,369250,339414.2,555250,355590,275297.5,777100
732130,693880.2,1332350,372420,387369.8,555250,359710,306510.4,777100
739470,775886.2,1332350,375580,436839.3,555250,363890,339046.9,777100
746780,809924,1332350,378760,458622.8,555250,368020,351301.2,777100
749260,859943.8,1332350,380960,485140.6,555250,368300,374803.2,777100
751730,894667.6,1332350,383160,502583.8,555250,368570,392083.8,777100
754270,918044.3,1332350,385360,516065.1,555250,368910,401979.2,777100
756800,910273.8,1332350,387580,510409.7,555250,369220,399864.1,777100
762560,874788.1,1332350,392770,493187,555250,369790,381601.1,777100
768360,860504.5,1332350,398010,481228.9,555250,370350,379275.6,777100
774060,896195.9,1332350,403190,506793.4,555250,370870,389402.5,777100
779820,904630.7,1332350,408410,514582.5,555250,371410,390048.2,777100
782850,891386.6,1332350,410940,505461.7,555250,371910,385924.9,777100
785830,858107.7,1332350,413440,483841.6,555250,372390,374266.1,777100
788780,777103.7,1332350,415920,436254.5,555250,372860,340849.2,777100
791870,760558.4,1332350,418450,428723.8,555250,373420,331834.6,777100
794540,759568.4,1332350,419930,437236.2,555250,374610,322332.2,777100
797260,792446.4,1332350,421440,464903.9,555250,375820,327542.5,777100
799970,824641.1,1332350,422940,484537.1,555250,377030,340104,777100
802720,829389.6,1332350,424420,492019.4,555250,378300,337370.2,777100
805120,832440.6,1332350,426340,490071.7,555250,378780,342368.9,777100
807670,823963.8,1332350,428250,484462.7,555250,379420,339501.1,777100
810120,831898.2,1332350,430170,486801.1,555250,379950,345097.1,777100
812600,852327.6,1332350,432090,489056.5,555250,380510,363271.1,777100
815630,829944.9,1332350,433910,476713.4,555250,381720,353231.5,777100
818620,799884.3,1332350,435720,464958.5,555250,382900,334925.8,777100
821630,817598,1332350,437520,470341.6,555250,384110,347256.4,777100
824580,818830,1332350,439340,466507.9,555250,385240,352322.1,777100
829140,799305.6,1332350,439690,456920.4,555250,389450,342385.2,777100
833680,780120.7,1332350,439980,446686.3,555250,393700,333434.4,777100
838190,753972.2,1332350,440330,431779.8,555250,397860,322192.4,777100
842730,735142.3,1332350,440650,415831.2,555250,402080,319311.1,777100
846500,814276.1,1332350,441190,458555.3,555250,405310,355720.8,777100
850300,852567.3,1332350,441760,474716.3,555250,408540,377851,777100
854010,888102.7,1332350,442280,492235.7,555250,411730,395867,777100
857790,883643.1,1332350,442850,485221.8,555250,414940,398421.3,777100
860640,895787.3,1332350,443310,490244.9,555250,417330,405542.4,777100
863440,884580.2,1332350,443780,481310.7,555250,419660,403269.5,777100
866310,896961.4,1332350,444230,485523.4,555250,422080,411438,777100
869070,872202.2,1332350,444680,479283.8,555250,424390,392918.4,777100
873170,832218.8,1332350,446180,475179.8,555250,426990,357039,777100
877320,839289,1332350,447720,474385.6,555250,429600,364903.4,777100
881330,835493.4,1332350,449210,473408.4,555250,432120,362085,777100
885480,854381.9,1332350,450710,478590.1,555250,434770,375791.8,777100
891760,845261.9,1332350,452690,473238.7,555250,439070,372023.2,777100
898100,847355.5,1332350,454700,477552.6,555250,443400,369802.9,777100
904400,890576.8,1332350,456690,500858.2,555250,447710,389718.6,777100
910770,918890.9,1332350,458670,511352.5,555250,452100,407538.4,777100
917250,966708.1,1332350,460230,521459.6,555250,457020,445248.5,777100
923660,983959.8,1332350,461730,537650.4,555250,461930,446309.4,777100
930100,939903.6,1332350,463250,506572.8,555250,466850,433330.8,777100
936650,934613.9,1332350,464800,504895.9,555250,471850,429718,777100
929550,980730.1,1332350,464010,521002.2,555250,465540,459727.9,777100
922500,955104.8,1332350,463260,507937.3,555250,459240,447167.5,777100
915500,921224,1332350,462480,503885.4,555250,453020,417338.6,777100
908450,882089.4,1332350,461700,498804.1,555250,446750,383285.3,777100
901920,886220.7,1332350,460890,502025.5,555250,441030,384195.2,777100
895360,892687,1332350,460070,504945.8,555250,435290,387741.2,777100
888790,894321.5,1332350,459250,510628.9,555250,429540,383692.6,777100
882310,882282.7,1332350,458430,514462,555250,423880,367820.7,777100
876970,873547.3,1332350,457860,507709.2,555250,419110,365838.1,777100
871550,870446.8,1332350,457240,499417.4,555250,414310,371029.4,777100
866310,882259.3,1332350,456680,498148.7,555250,409630,384110.6,777100
860980,882045.7,1332350,456090,490175,555250,404890,391870.7,777100
855840,847965.3,1332350,454150,475394.4,555250,401690,372570.9,777100
850550,825924.8,1332350,452170,478534.6,555250,398380,347390.2,777100
845340,803723,1332350,450190,477202.1,555250,395150,326520.9,777100
840170,814401.3,1332350,448210,484491.7,555250,391960,329909.6,777100
836200,803438.1,1332350,447230,479022.6,555250,388970,324415.5,777100
832320,826873.6,1332350,446250,486783.1,555250,386070,340090.5,777100
828340,839546.4,1332350,445220,484805.8,555250,383120,354740.6,777100
824440,851079.8,1332350,444240,494559.2,555250,380200,356520.6,777100
820100,838405.4,1332350,442640,499289.9,555250,377460,339115.5,777100
815840,842927.7,1332350,441030,500448.6,555250,374810,342479.1,777100
811490,867498.9,1332350,439420,500710.3,555250,372070,366788.6,777100
807170,872802.7,1332350,437810,504855.5,555250,369360,367947.2,777100
804310,866613.1,1332350,434830,497781.8,555250,369480,368831.3,777100
801450,863730.2,1332350,431810,493826.4,555250,369640,369903.8,777100
798650,884452.9,1332350,428830,499395.8,555250,369820,385057.1,777100
795730,893809.7,1332350,425810,502121.7,555250,369920,391688,777100
788930,880792,1332350,421930,497210.1,555250,367000,383581.9,777100
782080,890740.3,1332350,418060,507422.6,555250,364020,383317.7,777100
775350,863713.6,1332350,414190,493851.6,555250,361160,369862,777100
768530,807880.2,1332350,410310,463165.8,555250,358220,344714.4,777100
763920,709526.9,1332350,407050,402666.4,555250,356870,306860.5,777100
759290,636592.2,1332350,403790,352384.3,555250,355500,284207.9,777100
754750,649164.8,1332350,400540,361825.6,555250,354210,287339.2,777100
750060,659076.3,1332350,397260,366685.2,555250,352800,292391.1,777100
742400,670077.7,1332350,392620,370383.8,555250,349780,299693.9,777100
734820,655546.6,1332350,387990,360770.8,555250,346830,294775.8,777100
727180,617043,1332350,383320,339922.8,555250,343860,277120.2,777100
780960,594158.4,1332350,380130,310579.2,555250,400830,283579.2,777100
767590,582318,1332350,375230,300993,555250,392360,281325,777100
754250,570231.5,1332350,370340,290629.1,555250,383910,279602.4,777100
740880,616656.6,1332350,365470,322536.3,555250,375410,294120.3,777100
727470,696562,1332350,360560,374586.9,555250,366910,321975.1,777100
714820,673206.3,1332350,356470,361777.1,555250,358350,311429.2,777100
702190,659510.4,1332350,352380,352967.3,555250,349810,306543.1,777100
689540,618525.3,1332350,348270,333490,555250,341270,285035.3,777100
676800,616325.6,1332350,344160,335989.9,555250,332640,280335.7,777100
659590,667158.4,1332350,337230,370278.7,555250,322360,296879.7,777100
642240,654540.6,1332350,330280,368242,555250,311960,286298.6,777100
624850,583790.7,1332350,323320,327918.2,555250,301530,255872.5,777100
607550,575977,1332350,316350,326570.9,555250,291200,249406.1,777100
590570,557759.1,1332350,309760,316821.2,555250,280810,240937.9,777100
573470,565109.3,1332350,303140,327045.3,555250,270330,238064,777100
556480,548590.7,1332350,296570,317838.1,555250,259910,230752.6,777100
539400,522980.6,1332350,289960,301940.9,555250,249440,221039.7,777100
520240,462948.1,1332350,281880,269478.9,555250,238360,193469.2,777100
501050,407953.7,1332350,273820,241962.7,555250,227230,165991,777100
481910,409200.4,1332350,265760,246972,555250,216150,162228.4,777100
462700,373767.6,1332350,257690,227009.4,555250,205010,146758.2,777100
446870,367380,1332350,249790,223273.8,555250,197080,144106.2,777100
430890,370757.4,1332350,241870,226219.4,555250,189020,144538,777100
414990,340377.3,1332350,233960,208518.4,555250,181030,131858.9,777100
399130,311121.6,1332350,226070,193482.5,555250,173060,117639.1,777100
383700,345972.7,1332350,218930,218118.1,555250,164770,127854.6,777100
368330,379569.2,1332350,211790,237888.7,555250,156540,141680.5,777100
352950,340654.8,1332350,204660,219372.5,555250,148290,121282.3,777100
337550,283512.9,1332350,197540,185642.1,555250,140010,97870.8,777100
320610,241141.9,1332350,190080,162203.4,555250,130530,78938.5,777100
303560,213895.5,1332350,182640,146532.1,555250,120920,67363.4,777100
286470,202530.6,1332350,175180,142145.3,555250,111290,60385.3,777100
269540,204484.5,1332350,167770,142362.6,555250,101770,62121.9,777100
261900,208342.6,1332350,165530,145137.6,555250,96370,63205,777100
254340,197151.3,1332350,163280,140653.3,555250,91060,56498,777100
246850,194352.4,1332350,161040,139572.8,555250,85810,54779.6,777100
239280,166559.6,1332350,158830,125209.4,555250,80450,41350.2,777100
232640,128615.1,1332350,156020,104394,555250,76620,24221.1,777100
225890,141831.8,1332350,153190,113618.4,555250,72700,28213.4,777100
219210,168332,1332350,150360,130527.7,555250,68850,37804.3,777100
212500,135472.8,1332350,147540,110199.4,555250,64960,25273.4,777100
205620,139927.7,1332350,144090,112146.7,555250,61530,27781,777100
198720,130827.3,1332350,140630,105305.6,555250,58090,25521.7,777100
191670,121672.2,1332350,137150,99538.6,555250,54520,22133.6,777100
184710,142556.5,1332350,133650,111913.6,555250,51060,30642.9,777100
186660,142120.9,1332350,135520,111770.9,555250,51140,30350,777100
188550,142622.5,1332350,137380,113208.2,555250,51170,29414.3,777100
190430,163973.5,1332350,139250,127404.9,555250,51180,36568.6,777100
192330,147775.6,1332350,141100,118429.6,555250,51230,29346,777100
193530,90933.8,1332350,142370,79144,555250,51160,11789.8,777100
194740,80570.1,1332350,143640,70455.9,555250,51100,10114.2,777100
195870,101927.7,1332350,144900,90374.6,555250,50970,11553.1,777100
197040,127376.5,1332350,146170,108440.9,555250,50870,18935.6,777100
197810,100099.1,1332350,147350,89254.7,555250,50460,10844.4,777100
198540,69319.9,1332350,148510,62784.2,555250,50030,6535.7,777100
199340,66184.8,1332350,149750,60260.5,555250,49590,5924.3,777100
200030,40415.4,1332350,150930,36619.7,555250,49100,3795.7,777100
191950,21674.4,1332350,145750,17810.2,555250,46200,3864.2,777100
183810,22743.4,1332350,140590,18961.3,555250,43220,3782.1,777100
175760,17228.4,1332350,135410,14073.1,555250,40350,3155.3,777100
167550,17934.9,1332350,130260,14509.1,555250,37290,3425.8,777100
158750,27169.9,1332350,124620,23819.7,555250,34130,3350.2,777100
149850,26571.3,1332350,119000,22518.2,555250,30850,4053.1,777100
141000,21575.6,1332350,113390,16644.7,555250,27610,4930.9,777100
132100,15495.4,1332350,107760,10849.6,555250,24340,4645.8,777100
122520,10149,1332350,101560,6857.7,555250,20960,3291.3,777100
112920,5611.8,1332350,95320,2828.1,555250,17600,2783.7,777100
103320,3971,1332350,89130,1472.5,555250,14190,2498.5,777100
93640,3426.2,1332350,82910,522.3,555250,10730,2903.9,777100
90680,3578,1332350,79340,120,555250,11340,3458,777100
87740,4473.6,1332350,75780,131.1,555250,11960,4342.5,777100
84810,5296.5,1332350,72220,194,555250,12590,5102.5,777100
81790,7017.1,1332350,68640,254.6,555250,13150,6762.5,777100
79180,7942,1332350,65070,540.6,555250,14110,7401.4,777100
76620,8218,1332350,61520,1120.7,555250,15100,7097.3,777100
74040,8483.6,1332350,57950,2138.4,555250,16090,6345.2,777100
71440,10613.6,1332350,54400,3344.8,555250,17040,7268.8,777100
69480,16916.6,1332350,51130,6225.4,555250,18350,10691.2,777100
67510,17470.9,1332350,47860,5985.7,555250,19650,11485.2,777100
65550,21672.3,1332350,44590,7225.5,555250,20960,14446.8,777100
63470,22955.1,1332350,41310,5321.9,555250,22160,17633.2,777100
65780,20424.4,1332350,40060,4810.8,555250,25720,15613.6,777100
68090,19768.2,1332350,38900,4155.8,555250,29190,15612.4,777100
70300,20222.1,1332350,37670,5295.3,555250,32630,14926.8,777100
72560,19439.8,1332350,36460,4789.8,555250,36100,14650,777100
75140,20529.5,1332350,35830,4428,555250,39310,16101.5,777100
77730,23450.9,1332350,35190,4971.6,555250,42540,18479.3,777100
80420,31136.4,1332350,34590,7129.1,555250,45830,24007.3,777100
83040,39639,1332350,33940,9626.2,555250,49100,30012.8,777100
90010,51890.8,1332350,37390,15843.8,555250,52620,36047,777100
96980,65676.4,1332350,40850,22089.2,555250,56130,43587.2,777100
103930,98621.3,1332350,44280,39558,555250,59650,59063.3,777100
110910,134178.2,1332350,47720,57735.3,555250,63190,76442.9,777100
135710,173182,1332350,64330,80309.9,555250,71380,92872.1,777100
160510,213172.2,1332350,80930,106783.5,555250,79580,106388.7,777100
185350,289182.8,1332350,97540,154357,555250,87810,134825.8,777100
185980,368050.3,1332350,120710,214727,555250,65270,153323.3,777100
209440,435940,1332350,139040,261489.5,555250,70400,174450.5,777100
232890,492457.7,1332350,157390,299349.1,555250,75500,193108.6,777100
256290,570273.7,1332350,175730,350815.1,555250,80560,219458.6,777100
279710,645330.2,1332350,194060,398257.6,555250,85650,247072.6,777100
301680,681001.2,1332350,211190,422709.3,555250,90490,258291.9,777100
323650,692972.4,1332350,228350,432833.5,555250,95300,260138.9,777100
345600,696204.1,1332350,245460,440867.3,555250,100140,255336.8,777100
367470,730465.7,1332350,262580,464014.4,555250,104890,266451.3,777100
379540,731658.3,1332350,266710,462610,555250,112830,269048.3,777100
391640,732589.6,1332350,270850,462536.1,555250,120790,270053.5,777100
403670,697256.4,1332350,274990,437726.3,555250,128680,259530.1,777100
415760,726403.6,1332350,279110,450531.9,555250,136650,275871.7,777100
428650,749209.1,1332350,283520,456512.3,555250,145130,292696.8,777100
441560,744139.5,1332350,287900,450279.7,555250,153660,293859.8,777100
454590,732303.4,1332350,292280,440386,555250,162310,291917.4,777100
467490,709083.8,1332350,296700,427499.1,555250,170790,281584.7,777100
481140,697622.7,1332350,301550,420292.4,555250,179590,277330.3,777100
494850,702184.6,1332350,306430,419385.4,555250,188420,282799.2,777100
508430,725369.6,1332350,311270,433472.8,555250,197160,291896.8,777100
522110,752177.6,1332350,316150,448529.2,555250,205960,303648.4,777100
531220,742692.3,1332350,319200,444502,555250,212020,298190.3,777100
540440,745372.4,1332350,322320,445692.9,555250,218120,299679.5,777100
549570,770312.2,1332350,325380,459068,555250,224190,311244.2,777100
558760,770625.4,1332350,328470,457682.7,555250,230290,312942.7,777100
567920,776378.1,1332350,331380,459442.9,555250,236540,316935.2,777100
577240,766718,1332350,334350,454344.9,555250,242890,312373.1,777100
586470,761069.9,1332350,337260,446165.2,555250,249210,314904.7,777100
595700,751466.3,1332350,340210,438828.3,555250,255490,312638,777100
604880,721335.5,1332350,345370,424151.5,555250,259510,297184,777100
614080,745120.5,1332350,350560,438142.6,555250,263520,306977.9,777100
623270,792765.8,1332350,355720,472243.7,555250,267550,320522.1,777100
632410,780866.9,1332350,360880,463450.3,555250,271530,317416.6,777100
649060,775263.7,1332350,361750,455748.8,555250,287310,319514.9,777100
665660,829734.6,1332350,362640,479117.7,555250,303020,350616.9,777100
682320,856586.6,1332350,363520,492327.9,555250,318800,364258.7,777100
698920,895774.3,1332350,364390,508446.2,555250,334530,387328.1,777100
721830,910391.8,1332350,369090,504733.3,555250,352740,405658.5,777100
744610,912773,1332350,373810,493592.9,555250,370800,419180.1,777100
767480,947003,1332350,378550,498627.1,555250,388930,448375.9,777100
790340,921869.9,1332350,383260,484653.4,555250,407080,437216.5,777100
811080,950388.2,1332350,388230,493177.1,555250,422850,457211.1,777100
831760,981097,1332350,393190,501712.8,555250,438570,479384.2,777100
852490,965890.1,1332350,398120,499121.1,555250,454370,466769,777100
873200,999698.8,1332350,403110,509900.2,555250,470090,489798.6,777100
869910,990285.7,1332350,402520,507550.9,555250,467390,482734.8,777100
866630,1033373.7,1332350,401950,525592.3,555250,464680,507781.4,777100
863320,1039813.5,1332350,401410,527533.9,555250,461910,512279.6,777100
859930,1007997.9,1332350,400810,514811.3,555250,459120,493186.6,777100
862270,1005540.7,1332350,403710,514785.7,555250,458560,490755,777100
864550,1001173.6,1332350,406590,508100.9,555250,457960,493072.7,777100
866810,1004058.2,1332350,409460,516179.9,555250,457350,487878.3,777100
869040,994381.5,1332350,412340,515684.4,555250,456700,478697.1,777100
870510,1014943.8,1332350,416280,519921.8,555250,454230,495022,777100
871910,1011241.4,1332350,420210,519868.8,555250,451700,491372.6,777100
873390,1000427,1332350,424130,512976.8,555250,449260,487450.2,777100
874760,1014098.9,1332350,428060,518714.1,555250,446700,495384.8,777100
878470,1001352.6,1332350,430730,512912.5,555250,447740,488440.1,777100
882120,993385.3,1332350,433430,506135.8,555250,448690,487249.5,777100
885870,1017818.1,1332350,436100,513559.7,555250,449770,504258.4,777100
889490,1014555.2,1332350,438770,509359.9,555250,450720,505195.3,777100
892250,1026600.7,1332350,440960,525148.6,555250,451290,501452.1,777100
895030,1023633.9,1332350,443110,521007.2,555250,451920,502626.7,777100
897670,1033138.7,1332350,445310,528692.6,555250,452360,504446.1,777100
900420,1025955.1,1332350,447470,524010,555250,452950,501945.1,777100
902890,1005394.4,1332350,449340,521211.7,555250,453550,484182.7,777100
905380,1001748,1332350,451250,520010.4,555250,454130,481737.6,777100
907820,1014722.5,1332350,453140,530452.8,555250,454680,484269.7,777100
910350,994435.7,1332350,455040,522220.7,555250,455310,472215,777100
906140,988049.8,1332350,455110,519729.3,555250,451030,468320.5,777100
901960,993948,1332350,455200,526352.2,555250,446760,467595.8,777100
897750,985426.1,1332350,455270,524856.4,555250,442480,460569.7,777100
893520,1015210.1,1332350,455380,534482,555250,438140,480728.1,777100
887770,985349.6,1332350,455140,518594.7,555250,432630,466754.9,777100
881910,980778.9,1332350,454900,517481.3,555250,427010,463297.6,777100
876100,972809.2,1332350,454690,516757.6,555250,421410,456051.6,777100
870330,977249.9,1332350,454470,527543.6,555250,415860,449706.3,777100
862990,980624,1332350,453900,527096.5,555250,409090,453527.5,777100
855800,975100.3,1332350,453340,526354.3,555250,402460,448746,777100
848550,949383.9,1332350,452780,509734.7,555250,395770,439649.2,777100
841390,947702.1,1332350,452250,518151,555250,389140,429551.1,777100
832000,908425.1,1332350,450250,505244.8,555250,381750,403180.3,777100
822690,887406.9,1332350,448280,499223.2,555250,374410,388183.7,777100
813300,859810.6,1332350,446320,493171.7,555250,366980,366638.9,777100
803870,820235.3,1332350,444340,481454.4,555250,359530,338780.9,777100
796060,811505.3,1332350,442720,481928.8,555250,353340,329576.5,777100
788300,802012.7,1332350,441060,481874.7,555250,347240,320138,777100
780350,802277.9,1332350,439380,481396.7,555250,340970,320881.2,777100
772570,800137.2,1332350,437760,478460.6,555250,334810,321676.6,777100
766640,795375.9,1332350,436440,474017.7,555250,330200,321358.2,777100
760620,765122.8,1332350,435100,463765.2,555250,325520,301357.6,777100
754650,769243.1,1332350,433770,464487.8,555250,320880,304755.3,777100
748680,774411.8,1332350,432460,462578.4,555250,316220,311833.4,777100
745360,766503.5,1332350,430660,456531,555250,314700,309972.5,777100
742190,792690.6,1332350,428940,468494,555250,313250,324196.6,777100
738950,813042.2,1332350,427160,478439.8,555250,311790,334602.4,777100
637760,783246.7,1332350,394960,473954.6,555250,242800,309292.1,777100
629830,765605.8,1332350,391880,468865.3,555250,237950,296740.5,777100
621880,741300,1332350,388800,461768.3,555250,233080,279531.7,777100
613920,727963.8,1332350,385730,455590.4,555250,228190,272373.4,777100
606000,712394.7,1332350,382670,448145.7,555250,223330,264249,777100
597790,714115.7,1332350,379090,450081.7,555250,218700,264034,777100
589570,718718.1,1332350,375510,451225.9,555250,214060,267492.2,777100
581420,719961.1,1332350,371930,451667.9,555250,209490,268293.2,777100
573180,726617,1332350,368350,461086.7,555250,204830,265530.3,777100
565900,721704.7,1332350,363760,461043.7,555250,202140,260661,777100
558600,715390.6,1332350,359170,457098.8,555250,199430,258291.8,777100
551260,684137.1,1332350,354590,438010.5,555250,196670,246126.6,777100
543990,665487.5,1332350,349970,425823.5,555250,194020,239664,777100
537470,626216.1,1332350,345860,408558.8,555250,191610,217657.3,777100
530910,631226.7,1332350,341730,410295.4,555250,189180,220931.3,777100
524360,622731,1332350,337590,401587.2,555250,186770,221143.8,777100
517890,611495.1,1332350,333440,395080.6,555250,184450,216414.5,777100
510470,621341,1332350,329260,406433.4,555250,181210,214907.6,777100
503220,634329.7,1332350,325080,417091,555250,178140,217238.7,777100
495740,478478,1332350,320880,324353.3,555250,174860,154124.7,777100
488410,485224.8,1332350,316710,329916.1,555250,171700,155308.7,777100
477530,467915.1,1332350,311570,323690.5,555250,165960,144224.6,777100
466640,453540.7,1332350,306430,320435.6,555250,160210,133105.1,777100
455700,438598.5,1332350,301290,312514.7,555250,154410,126083.8,777100
444800,451436.1,1332350,296130,320749.3,555250,148670,130686.8,777100
435060,462435.3,1332350,291310,328109.5,555250,143750,134325.8,777100
425290,456310.8,1332350,286510,324440.4,555250,138780,131870.4,777100
415550,433553.4,1332350,281680,311514.8,555250,133870,122038.6,777100
405900,432597.7,1332350,276870,311103.7,555250,129030,121494,777100
392550,418812.5,1332350,270710,304052.9,555250,121840,114759.6,777100
379220,387594.6,1332350,264540,284005.2,555250,114680,103589.4,777100
365880,392219.6,1332350,258380,285834.5,555250,107500,106385.1,777100
352600,387437.8,1332350,252220,282205.4,555250,100380,105232.4,777100
346630,333420.8,1332350,249060,251095.8,555250,97570,82325,777100
340710,284484.3,1332350,245900,222486.8,555250,94810,61997.5,777100
334710,246100.3,1332350,242720,198494.2,555250,91990,47606.1,777100
328780,242034.4,1332350,239550,195990.4,555250,89230,46044,777100
325550,260482.9,1332350,236880,208619.1,555250,88670,51863.8,777100
322180,276310.9,1332350,234190,217019.9,555250,87990,59291,777100
318890,251512.8,1332350,231520,201295.5,555250,87370,50217.3,777100
315570,239570.7,1332350,228850,193152.3,555250,86720,46418.4,777100
311330,202387.8,1332350,226950,166190.6,555250,84380,36197.2,777100
306990,231600.7,1332350,225000,184465.7,555250,81990,47135,777100
302720,188245.2,1332350,223070,153326.8,555250,79650,34918.4,777100
298410,164558.9,1332350,221140,134715.3,555250,77270,29843.6,777100
286540,181458.3,1332350,212210,147989.3,555250,74330,33469,777100
274760,176877.9,1332350,203250,141267,555250,71510,35610.9,777100
262860,199109.5,1332350,194310,154403.6,555250,68550,44705.9,777100
250990,241078.1,1332350,185340,176122,555250,65650,64956.1,777100
240520,279178.7,1332350,177580,198761.1,555250,62940,80417.6,777100
230150,262776.3,1332350,169860,187144.1,555250,60290,75632.2,777100
219690,204599.6,1332350,162120,152641.2,555250,57570,51958.4,777100
209290,159144.6,1332350,154390,123417.6,555250,54900,35727,777100
197180,146001.4,1332350,145340,114892.9,555250,51840,31108.5,777100
185070,127688.2,1332350,136290,102422.9,555250,48780,25265.3,777100
173000,99171.3,1332350,127270,81946.8,555250,45730,17224.5,777100
160920,115444.7,1332350,118200,91342.4,555250,42720,24102.3,777100
152640,111804.2,1332350,113300,90510.5,555250,39340,21293.7,777100
144410,103783.9,1332350,108410,85215.7,555250,36000,18568.2,777100
136170,100935.5,1332350,103500,83318.2,555250,32670,17617.3,777100
127930,90416.6,1332350,98630,76688.9,555250,29300,13727.7,777100
120570,90885.6,1332350,94050,78159.5,555250,26520,12726.1,777100
113130,82753.7,1332350,89470,72382.4,555250,23660,10371.3,777100
105700,57918.3,1332350,84850,53734.1,555250,20850,4184.2,777100
98260,45316.4,1332350,80290,42643.7,555250,17970,2672.7,777100
91920,47750.2,1332350,76540,44786.7,555250,15380,2963.5,777100
85560,54337,1332350,72800,50190,555250,12760,4147,777100
79210,56327,1332350,69040,51474.2,555250,10170,4852.8,777100
72910,58344.3,1332350,65330,53292.3,555250,7580,5052,777100
67880,51508.4,1332350,60440,47863.6,555250,7440,3644.8,777100
62840,36724,1332350,55550,34428.9,555250,7290,2295.1,777100
57840,26347.7,1332350,50660,24687.4,555250,7180,1660.3,777100
52840,29353.3,1332350,45760,27218.6,555250,7080,2134.7,777100
46950,18882.6,1332350,39880,17106.3,555250,7070,1776.3,777100
41070,9947.9,1332350,34000,8272.2,555250,7070,1675.7,777100
35100,3178.1,1332350,28110,1509.1,555250,6990,1669,777100
29240,2342.8,1332350,22230,485.7,555250,7010,1857.1,777100
25060,5201.6,1332350,17720,1966.9,555250,7340,3234.7,777100
20780,5617.1,1332350,13200,1274.3,555250,7580,4342.8,777100
16490,8704,1332350,8670,2496.6,555250,7820,6207.4,777100
12340,14557.2,1332350,4160,4175.2,555250,8180,10382,777100
17850,20049.6,1332350,5110,4857.3,555250,12740,15192.3,777100
23450,23202.1,1332350,6060,6001.9,555250,17390,17200.2,777100
28930,23275.8,1332350,7010,5422.5,555250,21920,17853.3,777100
34530,23097.4,1332350,7980,4001.1,555250,26550,19096.3,777100
40720,25997.9,1332350,9250,4105.6,555250,31470,21892.3,777100
46840,33997.3,1332350,10510,5619.7,555250,36330,28377.6,777100
53040,42306.3,1332350,11780,7712.2,555250,41260,34594.1,777100
59240,51421.4,1332350,13060,10107.1,555250,46180,41314.3,777100
66030,60189.1,1332350,14730,11418.5,555250,51300,48770.6,777100
72870,63528.3,1332350,16410,10805.1,555250,56460,52723.2,777100
79580,72536.9,1332350,18080,14396,555250,61500,58140.9,777100
86440,78603.6,1332350,19770,15252.9,555250,66670,63350.7,777100
93950,77235.2,1332350,22970,15402.5,555250,70980,61832.7,777100
101480,83848,1332350,26180,18179.1,555250,75300,65668.9,777100
109010,89947.7,1332350,29410,21810.3,555250,79600,68137.4,777100
133660,98591.3,1332350,36340,24556,555250,97320,74035.3,777100
140430,106204.6,1332350,40110,28336,555250,100320,77868.6,777100
147140,118805.7,1332350,43880,35382.8,555250,103260,83422.9,777100
153920,118767.4,1332350,47670,32843.1,555250,106250,85924.3,777100
160660,119185.6,1332350,51460,32887.1,555250,109200,86298.5,777100
168390,109904.7,1332350,55970,30967.3,555250,112420,78937.4,777100
176130,117062.7,1332350,60480,35120.6,555250,115650,81942.1,777100
183900,137159.6,1332350,65000,48493.7,555250,118900,88665.9,777100
191550,151503.6,1332350,69540,59061.1,555250,122010,92442.5,777100
202330,163824.7,1332350,76880,67612.4,555250,125450,96212.3,777100
213100,197646.2,1332350,84220,86103.2,555250,128880,111543,777100
223890,241423.2,1332350,91570,109434,555250,132320,131989.2,777100
234620,244924.1,1332350,98920,113393.7,555250,135700,131530.4,777100
244070,265438.7,1332350,104990,127322.6,555250,139080,138116.1,777100
253590,267587.8,1332350,111110,133535.1,555250,142480,134052.7,777100
263070,355927.5,1332350,117180,189787.9,555250,145890,166139.6,777100
272580,398907.3,1332350,123300,213374.6,555250,149280,185532.7,777100
280550,399890.7,1332350,128750,213276.3,555250,151800,186614.4,777100
288680,355821,1332350,134220,188238.9,555250,154460,167582.1,777100
296770,363007.6,1332350,139670,190654.9,555250,157100,172352.7,777100
304890,378466.2,1332350,145170,199215.3,555250,159720,179250.9,777100
306200,410362.6,1332350,147900,221042.4,555250,158300,189320.2,777100
307490,513810.5,1332350,150640,282340.5,555250,156850,231470,777100
308810,563589.1,1332350,153390,307685.5,555250,155420,255903.6,777100
310020,621227.6,1332350,156100,342744.2,555250,153920,278483.4,777100
313980,633679.4,1332350,160480,354264.5,555250,153500,279414.9,777100
317980,548534.3,1332350,164840,305436.4,555250,153140,243097.9,777100
321950,491332.2,1332350,169200,276762.2,555250,152750,214570,777100
325850,454706.6,1332350,173580,261228,555250,152270,193478.6,777100
329070,393018.2,1332350,178070,231482.2,555250,151000,161536,777100
332260,369237.9,1332350,182550,221575.1,555250,149710,147662.8,777100
335420,286361.1,1332350,187050,173407.2,555250,148370,112953.9,777100
338650,217824.2,1332350,191560,138727.9,555250,147090,79096.3,777100
335100,185818.7,1332350,193150,123994.4,555250,141950,61824.3,777100
331650,183363.8,1332350,194710,125203.3,555250,136940,58160.5,777100
328100,150271.4,1332350,196300,106889.3,555250,131800,43382.1,777100
324580,137966.6,1332350,197870,103537.3,555250,126710,34429.3,777100
322300,160464.4,1332350,198790,121847.4,555250,123510,38617,777100
319980,190648.9,1332350,199640,142012,555250,120340,48636.9,777100
317640,203487,1332350,200520,152700.4,555250,117120,50786.6,777100
315310,189090.4,1332350,201380,145376.7,555250,113930,43713.7,777100
319460,153724.2,1332350,207550,125384.3,555250,111910,28339.9,777100
323630,185979.2,1332350,213720,148046,555250,109910,37933.2,777100
327780,298444.7,1332350,219870,218721.3,555250,107910,79723.4,777100
331930,317203.9,1332350,226040,231985.1,555250,105890,85218.8,777100
338270,325303.5,1332350,228930,235639.2,555250,109340,89664.3,777100
344650,303729.9,1332350,231790,216950.7,555250,112860,86779.2,777100
351010,306556.1,1332350,234660,211428.8,555250,116350,95127.3,777100
357310,335661.2,1332350,237540,231076.4,555250,119770,104584.8,777100
369750,409742.9,1332350,245710,279451.6,555250,124040,130291.3,777100
382200,457873,1332350,253900,317588.5,555250,128300,140284.5,777100
394560,465253,1332350,262100,329495.6,555250,132460,135757.4,777100
407020,476203,1332350,270270,340519.3,555250,136750,135683.7,777100
418350,504929,1332350,276830,355830,555250,141520,149099,777100
429590,473092.4,1332350,283360,337973.6,555250,146230,135118.8,777100
440850,446836.1,1332350,289900,318753,555250,150950,128083.1,777100
452170,399247,1332350,296460,293798.7,555250,155710,105448.3,777100
450390,479924.1,1332350,294470,331647,555250,155920,148277.1,777100
448540,538766.6,1332350,292460,354120.2,555250,156080,184646.4,777100
446650,567193.7,1332350,290430,356694.4,555250,156220,210499.3,777100
444860,567923,1332350,288430,363201.8,555250,156430,204721.2,777100
448210,532113.8,1332350,291720,348638.6,555250,156490,183475.2,777100
451540,553953.9,1332350,294960,369256.8,555250,156580,184697.1,777100
454940,528192.1,1332350,298230,359403.8,555250,156710,168788.3,777100
458250,528433.9,1332350,301540,360284.5,555250,156710,168149.4,777100
463970,524532.6,1332350,306860,363036.7,555250,157110,161495.9,777100
469780,506067.7,1332350,312210,354612.6,555250,157570,151455.1,777100
475530,488992.7,1332350,317560,349350.9,555250,157970,139641.8,777100
481280,541089.3,1332350,322880,379034.1,555250,158400,162055.2,777100
483130,579806.2,1332350,326080,407470.3,555250,157050,172335.9,777100
485040,571462.5,1332350,329250,404077.9,555250,155790,167384.6,777100
486910,534177,1332350,332470,388374.4,555250,154440,145802.6,777100
488740,534003.6,1332350,335620,393624.5,555250,153120,140379.1,777100
489460,515384.1,1332350,337790,385344.9,555250,151670,130039.2,777100
490110,492695.4,1332350,339960,372537.2,555250,150150,120158.2,777100
490840,483653.2,1332350,342120,370441.7,555250,148720,113211.5,777100
491620,507618.4,1332350,344290,387529.9,555250,147330,120088.5,777100
493970,498418.2,1332350,347450,383000,555250,146520,115418.2,777100
496280,464786.6,1332350,350600,364376.9,555250,145680,100409.7,777100
498640,474684.9,1332350,353770,372465.9,555250,144870,102219,777100
501020,471678,1332350,356910,370033.3,555250,144110,101644.7,777100
498350,473633.9,1332350,355250,366892.2,555250,143100,106741.7,777100
495690,443909,1332350,353610,344148.7,555250,142080,99760.3,777100
493010,406129.7,1332350,351940,316196.9,555250,141070,89932.8,777100
490290,413485.8,1332350,350260,319407.8,555250,140030,94078,777100
487720,463106.8,1332350,348590,350099,555250,139130,113007.8,777100
485190,482893.3,1332350,346930,362544,555250,138260,120349.3,777100
482640,456582.7,1332350,345240,350583.4,555250,137400,105999.3,777100
480120,443664.3,1332350,343560,340712.6,555250,136560,102951.7,777100
475300,364632,1332350,340550,291603.5,555250,134750,73028.5,777100
470600,353733.5,1332350,337530,287317.5,555250,133070,66416,777100
465850,355068,1332350,334540,289488.3,555250,131310,65579.7,777100
461070,360361.7,1332350,331550,294347.6,555250,129520,66014.1,777100
458610,328710.7,1332350,328660,274533.9,555250,129950,54176.8,777100
456000,332829.8,1332350,325770,280442.1,555250,130230,52387.7,777100
453540,318160.1,1332350,322880,270343.1,555250,130660,47817,777100
446550,270884.8,1332350,331430,238314.6,555250,115120,32570.2,777100
438060,235561.5,1332350,324460,210843.5,555250,113600,24718,777100
429560,294397.1,1332350,317490,254749.7,555250,112070,39647.4,777100
421060,308990.5,1332350,310520,256511.8,555250,110540,52478.7,777100
412640,344608.5,1332350,303560,269355.1,555250,109080,75253.4,777100
403070,365150.4,1332350,295980,283069.4,555250,107090,82081,777100
393570,192391.2,1332350,288410,163343.3,555250,105160,29047.9,777100
384000,138259.2,1332350,280860,116122.2,555250,103140,22137,777100
374480,149760.9,1332350,273320,134141.3,555250,101160,15619.6,777100
369200,153033.4,1332350,267640,141992.5,555250,101560,11040.9,777100
363840,187811,1332350,261960,170579.6,555250,101880,17231.4,777100
358520,197681.7,1332350,256320,174878.8,555250,102200,22802.9,777100
353200,216323.5,1332350,250640,183544.6,555250,102560,32778.9,777100
347330,188060.8,1332350,240560,158826.7,555250,106770,29234.1,777100
341510,137222.8,1332350,230510,120046.4,555250,111000,17176.4,777100
335550,117352.3,1332350,220460,103385.3,555250,115090,13967,777100
329730,127999.3,1332350,210410,109964.8,555250,119320,18034.5,777100
334490,100587.2,1332350,213540,89255.2,555250,120950,11332,777100
339210,88814.3,1332350,216660,78315,555250,122550,10499.3,777100
343860,73046.8,1332350,219780,62977.4,555250,124080,10069.4,777100
348710,85535,1332350,222930,70544,555250,125780,14991,777100
335320,86087.6,1332350,214290,71642.9,555250,121030,14444.7,777100
321950,94763.4,1332350,205670,79524.6,555250,116280,15238.8,777100
308640,130439,1332350,197040,106668.4,555250,111600,23770.6,777100
295270,148868,1332350,188410,115741.4,555250,106860,33126.6,777100
288100,125010.7,1332350,185720,99356.5,555250,102380,25654.2,777100
280910,102069.7,1332350,183020,80145.6,555250,97890,21924.1,777100
273780,99455,1332350,180300,78855.7,555250,93480,20599.3,777100
266650,107660.9,1332350,177610,89899.6,555250,89040,17761.3,777100
263280,142403.7,1332350,174930,114579.6,555250,88350,27824.1,777100
259950,112057.8,1332350,172230,91979,555250,87720,20078.8,777100
256620,112479.5,1332350,169570,93557.7,555250,87050,18921.8,777100
253340,104016.1,1332350,166890,89030.2,555250,86450,14985.9,777100
244470,91425.1,1332350,160700,80580.2,555250,83770,10844.9,777100
235730,80911.1,1332350,154560,72470.7,555250,81170,8440.4,777100
226810,61283.3,1332350,148390,56577.8,555250,78420,4705.5,777100
218010,52814.7,1332350,142250,48953.6,555250,75760,3861.1,777100
207480,64929.9,1332350,134510,59302.1,555250,72970,5627.8,777100
196940,50398.8,1332350,126760,46092.8,555250,70180,4306,777100
186450,55042.4,1332350,119020,49877.5,555250,67430,5164.9,777100
175950,37924.9,1332350,111310,34311.8,555250,64640,3613.1,777100
167460,26302.3,1332350,104410,23142.2,555250,63050,3160.1,777100
159000,18196.9,1332350,97600,15286.9,555250,61400,2910,777100
150560,14645.8,1332350,90750,12185.2,555250,59810,2460.6,777100
142090,9164.4,1332350,83900,7291.3,555250,58190,1873.1,777100
141820,3785.5,1332350,84610,2130,555250,57210,1655.5,777100
141370,3863.2,1332350,85270,2449.7,555250,56100,1413.5,777100
141050,1728.9,1332350,85950,384.5,555250,55100,1344.4,777100
140750,2422.3,1332350,86640,412.5,555250,54110,2009.8,777100
141040,6821.9,1332350,87530,4088.6,555250,53510,2733.3,777100
141310,8776.2,1332350,88380,6244.7,555250,52930,2531.5,777100
141620,13285.4,1332350,89290,10800.3,555250,52330,2485.1,777100
141980,18727.5,1332350,90150,16030.7,555250,51830,2696.8,777100
142200,14467.7,1332350,90870,12062.1,555250,51330,2405.6,777100
142470,9315.7,1332350,91600,7156.5,555250,50870,2159.2,777100
142750,5064.2,1332350,92330,2286,555250,50420,2778.2,777100
143000,3781.1,1332350,93040,1069.1,555250,49960,2712,777100
139030,3991.5,1332350,91950,1010,555250,47080,2981.5,777100
135020,3788.1,1332350,90870,991.1,555250,44150,2797,777100
131110,3596.4,1332350,89800,722.8,555250,41310,2873.6,777100
127080,3015.1,1332350,88750,635.8,555250,38330,2379.3,777100
124560,2713.6,1332350,88640,531.6,555250,35920,2182,777100
122030,2259.2,1332350,88550,425.4,555250,33480,1833.8,777100
119550,2229.6,1332350,88450,499.4,555250,31100,1730.2,777100
116950,2465.5,1332350,88310,690.4,555250,28640,1775.1,777100
115330,3276,1332350,88750,778,555250,26580,2498,777100
113730,3017.1,1332350,89200,727.7,555250,24530,2289.4,777100
112070,3124.3,1332350,89620,952.4,555250,22450,2171.9,777100
110470,3015.9,1332350,90070,788.1,555250,20400,2227.8,777100
112180,3404.6,1332350,92040,755.8,555250,20140,2648.8,777100
113960,4664.1,1332350,94030,2006.9,555250,19930,2657.2,777100
115770,4320.6,1332350,96020,1478.1,555250,19750,2842.5,777100
117450,3924.6,1332350,97990,769.9,555250,19460,3154.7,777100
117270,3775.9,1332350,98210,419.2,555250,19060,3356.7,777100
117210,4839.8,1332350,98440,1167.3,555250,18770,3672.5,777100
117030,4881.4,1332350,98620,1107.1,555250,18410,3774.3,777100
116880,5960.8,1332350,98860,2785.8,555250,18020,3175,777100
117180,17747.9,1332350,99040,15072,555250,18140,2675.9,777100
117420,29549.6,1332350,99200,26223.2,555250,18220,3326.4,777100
117690,27731.5,1332350,99390,23310.7,555250,18300,4420.8,777100
118060,28922.9,1332350,99560,24056.2,555250,18500,4866.7,777100
117110,28406.5,1332350,94160,23039.2,555250,22950,5367.3,777100
116130,28236.9,1332350,88770,21870.4,555250,27360,6366.5,777100
115200,19287.3,1332350,83380,12371.8,555250,31820,6915.5,777100
114290,13705.3,1332350,78020,7619.2,555250,36270,6086.1,777100
113900,20087.6,1332350,73370,14081,555250,40530,6006.6,777100
113390,17023.7,1332350,68660,10277.9,555250,44730,6745.8,777100
112980,7753.8,1332350,64060,314.1,555250,48920,7439.7,777100
112570,11330.5,1332350,59390,237.8,555250,53180,11092.7,777100
111540,17892.5,1332350,54280,2155.3,555250,57260,15737.2,777100
110550,28537.5,1332350,49160,7025.1,555250,61390,21512.4,777100
109480,32154.8,1332350,43990,2811.4,555250,65490,29343.4,777100
108430,39976.8,1332350,38890,2223.8,555250,69540,37753,777100
111720,48335.7,1332350,38570,3119,555250,73150,45216.7,777100
114920,60730.5,1332350,38210,7816.7,555250,76710,52913.8,777100
118090,64596.1,1332350,37880,8285.6,555250,80210,56310.5,777100
191590,72157.7,1332350,78660,13762.1,555250,112930,58395.6,777100
190950,72067.3,1332350,77140,12342.8,555250,113810,59724.5,777100
190300,82785.4,1332350,75620,19991.9,555250,114680,62793.5,777100
189680,92305.6,1332350,74160,22773.3,555250,115520,69532.3,777100
189040,104086.1,1332350,72650,26872.6,555250,116390,77213.5,777100
188530,110288.6,1332350,71090,32547.1,555250,117440,77741.5,777100
187960,105373.3,1332350,69550,32192.8,555250,118410,73180.5,777100
187400,104410.4,1332350,67990,28330.7,555250,119410,76079.7,777100
186830,104459.3,1332350,66440,21821.7,555250,120390,82637.6,777100
189200,89934.3,1332350,70450,13157.2,555250,118750,76777.1,777100
191550,89091.7,1332350,74420,17336.6,555250,117130,71755.1,777100
193840,83447.2,1332350,78410,19498.7,555250,115430,63948.5,777100
196220,84648.8,1332350,82430,21656.3,555250,113790,62992.5,777100
197150,65885.2,1332350,85090,11826.3,555250,112060,54058.9,777100
198040,56817.1,1332350,87740,8330,555250,110300,48487.1,777100
198950,43577.1,1332350,90390,2765,555250,108560,40812.1,777100
199890,39140.6,1332350,93060,3853.9,555250,106830,35286.7,777100
202660,37995.9,1332350,97120,9035.1,555250,105540,28960.8,777100
205520,50139.6,1332350,101170,10968.3,555250,104350,39171.3,777100
208360,54577.6,1332350,105260,11290,555250,103100,43287.6,777100
211160,52558.1,1332350,109330,7539.9,555250,101830,45018.2,777100
210660,58752.4,1332350,111230,17150.4,555250,99430,41602,777100
210310,83912.2,1332350,113190,45509.1,555250,97120,38403.1,777100
209850,98384.4,1332350,115080,53947.7,555250,94770,44436.7,777100
209390,105001.7,1332350,117010,56487,555250,92380,48514.7,777100
206300,97514.4,1332350,116360,52356.7,555250,89940,45157.7,777100
203230,85265.8,1332350,115730,45536.4,555250,87500,39729.4,777100
200120,107157.5,1332350,115130,57799.4,555250,84990,49358.1,777100
197030,106658.4,1332350,114480,51650.2,555250,82550,55008.2,777100
196960,171595.7,1332350,117020,78362.7,555250,79940,93233,777100
196890,215696.2,1332350,119520,102785.1,555250,77370,112911.1,777100
196800,217353,1332350,122030,110053.6,555250,74770,107299.4,777100
196740,174846.8,1332350,124520,82677.6,555250,72220,92169.2,777100
189740,100780.7,1332350,122260,39068.8,555250,67480,61711.9,777100
182840,75262,1332350,120010,26952.6,555250,62830,48309.4,777100
176020,74817.4,1332350,117730,28948.4,555250,58290,45869,777100
169090,75107.9,1332350,115490,31201.2,555250,53600,43906.7,777100
159600,75107.9,1332350,110480,31201.2,555250,49120,43906.7,777100
150180,123152.3,1332350,105460,75446.6,555250,44720,47705.7,777100
140740,147274.2,1332350,100450,84072.6,555250,40290,63201.6,777100
131230,233474.3,1332350,95410,131607.3,555250,35820,101867,777100
124520,240757.4,1332350,92430,139828,555250,32090,100929.4,777100
117650,164604.4,1332350,89430,96909,555250,28220,67695.4,777100
110970,121055.6,1332350,86440,65305.2,555250,24530,55750.4,777100
104190,75628.2,1332350,83440,42098,555250,20750,33530.2,777100
109940,124891.6,1332350,88280,59854.8,555250,21660,65036.8,777100
115690,108444,1332350,93120,53201.6,555250,22570,55242.4,777100
121460,93529.6,1332350,97950,50140.5,555250,23510,43389.1,777100
127250,104847.5,1332350,102790,62140.3,555250,24460,42707.2,777100
130620,123872.1,1332350,105120,79591.5,555250,25500,44280.6,777100
133930,217209.6,1332350,107430,133129,555250,26500,84080.6,777100
137280,218642.7,1332350,109730,133665,555250,27550,84977.7,777100
140630,322579.9,1332350,112040,198584.9,555250,28590,123995,777100
141750,410847.7,1332350,112690,257143.8,555250,29060,153703.9,777100
142860,291684.2,1332350,113350,187345.6,555250,29510,104338.6,777100
143940,118027.6,1332350,114000,84391.8,555250,29940,33635.8,777100
145070,137514.1,1332350,114650,106662.5,555250,30420,30851.6,777100
152690,98587.8,1332350,120110,70430.7,555250,32580,28157.1,777100
160410,84935.8,1332350,125600,63440.5,555250,34810,21495.3,777100
168050,86729.1,1332350,131110,59568.7,555250,36940,27160.4,777100
175730,84326.3,1332350,136550,59536,555250,39180,24790.3,777100
182660,75395.7,1332350,141160,51699.1,555250,41500,23696.6,777100
189550,71909.6,1332350,145800,43571.5,555250,43750,28338.1,777100
196420,91273.6,1332350,150360,61932,555250,46060,29341.6,777100
203270,92382.1,1332350,154970,64159.1,555250,48300,28223,777100
212160,114636,1332350,161550,72381.6,555250,50610,42254.4,777100
221020,92674.8,1332350,168120,52680.5,555250,52900,39994.3,777100
229890,71296.8,1332350,174670,37570.4,555250,55220,33726.4,777100
238800,72908.3,1332350,181250,47995.1,555250,57550,24913.2,777100
245860,76049.5,1332350,185740,52654.5,555250,60120,23395,777100
252970,82468.9,1332350,190230,53444.3,555250,62740,29024.6,777100
260020,90262.7,1332350,194710,65112.5,555250,65310,25150.2,777100
267140,101791.8,1332350,199200,73948.3,555250,67940,27843.5,777100
270250,114779.5,1332350,200930,84933.2,555250,69320,29846.3,777100
273290,128380.5,1332350,202650,99394.8,555250,70640,28985.7,777100
276390,153885.6,1332350,204370,125990.7,555250,72020,27894.9,777100
279520,174562.8,1332350,206120,149361.9,555250,73400,25200.9,777100
278580,189195,1332350,202660,160958.5,555250,75920,28236.5,777100
277600,221299.1,1332350,199190,181978.5,555250,78410,39320.6,777100
276710,208858.7,1332350,195750,171838.4,555250,80960,37020.3,777100
275790,233717.4,1332350,192280,183672.3,555250,83510,50045.1,777100
280960,181913.5,1332350,195410,149623.5,555250,85550,32290,777100
286120,167830,1332350,198530,139544.6,555250,87590,28285.4,777100
291240,180033.3,1332350,201670,143578.6,555250,89570,36454.7,777100
296500,183459.3,1332350,204770,138873.9,555250,91730,44585.4,777100
299820,209012.2,1332350,207000,149356.1,555250,92820,59656.1,777100
303200,209459,1332350,209210,145372.9,555250,93990,64086.1,777100
306530,151592.1,1332350,211450,95372.8,555250,95080,56219.3,777100
309890,112406,1332350,213680,58021.9,555250,96210,54384.1,777100
309620,104414.5,1332350,212520,49654.6,555250,97100,54759.9,777100
309350,133471.8,1332350,211390,71522.6,555250,97960,61949.2,777100
309050,153103.7,1332350,210240,84496.4,555250,98810,68607.3,777100
308710,130441.9,1332350,209090,71522.4,555250,99620,58919.5,777100
309250,100626.6,1332350,210250,61085.6,555250,99000,39541,777100
309700,87107.2,1332350,211330,55555.2,555250,98370,31552,777100
310220,97945,1332350,212470,67181.9,555250,97750,30763.1,777100
289890,170330.4,1332350,194350,118599.3,555250,95540,51731.1,777100
281740,245281.2,1332350,192980,154432.9,555250,88760,90848.3,777100
273600,306958.7,1332350,191600,200138.5,555250,82000,106820.2,777100
265490,404798.4,1332350,190250,266785.2,555250,75240,138013.2,777100
257330,358841.1,1332350,188850,222777.9,555250,68480,136063.2,777100
243740,252644.4,1332350,180690,159052.7,555250,63050,93591.7,777100
230070,215867.8,1332350,172520,143538.3,555250,57550,72329.5,777100
216370,246382.6,1332350,164340,165191.7,555250,52030,81190.9,777100
202790,316178.7,1332350,156170,218135.6,555250,46620,98043.1,777100
204420,238262.3,1332350,156460,177993.5,555250,47960,60268.8,777100
206000,204941.5,1332350,156730,160733.3,555250,49270,44208.2,777100
207560,217224,1332350,157000,167385.8,555250,50560,49838.2,777100
209170,213054.5,1332350,157260,164303.3,555250,51910,48751.2,777100
208040,205964.1,1332350,156200,147760.9,555250,51840,58203.2,777100
206920,170197.7,1332350,155130,125995.7,555250,51790,44202,777100
205930,139491.3,1332350,154080,110226.9,555250,51850,29264.4,777100
204900,158304.8,1332350,153020,115813.2,555250,51880,42491.6,777100
206760,160456,1332350,152970,111195.4,555250,53790,49260.6,777100
208750,169731,1332350,152910,120264.7,555250,55840,49466.3,777100
210760,136369.8,1332350,152870,105444.4,555250,57890,30925.4,777100
212710,99255.3,1332350,152810,79757.2,555250,59900,19498.1,777100
210030,84536.6,1332350,151940,66956.3,555250,58090,17580.3,777100
207440,65519.9,1332350,151080,51789,555250,56360,13730.9,777100
204720,46238.9,1332350,150210,33757.7,555250,54510,12481.2,777100
202030,41448.6,1332350,149360,31028.8,555250,52670,10419.8,777100
200980,33382.1,1332350,148040,24237,555250,52940,9145.1,777100
199980,42293.8,1332350,146750,28542.8,555250,53230,13751,777100
198970,45024.5,1332350,145460,32895.8,555250,53510,12128.7,777100
197890,42120.5,1332350,144170,27980.8,555250,53720,14139.7,777100
208520,33783.2,1332350,154420,25050.7,555250,54100,8732.5,777100
219130,35959.2,1332350,164660,31261.9,555250,54470,4697.3,777100
229800,50264.7,1332350,174900,45227.6,555250,54900,5037.1,777100
240420,53399.1,1332350,185180,45464.6,555250,55240,7934.5,777100
216680,70284.3,1332350,164780,58983.1,555250,51900,11301.2,777100
193000,93115.9,1332350,144420,71018.1,555250,48580,22097.8,777100
169320,102405,1332350,124060,64834.9,555250,45260,37570.1,777100
145530,147375.6,1332350,103670,82160.3,555250,41860,65215.3,777100
135850,217495.5,1332350,94680,116490.6,555250,41170,101004.9,777100
126010,268423,1332350,85660,136237.5,555250,40350,132185.5,777100
116260,250330.5,1332350,76670,121264.7,555250,39590,129065.8,777100
106520,243443.1,1332350,67680,121897.6,555250,38840,121545.5,777100
98630,240459.6,1332350,60050,110297.6,555250,38580,130162,777100
90880,238084.6,1332350,52400,110384.9,555250,38480,127699.7,777100
82980,218460.9,1332350,44750,93268.6,555250,38230,125192.3,777100
75220,180987.7,1332350,37140,74637.2,555250,38080,106350.5,777100
72610,130959.8,1332350,35260,48007.5,555250,37350,82952.3,777100
69860,110263,1332350,33340,34933.7,555250,36520,75329.3,777100
67200,106054.8,1332350,31430,28519.4,555250,35770,77535.4,777100
64550,103513.3,1332350,29540,19987.8,555250,35010,83525.5,777100
61860,79446.2,1332350,27570,11998.7,555250,34290,67447.5,777100
59230,62737.4,1332350,25650,8014.9,555250,33580,54722.5,777100
56630,49323.3,1332350,23720,13911.3,555250,32910,35412,777100
53940,42518,1332350,21780,10923.7,555250,32160,31594.3,777100
51290,69327,1332350,20080,26615.4,555250,31210,42711.6,777100
48670,71036,1332350,18400,18571.8,555250,30270,52464.2,777100
46030,22425.9,1332350,16690,1695.6,555250,29340,20730.3,777100
43490,29851,1332350,15010,2343.5,555250,28480,27507.5,777100
44320,29209.9,1332350,16090,1267,555250,28230,27942.9,777100
45140,28883.6,1332350,17150,761.5,555250,27990,28122.1,777100
46020,19771,1332350,18230,988,555250,27790,18783,777100
46850,21178,1332350,19310,2577.8,555250,27540,18600.2,777100
47220,24412.9,1332350,20050,4228.5,555250,27170,20184.4,777100
47690,23476.6,1332350,20830,4497.1,555250,26860,18979.5,777100
48090,32978.4,1332350,21570,9441.6,555250,26520,23536.8,777100
48510,45068.9,1332350,22340,13980,555250,26170,31088.9,777100
48750,50300.3,1332350,23150,14785,555250,25600,35515.3,777100
49190,64790.6,1332350,24000,23767,555250,25190,41023.6,777100
49510,55823.8,1332350,24820,19083.6,555250,24690,36740.2,777100
49850,31690.7,1332350,25640,8495.4,555250,24210,23195.3,777100
51370,29044,1332350,25250,9155.5,555250,26120,19888.5,777100
52830,40025.1,1332350,24850,18039.9,555250,27980,21985.2,777100
54350,40513.5,1332350,24470,16338.7,555250,29880,24174.8,777100
55850,27229.8,1332350,24090,7512,555250,31760,19717.8,777100
57400,25874.8,1332350,23680,7350,555250,33720,18524.8,777100
59030,20822.3,1332350,23280,4696.9,555250,35750,16125.4,777100
60590,16104.2,1332350,22870,1277.1,555250,37720,14827.1,777100
62130,15660.5,1332350,22440,992.8,555250,39690,14667.7,777100
62860,17811.3,1332350,22010,2059.2,555250,40850,15752.1,777100
63680,18896.7,1332350,21600,2363.9,555250,42080,16532.8,777100
64360,26340.1,1332350,21160,3049.6,555250,43200,23290.5,777100
65090,38034.9,1332350,20710,6163.4,555250,44380,31871.5,777100
70690,46506.5,1332350,21300,10490.3,555250,49390,36016.2,777100
76310,50229,1332350,21880,7940.5,555250,54430,42288.5,777100
81870,58768.7,1332350,22410,9186.4,555250,59460,49582.3,777100
87480,95797.1,1332350,23010,18414.3,555250,64470,77382.8,777100
93080,110281.4,1332350,23700,19513,555250,69380,90768.4,777100
98680,136006.8,1332350,24340,28566.3,555250,74340,107440.5,777100
104340,147804.9,1332350,25020,38870.3,555250,79320,108934.6,777100
110000,160321.5,1332350,25690,42541.8,555250,84310,117779.7,777100
116540,168585.8,1332350,26510,44971,555250,90030,123614.8,777100
122900,127568.6,1332350,27340,29220.5,555250,95560,98348.1,777100
129410,108995.2,1332350,28140,21577.7,555250,101270,87417.5,777100
135870,99041,1332350,28960,17976.3,555250,106910,81064.7,777100
143140,96149.2,1332350,32910,12259.2,555250,110230,83890,777100
150430,94048,1332350,36880,14503.2,555250,113550,79544.8,777100
157760,84036.3,1332350,40830,8219.4,555250,116930,75816.9,777100
219130,81469.6,1332350,80340,15327.2,555250,138790,66142.4,777100
227830,97494.9,1332350,83310,25267.1,555250,144520,72227.8,777100
236640,110212.4,1332350,86300,30208.7,555250,150340,80003.7,777100
245450,112238.9,1332350,89290,25286.4,555250,156160,86952.5,777100
254160,88134.9,1332350,92260,13389.7,555250,161900,74745.2,777100
267710,77592.4,1332350,99000,8586,555250,168710,69006.4,777100
281280,80927.9,1332350,105730,7874.1,555250,175550,73053.8,777100
294840,102115.6,1332350,112490,15817.1,555250,182350,86298.5,777100
308380,150156.3,1332350,119220,38242.3,555250,189160,111914,777100
322290,220805.2,1332350,127780,75625.2,555250,194510,145180,777100
336300,293128.5,1332350,136350,121391.1,555250,199950,171737.4,777100
350290,305860.2,1332350,144910,129429.1,555250,205380,176431.1,777100
364240,328334.4,1332350,153470,138218.4,555250,210770,190116,777100
375920,309492.5,1332350,160370,126566.5,555250,215550,182926,777100
387520,328608.9,1332350,167250,134267.4,555250,220270,194341.5,777100
399240,330710.7,1332350,174130,129410.1,555250,225110,201300.6,777100
410830,344150.8,1332350,181010,138557.5,555250,229820,205593.3,777100
419270,433213.7,1332350,186960,188627.8,555250,232310,244585.9,777100
427690,474684.8,1332350,192900,225819.7,555250,234790,248865.1,777100
436040,525089.5,1332350,198850,262529.3,555250,237190,262560.2,777100
444420,669155.9,1332350,204770,348448.3,555250,239650,320707.6,777100
449290,761289.5,1332350,209000,403188.7,555250,240290,358100.8,777100
454040,799038,1332350,213210,430021.5,555250,240830,369016.5,777100
458810,808970.7,1332350,217410,439440,555250,241400,369530.7,777100
463620,799899.9,1332350,221610,439130.2,555250,242010,360769.7,777100
471610,764804.6,1332350,229750,425570.4,555250,241860,339234.2,777100
479590,680123.3,1332350,237900,386263.9,555250,241690,293859.4,777100
487510,574327.7,1332350,246030,327466.3,555250,241480,246861.4,777100
495450,555422.6,1332350,254160,313774.2,555250,241290,241648.4,777100
504280,551151,1332350,262250,319254.4,555250,242030,231896.6,777100
513180,587113.2,1332350,270350,345098.3,555250,242830,242014.9,777100
522010,568594.9,1332350,278450,337905.1,555250,243560,230689.8,777100
530830,566312.4,1332350,286540,336908.4,555250,244290,229404,777100
534550,566752.5,1332350,289280,329886.9,555250,245270,236865.6,777100
538310,528992.2,1332350,292040,315896.2,555250,246270,213096,777100
542070,518988.8,1332350,294770,315788.5,555250,247300,203200.3,777100
545840,482214.5,1332350,297530,294929.1,555250,248310,187285.4,777100
554820,393528.2,1332350,303530,245444,555250,251290,148084.2,777100
563750,434719.4,1332350,309530,275922.3,555250,254220,158797.1,777100
572570,456718.9,1332350,315480,285611.6,555250,257090,171107.3,777100
581580,427256,1332350,321490,266495.5,555250,260090,160760.5,777100
587210,339577.7,1332350,325400,213372.5,555250,261810,126205.2,777100
592950,333630.6,1332350,329340,213232.5,555250,263610,120398.1,777100
598500,383909.5,1332350,333240,244455.9,555250,265260,139453.6,777100
604140,486441.1,1332350,337180,301839.2,555250,266960,184601.9,777100
616710,480579.2,1332350,340250,288128.9,555250,276460,192450.3,777100
629130,504191.3,1332350,343310,298081.2,555250,285820,206110.1,777100
641570,531018.4,1332350,346360,308939.5,555250,295210,222078.9,777100
654010,577823.9,1332350,349430,336061.8,555250,304580,241762.1,777100
664270,615047.6,1332350,352400,356605,555250,311870,258442.6,777100
674630,610859.6,1332350,355380,353274.3,555250,319250,257585.3,777100
684920,602564.3,1332350,358330,349500.3,555250,326590,253064,777100
695220,619296.6,1332350,361310,343537,555250,333910,275759.6,777100
705900,620821.3,1332350,364940,335368.1,555250,340960,285453.2,777100
716490,663310.8,1332350,368560,364517.7,555250,347930,298793.1,777100
727130,743560.6,1332350,372200,412567.1,555250,354930,330993.5,777100
737890,792783.3,1332350,375850,437030.5,555250,362040,355752.8,777100
745430,813904.6,1332350,376810,441434.5,555250,368620,372470.1,777100
752870,866694.8,1332350,377730,468049.8,555250,375140,398645,777100
760410,837556.4,1332350,378700,452855.1,555250,381710,384701.3,777100
767920,806865.1,1332350,379620,426439.4,555250,388300,380425.7,777100
774280,817521.5,1332350,380120,429060.8,555250,394160,388460.7,777100
780580,809758.4,1332350,380570,433085.4,555250,400010,376673,777100
786860,822449,1332350,381060,438565,555250,405800,383884,777100
793190,865298.7,1332350,381560,461419.7,555250,411630,403879,777100
798050,873544.5,1332350,382320,461957.5,555250,415730,411587,777100
802960,883632.1,1332350,383130,471545.9,555250,419830,412086.2,777100
807850,897348.9,1332350,383910,479337.9,555250,423940,418011,777100
812770,914732.3,1332350,384700,488835.9,555250,428070,425896.4,777100
794350,882112.9,1332350,383100,480666.4,555250,411250,401446.5,777100
775990,890363,1332350,381490,492744,555250,394500,397619,777100
757570,856643.7,1332350,379890,482093.2,555250,377680,374550.5,777100
739170,805527.7,1332350,378310,459430.5,555250,360860,346097.2,777100
720530,838609.4,1332350,375470,480547.7,555250,345060,358061.7,777100
701670,828574.3,1332350,372640,479975.1,555250,329030,348599.2,777100
682930,785526.1,1332350,369800,462709.8,555250,313130,322816.3,777100
664150,773753.5,1332350,366990,456538.9,555250,297160,317214.6,777100
646920,769614.6,1332350,364160,456812.5,555250,282760,312802.1,777100
629580,725431.8,1332350,361360,448270.1,555250,268220,277161.7,777100
612310,700713.2,1332350,358530,443193.8,555250,253780,257519.4,777100
595000,658948.8,1332350,355710,417612.1,555250,239290,241336.7,777100
593540,616457.5,1332350,355680,395254.7,555250,237860,221202.8,777100
592100,625446.5,1332350,355650,404027.4,555250,236450,221419.1,777100
590540,677622.9,1332350,355610,437295.7,555250,234930,240327.2,777100
589070,680129.2,1332350,355590,443519.2,555250,233480,236610,777100
586690,670621.5,1332350,356150,439952.7,555250,230540,230668.8,777100
584340,649442.4,1332350,356740,430930.7,555250,227600,218511.7,777100
582060,651438.4,1332350,357340,433067.2,555250,224720,218371.2,777100
579650,681100.8,1332350,357910,450750.7,555250,221740,230350.1,777100
579230,670108.9,1332350,358960,449311.1,555250,220270,220797.8,777100
578910,691100.8,1332350,360090,461877.5,555250,218820,229223.3,777100
578460,670842.1,1332350,361150,447236.3,555250,217310,223605.8,777100
578060,670937.8,1332350,362250,445943.6,555250,215810,224994.2,777100
580620,690533.7,1332350,362900,452635.7,555250,217720,237898,777100
583140,688625.2,1332350,363570,451043.7,555250,219570,237581.5,777100
585720,713077,1332350,364280,457404.8,555250,221440,255672.2,777100
568490,713696.1,1332350,353970,451517.2,555250,214520,262178.9,777100
572590,747176.3,1332350,354220,467413.5,555250,218370,279762.8,777100
576600,754945.5,1332350,354460,466009.7,555250,222140,288935.8,777100
580690,748907.1,1332350,354720,460730.5,555250,225970,288176.6,777100
584770,716267.6,1332350,354990,442962.7,555250,229780,273304.9,777100
590420,752428.5,1332350,356750,459574.1,555250,233670,292854.4,777100
596160,778249.3,1332350,358520,471866.7,555250,237640,306382.6,777100
601800,759849.5,1332350,360290,462440,555250,241510,297409.5,777100
607400,762468.3,1332350,362060,466209.2,555250,245340,296259.1,777100
607570,769257.9,1332350,362300,468754.7,555250,245270,300503.2,777100
607630,761815.3,1332350,362470,467162.8,555250,245160,294652.5,777100
607710,744883.4,1332350,362700,458854.5,555250,245010,286028.9,777100
607790,749841.4,1332350,362920,462491.1,555250,244870,287350.3,777100
606320,735884.1,1332350,362870,456333.9,555250,243450,279550.2,777100
604890,737371.2,1332350,362830,462148.9,555250,242060,275222.3,777100
603460,737857.4,1332350,362780,463596.5,555250,240680,274260.9,777100
602030,726765.5,1332350,362750,456119.9,555250,239280,270645.6,777100
602960,719915,1332350,364630,453999.9,555250,238330,265915.1,777100
603960,688709.1,1332350,366520,434980.9,555250,237440,253728.2,777100
604890,691246.4,1332350,368410,442675.7,555250,236480,248570.7,777100
605870,697551,1332350,370260,446671.9,555250,235610,250879.1,777100
602070,650916.1,1332350,367600,419924.4,555250,234470,230991.7,777100
598210,661739.5,1332350,364910,428691.5,555250,233300,233048,777100
594370,662895.9,1332350,362240,427625,555250,232130,235270.9,777100
590520,637603.4,1332350,359530,414077.8,555250,230990,223525.6,777100
588040,550486.4,1332350,358320,361309.9,555250,229720,189176.5,777100
585590,584295.4,1332350,357110,380872.7,555250,228480,203422.7,777100
583050,599858.3,1332350,355880,387976.5,555250,227170,211881.8,777100
580590,569323.6,1332350,354660,366189.5,555250,225930,203134.1,777100
578570,554663.3,1332350,353530,356026.7,555250,225040,198636.6,777100
576520,567664.7,1332350,352400,360953,555250,224120,206711.7,777100
574600,653877.9,1332350,351240,409305.4,555250,223360,244572.5,777100
572590,655201.3,1332350,350120,411646.9,555250,222470,243554.4,777100
596640,696766.5,1332350,354600,427340.4,555250,242040,269426.1,777100
620710,709053.8,1332350,359070,431273,555250,261640,277780.8,777100
644840,698866.3,1332350,363550,419303.7,555250,281290,279562.6,777100
668820,704563.5,1332350,368030,414962.1,555250,300790,289601.4,777100
697490,699690.7,1332350,376100,405882.4,555250,321390,293808.3,777100
726130,763483.7,1332350,384100,432919.1,555250,342030,330564.6,777100
754790,711032.8,1332350,392130,398109.8,555250,362660,312923,777100
783400,665689.3,1332350,400140,361369.5,555250,383260,304319.8,777100
812160,707200.5,1332350,407880,367906.2,555250,404280,339294.3,777100
840940,715843.4,1332350,415600,371693.3,555250,425340,344150.1,777100
869720,788825.6,1332350,423310,403910.6,555250,446410,384915,777100
898500,893730.7,1332350,431040,459160.9,555250,467460,434569.8,777100
910740,908415.4,1332350,435320,466232.2,555250,475420,442183.2,777100
922990,881801.6,1332350,439630,441092.4,555250,483360,440709.2,777100
935150,863760.7,1332350,443880,422365.6,555250,491270,441395.1,777100
947400,1021208.6,1332350,448170,501872.8,555250,499230,519335.8,777100
958230,1095653.7,1332350,451870,545465.9,555250,506360,550187.8,777100
969160,1101822.6,1332350,455540,544951.8,555250,513620,556870.8,777100
980000,1093493.9,1332350,459220,546266.7,555250,520780,547227.2,777100
990880,1098092.1,1332350,462880,549999.2,555250,528000,548092.9,777100
999680,1108552.5,1332350,465360,552150.9,555250,534320,556401.6,777100
1008370,1078271.8,1332350,467810,537940.8,555250,540560,540331,777100
1017220,1063857.4,1332350,470310,530571.7,555250,546910,533285.7,777100
1025990,1085430,1332350,472770,550867.7,555250,553220,534562.3,777100
1026280,1079438.3,1332350,473480,543399.9,555250,552800,536038.4,777100
1026620,1071531.8,1332350,474210,534695.4,555250,552410,536836.4,777100
1026920,1084666.3,1332350,474920,547705.6,555250,552000,536960.7,777100
1027300,1076307.4,1332350,475640,537438.9,555250,551660,538868.5,777100
1026260,1079446.9,1332350,475420,538740.2,555250,550840,540706.7,777100
1025170,1091370.2,1332350,475170,542588.7,555250,550000,548781.5,777100
1024140,1077388.8,1332350,474960,537413.6,555250,549180,539975.2,777100
1023110,1063038,1332350,474730,528182.6,555250,548380,534855.4,777100
1020320,1043543.3,1332350,474110,519785.6,555250,546210,523757.7,777100
1017550,1063454.8,1332350,473500,528982.9,555250,544050,534471.9,777100
1014740,1092666.1,1332350,472890,549469,555250,541850,543197.1,777100
1012010,1086959.3,1332350,472280,553469,555250,539730,533490.3,777100
1012180,1102751.3,1332350,473480,556796.8,555250,538700,545954.5,777100
1012350,1091107,1332350,474650,550971.1,555250,537700,540135.9,777100
1012500,1090887.2,1332350,475820,547619.2,555250,536680,543268,777100
1012700,1084191.5,1332350,477020,548603.2,555250,535680,535588.3,777100
1012510,1069969.4,1332350,477970,541453.7,555250,534540,528515.7,777100
1012360,1060494.5,1332350,478950,537998.3,555250,533410,522496.2,777100
1012230,1049477.5,1332350,479940,541222.2,555250,532290,508255.3,777100
1011990,1047615,1332350,480900,547284.2,555250,531090,500330.8,777100
1010960,1042615.7,1332350,481430,542244.7,555250,529530,500371,777100
1009880,1014528.9,1332350,481970,537776.1,555250,527910,476752.8,777100
1008850,1016143.9,1332350,482500,536410.2,555250,526350,479733.7,777100
1007770,1025925.7,1332350,483040,542042,555250,524730,483883.7,777100
1000840,1035521.9,1332350,481510,547411.7,555250,519330,488110.2,777100
993850,1019932.9,1332350,480000,542156.7,555250,513850,477776.2,777100
986870,984640.2,1332350,478500,526934.4,555250,508370,457705.8,777100
979820,948560.4,1332350,476940,507337,555250,502880,441223.4,777100
972720,903930.7,1332350,475600,490903.1,555250,497120,413027.6,777100
965550,888967.9,1332350,474270,480171.6,555250,491280,408796.3,777100
958400,892286.5,1332350,472920,483501.1,555250,485480,408785.4,777100
951240,887360.6,1332350,471550,484529.6,555250,479690,402831,777100
945320,879486.6,1332350,470100,488180.2,555250,475220,391306.4,777100
939290,859762.7,1332350,468590,484513.6,555250,470700,375249.1,777100
933400,836082.7,1332350,467120,473764.7,555250,466280,362318,777100
927420,834282.5,1332350,465650,476392.8,555250,461770,357889.7,777100
924090,826528.9,1332350,464840,476622.6,555250,459250,349906.3,777100
920700,817977.1,1332350,464010,478453.4,555250,456690,339523.7,777100
917340,822442.4,1332350,463190,481108.9,555250,454150,341333.5,777100
917170,847198.7,1332350,457950,487852.8,555250,459220,359345.9,777100
918030,884869,1332350,459000,496456.9,555250,459030,388412.1,777100
918880,894231.8,1332350,460050,498927.8,555250,458830,395304,777100
919770,905221.6,1332350,461100,503835.5,555250,458670,401386.1,777100
920540,896129.2,1332350,462150,505615.3,555250,458390,390513.9,777100
921530,882636.9,1332350,463080,497312.7,555250,458450,385324.2,777100
922490,884846.5,1332350,464000,500163,555250,458490,384683.5,777100
923460,892626.9,1332350,464940,506857.2,555250,458520,385769.7,777100
924450,900696.7,1332350,465860,513598.9,555250,458590,387097.8,777100
929790,901643.3,1332350,467440,516401.9,555250,462350,385241.4,777100
935230,894566.5,1332350,469040,518989.6,555250,466190,375576.9,777100
940570,902286,1332350,470610,516950.3,555250,469960,385335.7,777100
945990,894068.1,1332350,472210,508855.5,555250,473780,385212.6,777100
951540,902556.1,1332350,473790,514697.5,555250,477750,387858.6,777100
957200,914003.8,1332350,475370,517120.9,555250,481830,396882.9,777100
962770,941422.8,1332350,476950,528990.8,555250,485820,412432,777100
968370,960674.2,1332350,478550,534096.9,555250,489820,426577.3,777100
973480,963020.7,1332350,479610,526585.8,555250,493870,436434.9,777100
978460,981517.3,1332350,480700,535339.3,555250,497760,446178,777100
983490,987133.8,1332350,481750,538208.6,555250,501740,448925.2,777100
988580,990488.7,1332350,482830,534249.6,555250,505750,456239.1,777100
994560,983710.6,1332350,483580,528811.7,555250,510980,454898.9,777100
1000440,1008585.1,1332350,484310,539808.6,555250,516130,468776.5,777100
1006460,1028386.6,1332350,485050,549563.8,555250,521410,478822.8,777100
1012370,1019688.6,1332350,485790,547096.9,555250,526580,472591.7,777100
1019430,1017262.1,1332350,486710,543826.1,555250,532720,473436,777100
1026460,1050163.4,1332350,487590,558667.7,555250,538870,491495.7,777100
1033450,1057898.5,1332350,488510,558460,555250,544940,499438.5,777100
1040400,1062235.8,1332350,489400,555545.8,555250,551000,506690,777100
1046370,1061255.4,1332350,489390,552271.4,555250,556980,508984,777100
1052210,1077842.9,1332350,489360,558502.4,555250,562850,519340.5,777100
1058150,1089078.4,1332350,489320,562991.8,555250,568830,526086.6,777100
1064010,1082230.5,1332350,489290,557598.1,555250,574720,524632.4,777100
1062660,1074626.2,1332350,485330,551433.4,555250,577330,523192.8,777100
1061310,1082179.1,1332350,481360,553544.2,555250,579950,528634.9,777100
1059920,1072616.4,1332350,477390,547438.9,555250,582530,525177.5,777100
1058480,1084735.6,1332350,473400,553353.6,555250,585080,531382,777100
1058380,1087916.3,1332350,470800,553909.7,555250,587580,534006.6,777100
1058140,1086357.1,1332350,468120,549589.6,555250,590020,536767.5,777100
1057960,1106005,1332350,465500,556462.6,555250,592460,549542.4,777100
1057830,1101471.3,1332350,462850,554883.4,555250,594980,546587.9,777100
1056730,1090581,1332350,459960,548336.7,555250,596770,542244.3,777100
1055590,1066982.9,1332350,457090,537014.2,555250,598500,529968.7,777100
1054580,1077575.6,1332350,454220,540044.5,555250,600360,537531.1,777100
1053420,1083273.6,1332350,451340,542608.8,555250,602080,540664.8,777100
1048270,1089343.1,1332350,449880,545762.2,555250,598390,543580.9,777100
1043140,1072566.3,1332350,448420,535672.2,555250,594720,536894.1,777100
1037910,1045017.4,1332350,446960,517898.2,555250,590950,527119.2,777100
1032700,1040842.6,1332350,445500,513477.7,555250,587200,527364.9,777100
1026080,1072174.9,1332350,442470,532599.1,555250,583610,539575.8,777100
1019290,1064830.7,1332350,439380,532325.3,555250,579910,532505.4,777100
1012470,1069648,1332350,436310,532038.8,555250,576160,537609.2,777100
1005750,1080732,1332350,433270,537105.2,555250,572480,543626.8,777100
1000090,1065074.3,1332350,431710,530350.6,555250,568380,534723.7,777100
994480,1059503.9,1332350,430170,529897.2,555250,564310,529606.7,777100
988820,1068185.3,1332350,428600,534861.6,555250,560220,533323.7,777100
983190,1078330.3,1332350,427070,537187.5,555250,556120,541142.8,777100
981370,1070487.5,1332350,428310,532769.8,555250,553060,537717.7,777100
979570,1091989.8,1332350,429560,543526.8,555250,550010,548463,777100
977720,1068224.7,1332350,430800,541605.6,555250,546920,526619.1,777100
976000,1042686.3,1332350,432070,527595.1,555250,543930,515091.2,777100
972380,1035443.7,1332350,432240,529326.5,555250,540140,506117.2,777100
968720,1032127.7,1332350,432390,531343.7,555250,536330,500784,777100
965120,1013190.9,1332350,432570,530790.9,555250,532550,482400,777100
961510,1040281,1332350,432740,545084.4,555250,528770,495196.6,777100
959620,1044522.6,1332350,434040,541167.7,555250,525580,503354.9,777100
957790,1030398.9,1332350,435350,543344,555250,522440,487054.9,777100
955890,990208.7,1332350,436650,527142.3,555250,519240,463066.4,777100
954120,984852.6,1332350,437940,512222.4,555250,516180,472630.2,777100
943950,958448.7,1332350,436380,503916,555250,507570,454532.7,777100
933810,988736.9,1332350,434780,522374.8,555250,499030,466362.1,777100
923670,969097.6,1332350,433200,517290.7,555250,490470,451806.9,777100
913450,969816.2,1332350,431590,518723.8,555250,481860,451092.4,777100
901570,948289.3,1332350,428980,511554,555250,472590,436735.3,777100
889590,901216.1,1332350,426340,490011.1,555250,463250,411205,777100
877710,914132,1332350,423740,496419.6,555250,453970,417712.4,777100
865820,961025.1,1332350,421100,522949.6,555250,444720,438075.5,777100
855350,918926.8,1332350,419210,510706.3,555250,436140,408220.5,777100
844910,893613.8,1332350,417300,494173.4,555250,427610,399440.4,777100
834570,884471.5,1332350,415410,500422.9,555250,419160,384048.6,777100
824100,845973.3,1332350,413500,469030.1,555250,410600,376943.2,777100
813550,866770.9,1332350,410470,481256.1,555250,403080,385514.8,777100
802990,860480.6,1332350,407420,478390.5,555250,395570,382090.1,777100
792480,872824,1332350,404400,481367.8,555250,388080,391456.2,777100
781950,825783.2,1332350,401360,461408.4,555250,380590,364374.8,777100
768780,817764.4,1332350,396090,457628.5,555250,372690,360135.9,777100
755700,807213.6,1332350,390860,462007.6,555250,364840,345206,777100
742530,824234,1332350,385570,470833.2,555250,356960,353400.8,777100
729470,835883.9,1332350,380330,473696.1,555250,349140,362187.8,777100
721590,851988.9,1332350,380050,485871.6,555250,341540,366117.3,777100
713670,831890.4,1332350,379780,477894.4,555250,333890,353996,777100
705870,768880.5,1332350,379540,443028.8,555250,326330,325851.7,777100
697960,666805.1,1332350,379260,386699.2,555250,318700,280105.9,777100
694940,595400.4,1332350,376820,343689.8,555250,318120,251710.6,777100
691870,578117.9,1332350,374410,338501.5,555250,317460,239616.4,777100
688910,614513,1332350,371990,355179.5,555250,316920,259333.5,777100
637840,611898.4,1332350,345140,355702.2,555250,292700,256196.2,777100
630110,654120.8,1332350,341400,379244.7,555250,288710,274876.1,777100
622360,726762.3,1332350,337650,427090,555250,284710,299672.3,777100
614600,742291.8,1332350,333920,437248.5,555250,280680,305043.3,777100
606870,688883.4,1332350,330160,404511.9,555250,276710,284371.5,777100
599650,636781.2,1332350,328250,378260.9,555250,271400,258520.3,777100
592620,624724.6,1332350,326350,370306.6,555250,266270,254418,777100
585570,545789,1332350,324460,326197.6,555250,261110,219591.4,777100
578520,445601.4,1332350,322590,268519.6,555250,255930,177081.8,777100
563720,485591.9,1332350,315430,293027,555250,248290,192564.9,777100
549070,527043.5,1332350,308330,319907.7,555250,240740,207135.8,777100
534300,523994.9,1332350,301190,320466.8,555250,233110,203528.1,777100
519690,513893.5,1332350,294100,312513.9,555250,225590,201379.6,777100
506370,542375.2,1332350,287200,330931,555250,219170,211444.2,777100
493140,581269.6,1332350,280310,357220.8,555250,212830,224048.8,777100
479800,516948.8,1332350,273410,318316.6,555250,206390,198632.2,777100
466470,450356,1332350,266530,277662.4,555250,199940,172693.6,777100
454720,427583.1,1332350,261060,264059.6,555250,193660,163523.5,777100
443010,424094.7,1332350,255600,262317.7,555250,187410,161777,777100
431150,384329.9,1332350,250110,240804.7,555250,181040,143525.2,777100
419390,373515.4,1332350,244640,235112.9,555250,174750,138402.5,777100
415660,345518.5,1332350,241250,221724.7,555250,174410,123793.8,777100
412080,371508.5,1332350,237830,237369.7,555250,174250,134138.8,777100
408370,417135.2,1332350,234450,261253.3,555250,173920,155881.9,777100
404760,395360.7,1332350,231050,245280.2,555250,173710,150080.5,777100
401070,425886.1,1332350,226320,258700.8,555250,174750,167185.3,777100
397400,487866.5,1332350,221600,289468.8,555250,175800,198397.7,777100
393790,552196.6,1332350,216860,331763.2,555250,176930,220433.4,777100
390140,566256.2,1332350,212140,338500.5,555250,178000,227755.7,777100
382870,529175.1,1332350,205690,311855.7,555250,177180,217319.4,777100
375650,482972.2,1332350,199210,278821.1,555250,176440,204151.1,777100
368310,424916.5,1332350,192750,244796.4,555250,175560,180120.1,777100
361060,412578.3,1332350,186300,235751.6,555250,174760,176826.7,777100
355440,429215.1,1332350,180530,242810.4,555250,174910,186404.7,777100
349860,453669.6,1332350,174770,256980.7,555250,175090,196688.9,777100
344230,467937.8,1332350,168980,262032.5,555250,175250,205905.3,777100
338710,457859.5,1332350,163250,253057.8,555250,175460,204801.7,777100
331170,434202.5,1332350,156530,238927.5,555250,174640,195275,777100
323750,368252.6,1332350,149800,198038.1,555250,173950,170214.5,777100
316260,370600.1,1332350,143080,193394.2,555250,173180,177205.9,777100
308830,331656.9,1332350,136350,169128.9,555250,172480,162528,777100
303430,305563.1,1332350,131270,150609.6,555250,172160,154953.5,777100
298090,299585.1,1332350,126170,143894.1,555250,171920,155691,777100
292810,292908.1,1332350,121130,134898.7,555250,171680,158009.4,777100
287420,307270.9,1332350,116030,141234.6,555250,171390,166036.3,777100
282810,284569.7,1332350,113400,125921.8,555250,169410,158647.9,777100
278220,268002.1,1332350,110810,118308.8,555250,167410,149693.3,777100
273540,246608.9,1332350,108190,101813.3,555250,165350,144795.6,777100
268970,263725.5,1332350,105580,109780.9,555250,163390,153944.6,777100
263050,277289.6,1332350,101480,117675.5,555250,161570,159614.1,777100
257290,247748.2,1332350,97430,107371.7,555250,159860,140376.5,777100
251420,242941.4,1332350,93370,100809.4,555250,158050,142132,777100
245580,261611.6,1332350,89290,104423.3,555250,156290,157188.3,777100
241700,290289.4,1332350,87180,117539.6,555250,154520,172749.8,777100
237760,291827.9,1332350,85080,119489.9,555250,152680,172338,777100
233880,262030,1332350,82970,101377.9,555250,150910,160652.1,777100
229870,260716.6,1332350,80880,105290.9,555250,148990,155425.7,777100
230190,236452.7,1332350,81740,92094,555250,148450,144358.7,777100
230380,222059.6,1332350,82630,82567.7,555250,147750,139491.9,777100
230710,201742.2,1332350,83530,80928.3,555250,147180,120813.9,777100
230900,191222.7,1332350,84390,82459.2,555250,146510,108763.5,777100
229170,173609.9,1332350,83680,74815.1,555250,145490,98794.8,777100
227380,155125.5,1332350,82960,64023.1,555250,144420,91102.4,777100
225600,181502.8,1332350,82250,73399.4,555250,143350,108103.4,777100
223880,176676.2,1332350,81540,73117.1,555250,142340,103559.1,777100
222920,181442.4,1332350,81760,80419.9,555250,141160,101022.5,777100
221960,203429.3,1332350,81960,89430.7,555250,140000,113998.6,777100
221010,211027.2,1332350,82210,95101.9,555250,138800,115925.3,777100
220030,206962.4,1332350,82410,92863.7,555250,137620,114098.7,777100
210190,200859.5,1332350,78460,92882.7,555250,131730,107976.8,777100
200360,191091.7,1332350,74570,90730.1,555250,125790,100361.6,777100
190520,177718.9,1332350,70620,82402,555250,119900,95316.9,777100
180630,170213.3,1332350,66670,76943.4,555250,113960,93269.9,777100
169080,157124.4,1332350,61090,70917.2,555250,107990,86207.2,777100
157480,135541.1,1332350,55520,56232.9,555250,101960,79308.2,777100
145880,81800.8,1332350,49950,25577.3,555250,95930,56223.5,777100
134340,84050.2,1332350,44360,25368.6,555250,89980,58681.6,777100
124900,67219.5,1332350,40560,17295.5,555250,84340,49924,777100
115420,62818.5,1332350,36740,16111.6,555250,78680,46706.9,777100
106000,57107.4,1332350,32950,12853.2,555250,73050,44254.2,777100
96480,54810.3,1332350,29130,10683.6,555250,67350,44126.7,777100
91300,49257.5,1332350,26900,8806.2,555250,64400,40451.3,777100
86070,47389.1,1332350,24620,8028.4,555250,61450,39360.7,777100
80880,49355,1332350,22370,6762.3,555250,58510,42592.7,777100
75730,46234.5,1332350,20140,6351,555250,55590,39883.5,777100
70630,39340.4,1332350,17980,5324.6,555250,52650,34015.8,777100
65680,34840.5,1332350,15830,4580.2,555250,49850,30260.3,777100
60650,32651.2,1332350,13650,3149.2,555250,47000,29502,777100
55660,30543.4,1332350,11520,2684.3,555250,44140,27859.1,777100
50990,30113.2,1332350,9920,2613.3,555250,41070,27499.9,777100
46480,28458.4,1332350,8370,2297.3,555250,38110,26161.1,777100
41810,27812.6,1332350,6790,2620.9,555250,35020,25191.7,777100
37140,28215.5,1332350,5210,3367.3,555250,31930,24848.2,777100
37520,30273.3,1332350,5860,3413.3,555250,31660,26860,777100
37970,31819.7,1332350,6540,3482.3,555250,31430,28337.4,777100
38320,27695,1332350,7220,3031.4,555250,31100,24663.6,777100
28890,21897,1332350,5320,2173,555250,23570,19724,777100
28250,18429.4,1332350,5120,1781.7,555250,23130,16647.7,777100
27600,17931,1332350,4880,2159.5,555250,22720,15771.5,777100
26920,19047.5,1332350,4640,2720.8,555250,22280,16326.7,777100
26290,16231.9,1332350,4420,1319.2,555250,21870,14912.7,777100
25560,14907.3,1332350,4170,1058,555250,21390,13849.3,777100
24660,13905.2,1332350,3870,1104.5,555250,20790,12800.7,777100
23910,15349.5,1332350,3620,1228.6,555250,20290,14120.9,777100
23110,15436.2,1332350,3360,1310.4,555250,19750,14125.8,777100
22520,15548.7,1332350,3180,1675.6,555250,19340,13873.1,777100
21870,14420.4,1332350,3010,792,555250,18860,13628.4,777100
21230,13971.1,1332350,2860,719.2,555250,18370,13251.9,777100
20640,12989.4,1332350,2680,476,555250,17960,12513.4,777100
19920,12536.7,1332350,2510,458.1,555250,17410,12078.6,777100
19170,12660.6,1332350,2340,682,555250,16830,11978.6,777100
18430,14258.1,1332350,2170,1352.5,555250,16260,12905.6,777100
17690,14613.1,1332350,1990,1419.9,555250,15700,13193.2,777100
17230,15032.7,1332350,1920,1606.3,555250,15310,13426.4,777100
16640,16133.3,1332350,1820,2193.2,555250,14820,13940.1,777100
16070,15373.6,1332350,1710,1397.5,555250,14360,13976.1,777100
15560,14771.5,1332350,1610,1204.7,555250,13950,13566.8,777100
14790,12695.3,1332350,1530,696.3,555250,13260,11999,777100
13930,10828.8,1332350,1440,528.4,555250,12490,10300.4,777100
13130,11670.3,1332350,1350,799.9,555250,11780,10870.4,777100
12310,11892.3,1332350,1270,301,555250,11040,11591.3,777100
11530,11410,1332350,1130,301,555250,10400,11109,777100
10680,10918.8,1332350,990,301,555250,9690,10617.8,777100
9910,10368.5,1332350,860,397.4,555250,9050,9971.1,777100
9070,10499.5,1332350,730,437.9,555250,8340,10061.6,777100
8270,9559.7,1332350,690,451,555250,7580,9108.7,777100
7460,9223.2,1332350,640,447.1,555250,6820,8776.1,777100
6650,8537.4,1332350,590,424.4,555250,6060,8113,777100
5790,8900.4,1332350,560,413.5,555250,5230,8486.9,777100
6330,9426.9,1332350,530,451,555250,5800,8975.9,777100
6770,9267.8,1332350,500,377.8,555250,6270,8890,777100
7220,10182.7,1332350,470,436,555250,6750,9746.7,777100
7670,10768.9,1332350,420,397.2,555250,7250,10371.7,777100
8180,9972.4,1332350,460,311.7,555250,7720,9660.7,777100
8640,9333.8,1332350,480,345.5,555250,8160,8988.3,777100
9110,12840.1,1332350,520,666.3,555250,8590,12173.8,777100
9640,13568.3,1332350,560,695.1,555250,9080,12873.2,777100
10040,12755.7,1332350,500,425.9,555250,9540,12329.8,777100
10570,12987.1,1332350,470,315.4,555250,10100,12671.7,777100
10980,12642.9,1332350,410,311.7,555250,10570,12331.2,777100
11480,11877.4,1332350,380,258.1,555250,11100,11619.3,777100
13200,15841.3,1332350,720,524.5,555250,12480,15316.8,777100
14900,18217.8,1332350,1030,567.9,555250,13870,17649.9,777100
16640,18121.1,1332350,1340,692.1,555250,15300,17429,777100
18340,18251.7,1332350,1660,925.8,555250,16680,17325.9,777100
20180,19968,1332350,2060,1026.3,555250,18120,18941.7,777100
22060,18510.5,1332350,2460,970.6,555250,19600,17539.9,777100
23820,21662.1,1332350,2840,990.4,555250,20980,20671.7,777100
25710,22908.8,1332350,3250,1055.1,555250,22460,21853.7,777100
27670,26500.8,1332350,3730,1577.2,555250,23940,24923.6,777100
29670,26230.6,1332350,4230,1568.4,555250,25440,24662.2,777100
31670,28734.6,1332350,4690,2202.1,555250,26980,26532.5,777100
33670,28398.1,1332350,5160,2836.4,555250,28510,25561.7,777100
36420,27521.8,1332350,5700,2043,555250,30720,25478.8,777100
39240,27562.4,1332350,6240,2237.5,555250,33000,25324.9,777100
42010,34075.8,1332350,6770,2575,555250,35240,31500.8,777100
44720,35275.1,1332350,7300,2995.8,555250,37420,32279.3,777100
47250,36964.8,1332350,7590,3488,555250,39660,33476.8,777100
49660,40490.4,1332350,7920,4090.1,555250,41740,36400.3,777100
52200,45250.6,1332350,8200,5538.5,555250,44000,39712.1,777100
54780,46753.2,1332350,8540,5166.8,555250,46240,41586.4,777100
57450,50777.2,1332350,9040,4800.5,555250,48410,45976.7,777100
60200,50635.8,1332350,9570,5437.9,555250,50630,45197.9,777100
62870,56614.7,1332350,10070,6752.8,555250,52800,49861.9,777100
65580,57575.4,1332350,10570,5860.2,555250,55010,51715.2,777100
66870,62420.8,1332350,10840,6567.9,555250,56030,55852.9,777100
68140,56500,1332350,11120,4977.8,555250,57020,51522.2,777100
69450,53592.8,1332350,11400,5071.5,555250,58050,48521.3,777100
70700,57879,1332350,11670,6734.9,555250,59030,51144.1,777100
71900,56997.1,1332350,11660,6837.2,555250,60240,50159.9,777100
73090,59440.9,1332350,11680,7622.8,555250,61410,51818.1,777100
74370,55467.3,1332350,11690,7347.7,555250,62680,48119.6,777100
75590,54592.4,1332350,11710,6481.5,555250,63880,48110.9,777100
76830,52579.7,1332350,12180,6483.9,555250,64650,46095.8,777100
78120,51522.6,1332350,12690,5899.9,555250,65430,45622.7,777100
79410,55089.1,1332350,13180,8023,555250,66230,47066.1,777100
80700,56159.9,1332350,13670,7736.1,555250,67030,48423.8,777100
79770,55397.4,1332350,14170,7747.1,555250,65600,47650.3,777100
78750,55843.1,1332350,14660,8271.9,555250,64090,47571.2,777100
77820,53123.8,1332350,15150,7410.5,555250,62670,45713.3,777100
76780,49639.5,1332350,15670,7844.2,555250,61110,41795.3,777100
75550,49852.4,1332350,15580,8311.2,555250,59970,41541.2,777100
74270,56475.4,1332350,15540,12044.8,555250,58730,44430.6,777100
73040,70590.2,1332350,15490,19189.4,555250,57550,51400.8,777100
71790,68299.6,1332350,15430,17296.9,555250,56360,51002.7,777100
70090,72504.4,1332350,14950,18992.7,555250,55140,53511.7,777100
68360,74636.1,1332350,14490,19496.2,555250,53870,55139.9,777100
66610,67326.3,1332350,14000,14610.6,555250,52610,52715.7,777100
64870,69765,1332350,13540,14519.9,555250,51330,55245.1,777100
62190,68558.7,1332350,12770,13979.9,555250,49420,54578.8,777100
59470,68756.1,1332350,12000,13191.4,555250,47470,55564.7,777100
56750,65908,1332350,11240,12503.5,555250,45510,53404.5,777100
70590,66650.8,1332350,13940,11238.7,555250,56650,55412.1,777100
66690,64908.9,1332350,13300,10305.1,555250,53390,54603.8,777100
62820,58575.7,1332350,12640,8613,555250,50180,49962.7,777100
58920,54480.7,1332350,11990,7037.6,555250,46930,47443.1,777100
55010,50878.5,1332350,11340,5912.5,555250,43670,44966,777100
51450,46449.1,1332350,10730,5411.8,555250,40720,41037.3,777100
47880,40950.3,1332350,10100,5197.8,555250,37780,35752.5,777100
44350,35241.6,1332350,9470,4379.1,555250,34880,30862.5,777100
40700,30729.3,1332350,8810,3207.1,555250,31890,27522.2,777100
39590,30889.6,1332350,8420,2252.2,555250,31170,28637.4,777100
38500,28362.8,1332350,8010,1645,555250,30490,26717.8,777100
37330,23751.7,1332350,7620,1436.1,555250,29710,22315.6,777100
36210,19842.8,1332350,7220,1336.4,555250,28990,18506.4,777100
35490,18781.2,1332350,7040,1706.9,555250,28450,17074.3,777100
34810,19061.9,1332350,6850,2173.8,555250,27960,16888.1,777100
34140,20868.6,1332350,6700,3032.8,555250,27440,17835.8,777100
33380,22868.4,1332350,6510,3881.5,555250,26870,18986.9,777100
33070,22579.6,1332350,6530,3730.9,555250,26540,18848.7,777100
32710,22135.3,1332350,6560,3229.2,555250,26150,18906.1,777100
32370,21695.7,1332350,6600,2851.6,555250,25770,18844.1,777100
31970,21778.5,1332350,6600,2945,555250,25370,18833.5,777100
31600,21560.8,1332350,6670,3452.1,555250,24930,18108.7,777100
31210,24296,1332350,6750,6049.9,555250,24460,18246.1,777100
30840,26646.7,1332350,6810,7938,555250,24030,18708.7,777100
30440,29779.2,1332350,6870,9919.9,555250,23570,19859.3,777100
30090,28962.4,1332350,6830,9477.8,555250,23260,19484.6,777100
29740,27350.5,1332350,6810,8071.6,555250,22930,19278.9,777100
29480,31018.8,1332350,6800,9974.8,555250,22680,21044,777100
29140,34015.7,1332350,6770,11872.5,555250,22370,22143.2,777100
28760,34642.2,1332350,6800,12876.8,555250,21960,21765.4,777100
28390,41337.7,1332350,6840,17343,555250,21550,23994.7,777100
27990,44336,1332350,6870,18880.8,555250,21120,25455.2,777100
27660,42832.9,1332350,6920,18715.4,555250,20740,24117.5,777100
30390,44287.7,1332350,7130,19233,555250,23260,25054.7,777100
33020,44306.3,1332350,7370,19497.2,555250,25650,24809.1,777100
35750,45769.4,1332350,7590,20261.2,555250,28160,25508.2,777100
38340,42175.4,1332350,7800,17301.3,555250,30540,24874.1,777100
41820,37269.3,1332350,8010,13057.2,555250,33810,24212.1,777100
45270,38089.7,1332350,8280,11343.6,555250,36990,26746.1,777100
48670,42221.6,1332350,8510,11326,555250,40160,30895.6,777100
52130,46909,1332350,8740,13458.6,555250,43390,33450.4,777100
55800,50018.6,1332350,9010,13094,555250,46790,36924.6,777100
59410,51525.7,1332350,9270,12810.5,555250,50140,38715.2,777100
63070,50658.7,1332350,9530,10768.9,555250,53540,39889.8,777100
66760,50331.7,1332350,9780,10223.8,555250,56980,40107.9,777100
72080,52143.9,1332350,11560,10552.4,555250,60520,41591.5,777100
77460,59066.5,1332350,13340,13349.2,555250,64120,45717.3,777100
82790,59199.4,1332350,15130,13382.7,555250,67660,45816.7,777100
88150,56637,1332350,16920,11941.2,555250,71230,44695.8,777100
94010,56506.4,1332350,18830,11524.5,555250,75180,44981.9,777100
99840,59149.8,1332350,20730,12448.8,555250,79110,46701,777100
105780,63583,1332350,22640,13794.2,555250,83140,49788.8,777100
111620,65247.2,1332350,24550,14373.9,555250,87070,50873.3,777100
118890,73080.1,1332350,27380,17850.9,555250,91510,55229.2,777100
126160,77439.2,1332350,30190,19004.2,555250,95970,58435,777100
133430,83555.9,1332350,33000,21945.5,555250,100430,61610.4,777100
140640,86197.4,1332350,35800,24655.4,555250,104840,61542,777100
141640,97240.6,1332350,35510,28952.4,555250,106130,68288.2,777100
142640,101610.9,1332350,35200,32787.6,555250,107440,68823.3,777100
143600,105800.8,1332350,34920,36264,555250,108680,69536.8,777100
144650,103492.4,1332350,34620,34090,555250,110030,69402.4,777100
146030,106810.8,1332350,34220,36031.8,555250,111810,70779,777100
147380,118061,1332350,33800,41379,555250,113580,76682,777100
148820,121557.7,1332350,33390,41530.7,555250,115430,80027,777100
150250,114380.7,1332350,32990,37273.8,555250,117260,77106.9,777100
151110,113406,1332350,32530,34931.4,555250,118580,78474.6,777100
152030,102384,1332350,32070,27621.9,555250,119960,74762.1,777100
152930,87164.4,1332350,31570,16756.2,555250,121360,70408.2,777100
153830,89202.1,1332350,31130,16090.6,555250,122700,73111.5,777100
148310,76145.4,1332350,30690,8738.6,555250,117620,67406.8,777100
142720,72437,1332350,30260,8415.4,555250,112460,64021.6,777100
137170,72345.9,1332350,29850,10293.9,555250,107320,62052,777100
131570,79908.6,1332350,29380,16573.4,555250,102190,63335.2,777100
124720,77110.2,1332350,28060,16383.2,555250,96660,60727,777100
117870,70230.7,1332350,26720,13088.8,555250,91150,57141.9,777100
111000,82687.8,1332350,25370,24020.2,555250,85630,58667.6,777100
104150,98035.4,1332350,24010,35185.8,555250,80140,62849.6,777100
98350,106013.4,1332350,22940,42706,555250,75410,63307.4,777100
92520,92891,1332350,21830,36681,555250,70690,56210,777100
86730,80376.2,1332350,20740,29741.6,555250,65990,50634.6,777100
80880,97871.4,1332350,19640,41103,555250,61240,56768.4,777100
81630,111115.4,1332350,21900,50646.6,555250,59730,60468.8,777100
82450,145572,1332350,24150,72072.5,555250,58300,73499.5,777100
83070,182470.6,1332350,26380,95416.8,555250,56690,87053.8,777100
83770,248028,1332350,28620,135377.3,555250,55150,112650.7,777100
81340,306401.2,1332350,27270,168901.8,555250,54070,137499.4,777100
78810,321991.2,1332350,25940,175942.8,555250,52870,146048.4,777100
76370,319997.3,1332350,24630,172190,555250,51740,147807.3,777100
73880,379910.2,1332350,23290,206270.8,555250,50590,173639.4,777100
73050,522866.3,1332350,23820,290491.3,555250,49230,232375,777100
72260,601454.8,1332350,24380,335828.9,555250,47880,265625.9,777100
71470,402583.4,1332350,24950,210526.4,555250,46520,192057,777100
70610,375043.6,1332350,25470,190079.7,555250,45140,184963.9,777100
71900,267409.3,1332350,26210,128175.7,555250,45690,139233.6,777100
73100,214565.3,1332350,26950,95524.9,555250,46150,119040.4,777100
74240,169536.7,1332350,27670,68347.9,555250,46570,101188.8,777100
115080,162703.8,1332350,61740,73400.8,555250,53340,89303,777100
117820,219894.7,1332350,65350,109613.6,555250,52470,110281.1,777100
120460,312721.1,1332350,68950,167976.3,555250,51510,144744.8,777100
123140,363169.5,1332350,72530,199699,555250,50610,163470.5,777100
125830,320998.9,1332350,76130,178085.7,555250,49700,142913.2,777100
129780,302493.5,1332350,80150,167610.6,555250,49630,134882.9,777100
133690,356096.9,1332350,84160,193349.1,555250,49530,162747.8,777100
137590,337859.9,1332350,88160,185347.6,555250,49430,152512.3,777100
141520,294527.3,1332350,92190,166929.3,555250,49330,127598,777100
152830,279679.1,1332350,99130,160922.9,555250,53700,118756.2,777100
164160,263932.4,1332350,106110,157302.6,555250,58050,106629.8,777100
175460,279331.7,1332350,113090,169684.6,555250,62370,109647.1,777100
186780,283476,1332350,120050,176023.3,555250,66730,107452.7,777100
198370,234365.5,1332350,126850,147178,555250,71520,87187.5,777100
209880,203014.9,1332350,133610,125989.9,555250,76270,77025,777100
221390,191789,1332350,140380,120410.1,555250,81010,71378.9,777100
232990,247923.3,1332350,147150,151998.1,555250,85840,95925.2,777100
244160,294821.1,1332350,152910,180370.6,555250,91250,114450.5,777100
255370,319556.3,1332350,158700,197963,555250,96670,121593.3,777100
266530,337561.9,1332350,164470,213467.2,555250,102060,124094.7,777100
277760,333159.9,1332350,170240,211920.7,555250,107520,121239.2,777100
279040,322307.8,1332350,169220,199014.2,555250,109820,123293.6,777100
280240,315701,1332350,168180,189480.2,555250,112060,126220.8,777100
281510,377299.7,1332350,167170,225211.1,555250,114340,152088.6,777100
282640,390067.4,1332350,166110,235327.6,555250,116530,154739.8,777100
286350,345278.9,1332350,166690,207577.8,555250,119660,137701.1,777100
290050,359198.8,1332350,167250,218201.1,555250,122800,140997.7,777100
293710,346653.3,1332350,167790,209335.1,555250,125920,137318.2,777100
297340,372160.7,1332350,168360,219102.7,555250,128980,153058,777100
300310,379943.5,1332350,168950,222630.6,555250,131360,157312.9,777100
303010,380153.8,1332350,169500,220882.1,555250,133510,159271.7,777100
305850,388962.4,1332350,170070,223389.3,555250,135780,165573.1,777100
308700,396976.8,1332350,170640,230550,555250,138060,166426.8,777100
311010,390199.8,1332350,171310,227380.9,555250,139700,162818.9,777100
313350,394252.2,1332350,171990,227670.7,555250,141360,166581.5,777100
315660,406971.7,1332350,172680,232267.7,555250,142980,174704,777100
317970,377579,1332350,173340,219142.1,555250,144630,158436.9,777100
318450,340334.7,1332350,173160,196511.6,555250,145290,143823.1,777100
318960,147191.1,1332350,172980,113143.4,555250,145980,34047.7,777100
319300,292423.3,1332350,172820,166166.3,555250,146480,126257,777100
319770,266421.3,1332350,172670,154092.6,555250,147100,112328.7,777100
320830,268578.2,1332350,172700,154710,555250,148130,113868.2,777100
321880,243852.2,1332350,172750,147315.2,555250,149130,96537,777100
322890,185077.5,1332350,172800,112740.6,555250,150090,72336.9,777100
323920,188713.1,1332350,172830,114147.6,555250,151090,74565.5,777100
320540,180874.9,1332350,167090,105750.3,555250,153450,75124.6,777100
317070,164170.7,1332350,161320,96370.4,555250,155750,67800.3,777100
313660,177059.9,1332350,155560,100617.5,555250,158100,76442.4,777100
310180,169089.7,1332350,149810,94320.9,555250,160370,74768.8,777100
302790,191928,1332350,141030,103670.4,555250,161760,88257.6,777100
295360,211252.1,1332350,132280,108950.5,555250,163080,102301.6,777100
287980,193849.3,1332350,123520,95310.8,555250,164460,98538.5,777100
280580,189552.3,1332350,114760,85542.3,555250,165820,104010,777100
274770,179224.5,1332350,107230,78249,555250,167540,100975.5,777100
268900,150823.5,1332350,99700,61322.2,555250,169200,89501.3,777100
263030,135038.3,1332350,92170,48755.9,555250,170860,86282.4,777100
257230,121957.5,1332350,84660,39567.3,555250,172570,82390.2,777100
253620,120941.7,1332350,80670,35327.4,555250,172950,85614.3,777100
250150,103692.8,1332350,76710,22666.1,555250,173440,81026.7,777100
246590,101630.8,1332350,72740,18701.6,555250,173850,82929.2,777100
242970,97705.8,1332350,68760,16272.8,555250,174210,81433,777100
239910,116307.2,1332350,64850,19076.8,555250,175060,97230.4,777100
236840,128250.3,1332350,60950,29050.3,555250,175890,99200,777100
233710,141974.7,1332350,57050,39141.2,555250,176660,102833.5,777100
230600,140616.2,1332350,53150,31298.6,555250,177450,109317.6,777100
227710,140390.7,1332350,49640,34876.8,555250,178070,105513.9,777100
224810,157929.4,1332350,46110,37295.7,555250,178700,120633.7,777100
221890,154321.2,1332350,42600,29558,555250,179290,124763.2,777100
219030,157621.5,1332350,39090,30951.3,555250,179940,126670.2,777100
207790,155490.4,1332350,36590,29750.9,555250,171200,125739.5,777100
196520,157760.4,1332350,34110,34224.7,555250,162410,123535.7,777100
185280,163227.8,1332350,31610,39390.7,555250,153670,123837.1,777100
174040,157204.1,1332350,29120,38452.7,555250,144920,118751.4,777100
163050,159326.6,1332350,26970,43931,555250,136080,115395.6,777100
151960,142812.2,1332350,24820,39861.7,555250,127140,102950.5,777100
140860,130675.9,1332350,22670,34625.5,555250,118190,96050.4,777100
129850,127185.5,1332350,20530,36240,555250,109320,90945.5,777100
119330,117931.5,1332350,19070,36668.5,555250,100260,81263,777100
108890,121822.9,1332350,17640,41605.7,555250,91250,80217.2,777100
98350,125826.4,1332350,16190,48060.2,555250,82160,77766.2,777100
87950,141815.3,1332350,14750,59999.8,555250,73200,81815.5,777100
87240,154223.6,1332350,17130,71495.4,555250,70110,82728.2,777100
86460,222326.1,1332350,19490,114818.1,555250,66970,107508,777100
85790,387321.1,1332350,21880,217284.8,555250,63910,170036.3,777100
85090,408800.3,1332350,24250,231920,555250,60840,176880.3,777100
82450,390811.2,1332350,24260,220734,555250,58190,170077.2,777100
79910,351898.2,1332350,24290,196770.1,555250,55620,155128.1,777100
77330,321195.5,1332350,24270,177667.9,555250,53060,143527.6,777100
74760,309485.4,1332350,24320,169752.9,555250,50440,139732.5,777100
72770,299412.2,1332350,24830,163822.6,555250,47940,135589.6,777100
70800,296555.3,1332350,25390,163147.4,555250,45410,133407.9,777100
68830,307874.2,1332350,25920,170956.7,555250,42910,136917.5,777100
66790,275684.8,1332350,26460,151597.8,555250,40330,124087,777100
79000,236428.3,1332350,35960,131110.6,555250,43040,105317.7,777100
91230,226055.3,1332350,45480,128020.2,555250,45750,98035.1,777100
103310,230324.3,1332350,54980,132097,555250,48330,98227.3,777100
90950,242810.4,1332350,55900,144155.5,555250,35050,98654.9,777100
95810,234465.9,1332350,59610,140750.3,555250,36200,93715.6,777100
100650,197212,1332350,63310,119341.2,555250,37340,77870.8,777100
105450,183315.9,1332350,67000,112042.5,555250,38450,71273.4,777100
110380,157519.6,1332350,70740,96890.7,555250,39640,60628.9,777100
114620,136114.2,1332350,73740,83215.4,555250,40880,52898.8,777100
118940,130517.5,1332350,76750,78288.1,555250,42190,52229.4,777100
123270,128796,1332350,79760,78490.7,555250,43510,50305.3,777100
127560,117459.1,1332350,82770,71629.1,555250,44790,45830,777100
125570,119391.4,1332350,78920,70608.2,555250,46650,48783.2,777100
123570,113840.7,1332350,75100,66382.4,555250,48470,47458.3,777100
121690,123094.3,1332350,71250,70726.3,555250,50440,52368,777100
119720,107196.8,1332350,67440,60513.2,555250,52280,46683.6,777100
117620,100776.9,1332350,63930,54335.8,555250,53690,46441.1,777100
115460,100016.6,1332350,60420,51668.5,555250,55040,48348.1,777100
113340,86723,1332350,56910,41856.5,555250,56430,44866.5,777100
111240,93385.7,1332350,53430,44542.4,555250,57810,48843.3,777100
109470,81862.1,1332350,50330,38145.4,555250,59140,43716.7,777100
107680,76758.7,1332350,47230,34598.2,555250,60450,42160.5,777100
105850,70387.9,1332350,44130,26787.8,555250,61720,43600.1,777100
104060,60198.8,1332350,41030,17976.6,555250,63030,42222.2,777100
103090,54339.8,1332350,39400,13161.8,555250,63690,41178,777100
102130,57445.9,1332350,37770,12978.7,555250,64360,44467.2,777100
100990,71077.8,1332350,36120,19593.8,555250,64870,51484,777100
100070,88436.5,1332350,34510,24726.3,555250,65560,63710.2,777100
99030,100838.1,1332350,33160,29489.6,555250,65870,71348.5,777100
98080,102256.2,1332350,31810,31036.7,555250,66270,71219.5,777100
97090,105540.9,1332350,30470,31173.7,555250,66620,74367.2,777100
96140,97873.2,1332350,29130,30271,555250,67010,67602.2,777100
94090,90950.9,1332350,27210,26478.4,555250,66880,64472.5,777100
92150,89202,1332350,25320,23918.9,555250,66830,65283.1,777100
90100,89257.2,1332350,23380,20258.2,555250,66720,68999,777100
88170,88583.8,1332350,21470,19847.8,555250,66700,68736,777100
87780,91405.2,1332350,21140,22822.9,555250,66640,68582.3,777100
87410,100249.2,1332350,20780,31096.4,555250,66630,69152.8,777100
87120,87228.6,1332350,20440,23687.9,555250,66680,63540.7,777100
86720,74358.8,1332350,20110,17024.8,555250,66610,57334,777100
86160,85192.4,1332350,19750,23739.3,555250,66410,61453.1,777100
85630,97492.9,1332350,19420,29261.7,555250,66210,68231.2,777100
85120,105442.2,1332350,19090,34225.5,555250,66030,71216.7,777100
84550,106758.5,1332350,18740,35371.2,555250,65810,71387.3,777100
84260,106326.8,1332350,18380,33933.3,555250,65880,72393.5,777100
83970,99988.1,1332350,18020,32274.3,555250,65950,67713.8,777100
83640,96426.1,1332350,17650,31753,555250,65990,64673.1,777100
83430,97801.6,1332350,17300,31723.2,555250,66130,66078.4,777100
83370,99820.5,1332350,17720,32984.1,555250,65650,66836.4,777100
83360,114873,1332350,18120,43367.7,555250,65240,71505.3,777100
83240,129974.8,1332350,18540,52572.1,555250,64700,77402.7,777100
83300,137911.3,1332350,18960,54216.2,555250,64340,83695.1,777100
83160,127639.7,1332350,19130,46914,555250,64030,80725.7,777100
83030,111550.9,1332350,19300,38347.9,555250,63730,73203,777100
82930,106150.9,1332350,19480,35467.3,555250,63450,70683.6,777100
82780,96192,1332350,19650,30123.3,555250,63130,66068.7,777100
82270,92153.5,1332350,19430,29565.4,555250,62840,62588.1,777100
81720,89042.3,1332350,19210,28773,555250,62510,60269.3,777100
81190,93870,1332350,18960,30383.7,555250,62230,63486.3,777100
80630,89934,1332350,18730,29168.7,555250,61900,60765.3,777100
83740,98726.2,1332350,21780,36864,555250,61960,61862.2,777100
86820,98993,1332350,24850,36870.2,555250,61970,62122.8,777100
89920,106334.2,1332350,27910,42835,555250,62010,63499.2,777100
93060,131547.6,1332350,31000,59595.4,555250,62060,71952.2,777100
97230,170514.1,1332350,34800,84989.4,555250,62430,85524.7,777100
101400,183318.8,1332350,38590,91489.7,555250,62810,91829.1,777100
105640,177867.8,1332350,42380,89784.2,555250,63260,88083.6,777100
109820,182545.7,1332350,46210,97643.9,555250,63610,84901.8,777100
114470,192820.1,1332350,50360,104436.4,555250,64110,88383.7,777100
119180,207640.2,1332350,54530,113296.7,555250,64650,94343.5,777100
123880,254204.7,1332350,58680,142290.7,555250,65200,111914,777100
128520,299508.3,1332350,62840,171070,555250,65680,128438.3,777100
134700,339220.1,1332350,68650,195989.9,555250,66050,143230.2,777100
140850,381725.7,1332350,74450,222180.5,555250,66400,159545.2,777100
147130,380789.2,1332350,80290,224241.1,555250,66840,156548.1,777100
153240,398245.8,1332350,86060,232604.3,555250,67180,165641.5,777100
159070,440753.8,1332350,91650,261434.5,555250,67420,179319.3,777100
164840,474768.4,1332350,97200,287836.2,555250,67640,186932.2,777100
170640,441650,1332350,102750,269117.4,555250,67890,172532.6,777100
176460,387843.5,1332350,108350,238623.8,555250,68110,149219.7,777100
183650,374656.1,1332350,115710,230499.9,555250,67940,144156.2,777100
190910,374287.7,1332350,123140,236236.9,555250,67770,138050.8,777100
198180,360047.5,1332350,130520,231608.5,555250,67660,128439,777100
205390,362327.6,1332350,137920,234594.4,555250,67470,127733.2,777100
214200,399340.5,1332350,143100,257779.4,555250,71100,141561.1,777100
222870,421654.7,1332350,148260,269979.7,555250,74610,151675,777100
231620,437081.6,1332350,153410,278760.8,555250,78210,158320.8,777100
240420,448734.6,1332350,158600,284463,555250,81820,164271.6,777100
250440,447445.5,1332350,164930,282642.6,555250,85510,164802.9,777100
260500,446909.7,1332350,171240,281791.4,555250,89260,165118.3,777100
270550,437576.5,1332350,177570,276667.5,555250,92980,160909,777100
280570,516996.8,1332350,183920,326633.8,555250,96650,190363,777100
289610,594611.4,1332350,188720,373312.8,555250,100890,221298.6,777100
298660,655003.2,1332350,193550,407763.5,555250,105110,247239.7,777100
307690,700428.4,1332350,198370,436176,555250,109320,264252.4,777100
316700,701378.1,1332350,203220,435601.9,555250,113480,265776.2,777100
326920,685980.5,1332350,204550,420578.8,555250,122370,265401.7,777100
337300,631539.8,1332350,205870,382765.2,555250,131430,248774.6,777100
347570,602355.9,1332350,207200,358392.8,555250,140370,243963.1,777100
438310,680359,1332350,246660,402361.5,555250,191650,277997.5,777100
445010,784763.3,1332350,245690,460480.8,555250,199320,324282.5,777100
451610,811690,1332350,244710,473893.2,555250,206900,337796.8,777100
458190,813087,1332350,243720,468916,555250,214470,344171,777100
464830,707661.2,1332350,242770,403381.6,555250,222060,304279.6,777100
469840,742667,1332350,240030,419695.3,555250,229810,322971.7,777100
474910,816212.8,1332350,237310,451888.5,555250,237600,364324.3,777100
479860,757058.3,1332350,234580,415319.1,555250,245280,341739.2,777100
484870,648365.4,1332350,231850,347440.4,555250,253020,300925,777100
481770,611124.9,1332350,231820,312773.2,555250,249950,298351.7,777100
478720,650310.4,1332350,231860,333996.9,555250,246860,316313.5,777100
475650,659130.3,1332350,231850,340890,555250,243800,318240.3,777100
472590,672141,1332350,231870,348331.3,555250,240720,323809.7,777100
469050,612677.2,1332350,231990,315766.8,555250,237060,296910.4,777100
465520,617762.1,1332350,232120,323259.6,555250,233400,294502.5,777100
462000,743743.2,1332350,232260,391339,555250,229740,352404.2,777100
458440,775578,1332350,232380,409760.9,555250,226060,365817.1,777100
454520,759895.4,1332350,231850,404344.5,555250,222670,355550.9,777100
450600,693483.5,1332350,231280,368116,555250,219320,325367.5,777100
446660,611457.8,1332350,230740,329820.5,555250,215920,281637.3,777100
442720,512953.7,1332350,230190,276933.1,555250,212530,236020.6,777100
440450,496244.8,1332350,228830,271934.9,555250,211620,224309.9,777100
438150,504645.7,1332350,227480,278304.2,555250,210670,226341.5,777100
435900,418731.8,1332350,226120,222363.8,555250,209780,196368,777100
433600,400304.2,1332350,224780,209976.4,555250,208820,190327.8,777100
431710,398163.6,1332350,224090,213033.5,555250,207620,185130.1,777100
429890,394308,1332350,223430,211795.3,555250,206460,182512.7,777100
428080,387314,1332350,222760,208841.9,555250,205320,178472.1,777100
426220,366099.4,1332350,222090,198696.5,555250,204130,167402.9,777100
423360,358624.8,1332350,219620,194738.5,555250,203740,163886.3,777100
420450,389862.7,1332350,217140,212923.3,555250,203310,176939.4,777100
417430,439429.3,1332350,214670,242343.9,555250,202760,197085.4,777100
414490,401954.2,1332350,212190,221844.3,555250,202300,180109.9,777100
410990,436714.7,1332350,207780,240923.4,555250,203210,195791.3,777100
407510,465519.8,1332350,203350,258073.2,555250,204160,207446.6,777100
403980,485473.4,1332350,198920,267133.2,555250,205060,218340.2,777100
400500,444597.9,1332350,194520,238617,555250,205980,205980.9,777100
399200,393653.7,1332350,192970,205605.4,555250,206230,188048.3,777100
397950,367323.5,1332350,191430,190581.8,555250,206520,176741.7,777100
396670,348096.6,1332350,189870,183951.2,555250,206800,164145.4,777100
395360,305839.5,1332350,188360,158263.9,555250,207000,147575.6,777100
391390,309428.9,1332350,184600,157111.7,555250,206790,152317.2,777100
387400,316760.5,1332350,180850,164716.3,555250,206550,152044.2,777100
383360,336381.4,1332350,177080,175084.3,555250,206280,161297.1,777100
379400,337949.6,1332350,173370,177423.3,555250,206030,160526.3,777100
371150,292483.1,1332350,166920,145328.4,555250,204230,147154.7,777100
362940,287795.6,1332350,160500,142828,555250,202440,144967.6,777100
354690,272014.7,1332350,154090,128518.8,555250,200600,143495.9,777100
346480,222296.9,1332350,147640,102841.1,555250,198840,119455.8,777100
340120,197650,1332350,141910,82071.2,555250,198210,115578.8,777100
333790,184211.5,1332350,136180,77383.4,555250,197610,106828.1,777100
327480,191992.5,1332350,130430,75355.7,555250,197050,116636.8,777100
321130,187368.2,1332350,124680,71686.3,555250,196450,115681.9,777100
314440,172504.9,1332350,118910,64488.8,555250,195530,108016.1,777100
307750,175766.4,1332350,113100,63183.4,555250,194650,112583,777100
301040,177010.7,1332350,107320,64790.7,555250,193720,112220,777100
294410,187424.3,1332350,101560,68672.3,555250,192850,118752,777100
283710,172412.9,1332350,96030,58873.5,555250,187680,113539.4,777100
273040,166855,1332350,90480,58904.7,555250,182560,107950.3,777100
262380,165792.4,1332350,84990,53962.5,555250,177390,111829.9,777100
251730,164336,1332350,79440,52712.1,555250,172290,111623.9,777100
241460,158732.9,1332350,73950,50930,555250,167510,107802.9,777100
231160,153397.7,1332350,68450,52269.3,555250,162710,101128.4,777100
220910,137596.7,1332350,62950,38486.4,555250,157960,99110.3,777100
210520,114157.9,1332350,57430,25781.4,555250,153090,88376.5,777100
200030,105393.1,1332350,51870,23778.3,555250,148160,81614.8,777100
189490,94652.5,1332350,46250,17568.6,555250,143240,77083.9,777100
178990,93349.8,1332350,40670,13012.9,555250,138320,80336.9,777100
168480,86512.8,1332350,35110,8627.5,555250,133370,77885.3,777100
162660,81123.4,1332350,33360,7275.2,555250,129300,73848.2,777100
156860,82727.1,1332350,31590,8560.4,555250,125270,74166.7,777100
151040,80031.8,1332350,29840,7070.2,555250,121200,72961.6,777100
145220,82059.8,1332350,28070,6813.3,555250,117150,75246.5,777100
139490,79999.4,1332350,26300,6448.1,555250,113190,73551.3,777100
133590,78489.8,1332350,24480,7213.1,555250,109110,71276.7,777100
127830,69262.7,1332350,22690,5462.1,555250,105140,63800.6,777100
121990,68102,1332350,20870,6877.5,555250,101120,61224.5,777100
116420,65478.7,1332350,19260,5879.3,555250,97160,59599.4,777100
110930,63907,1332350,17650,5990.5,555250,93280,57916.5,777100
105340,61768.4,1332350,16020,7721,555250,89320,54047.4,777100
99840,61464.1,1332350,14420,9239,555250,85420,52225.1,777100
96970,61988.3,1332350,15240,10145.5,555250,81730,51842.8,777100
94130,56998.6,1332350,16060,7746.3,555250,78070,49252.3,777100
91220,51949.8,1332350,16870,5911.8,555250,74350,46038,777100
88350,51523.8,1332350,17690,6899.6,555250,70660,44624.2,777100
85890,54740.4,1332350,19030,10588.4,555250,66860,44152,777100
83460,53924.3,1332350,20400,11123.1,555250,63060,42801.2,777100
81050,50393,1332350,21760,10560.5,555250,59290,39832.5,777100
78580,46861.3,1332350,23110,8896.1,555250,55470,37965.2,777100
75220,42831.4,1332350,23360,7896.2,555250,51860,34935.2,777100
71820,37202.7,1332350,23610,5689.7,555250,48210,31513,777100
68460,33699.2,1332350,23880,5479.4,555250,44580,28219.8,777100
65070,29414,1332350,24120,4988.6,555250,40950,24425.4,777100
65390,25745.5,1332350,26220,4833.3,555250,39170,20912.2,777100
65650,28227.6,1332350,28340,6997.7,555250,37310,21229.9,777100
65920,35765.9,1332350,30450,12844.9,555250,35470,22921,777100
52540,42557.1,1332350,25490,16994.8,555250,27050,25562.3,777100
54780,30114.6,1332350,29550,13597.9,555250,25230,16516.7,777100
57000,27686.9,1332350,33620,14407.7,555250,23380,13279.2,777100
59190,27339.4,1332350,37700,17238.9,555250,21490,10100.5,777100
61350,26448.6,1332350,41760,18406,555250,19590,8042.6,777100
64060,33036.8,1332350,46140,25730.1,555250,17920,7306.7,777100
66710,46280.2,1332350,50520,37132.8,555250,16190,9147.4,777100
69340,50468.7,1332350,54910,43420.1,555250,14430,7048.6,777100
72090,59956.9,1332350,59310,50635.7,555250,12780,9321.2,777100
77510,73487.6,1332350,62690,60490.2,555250,14820,12997.4,777100
83040,69923.5,1332350,66130,58914.1,555250,16910,11009.4,777100
88460,76039.9,1332350,69510,62898.5,555250,18950,13141.4,777100
93980,82538.2,1332350,72950,67407.5,555250,21030,15130.7,777100
100100,84375.4,1332350,76930,68522.4,555250,23170,15853,777100
106230,82828.8,1332350,80940,67448.7,555250,25290,15380.1,777100
112340,87084.8,1332350,84920,69919.5,555250,27420,17165.3,777100
118480,111521.4,1332350,88920,86198.4,555250,29560,25323,777100
124960,155953.4,1332350,93090,111777,555250,31870,44176.4,777100
131490,155366.6,1332350,97250,111452.1,555250,34240,43914.5,777100
137960,139434.8,1332350,101430,102557.3,555250,36530,36877.5,777100
144460,130248.9,1332350,105600,96926.1,555250,38860,33322.8,777100
144840,130927.2,1332350,103690,94655.9,555250,41150,36271.3,777100
145200,127062.8,1332350,101780,89274.6,555250,43420,37788.2,777100
145510,122874.9,1332350,99860,85305.7,555250,45650,37569.2,777100
145970,122209.3,1332350,97960,83007.5,555250,48010,39201.8,777100
146300,126224.5,1332350,95780,84129.8,555250,50520,42094.7,777100
146740,125312.9,1332350,93640,82430,555250,53100,42882.9,777100
147070,127874.5,1332350,91480,83188,555250,55590,44686.5,777100
147500,152748,1332350,89290,98075.6,555250,58210,54672.4,777100
147860,168651.3,1332350,86940,106086.5,555250,60920,62564.8,777100
148250,167580.2,1332350,84570,104492.9,555250,63680,63087.3,777100
148650,161182.3,1332350,82200,99571.5,555250,66450,61610.8,777100
149010,167902.4,1332350,79810,102098.1,555250,69200,65804.3,777100
146710,170597.7,1332350,79450,103880.9,555250,67260,66716.8,777100
144400,168357.1,1332350,79080,102934.9,555250,65320,65422.2,777100
142130,157129.7,1332350,78710,96927,555250,63420,60202.7,777100
139830,163316.3,1332350,78370,101055.5,555250,61460,62260.8,777100
139530,169866,1332350,78590,105524.1,555250,60940,64341.9,777100
139240,148526.4,1332350,78820,94047.3,555250,60420,54479.1,777100
138940,148959.1,1332350,79050,95298.1,555250,59890,53661,777100
138680,152990.4,1332350,79290,97075.6,555250,59390,55914.8,777100
138910,136581.3,1332350,79830,86127.7,555250,59080,50453.6,777100
139070,150331.9,1332350,80370,94310.5,555250,58700,56021.4,777100
139300,135984.9,1332350,80880,85961.4,555250,58420,50023.5,777100
139580,110346.7,1332350,81430,69557.6,555250,58150,40789.1,777100
148110,123739.2,1332350,87050,78350,555250,61060,45389.2,777100
156650,125694,1332350,92670,79306,555250,63980,46388,777100
165130,153414.3,1332350,98290,97286.4,555250,66840,56127.9,777100
173720,176121.1,1332350,103920,111787.1,555250,69800,64334,777100
182280,157306.1,1332350,109630,102268.4,555250,72650,55037.7,777100
190950,136712.5,1332350,115390,90313.4,555250,75560,46399.1,777100
199550,121513.4,1332350,121100,83691.8,555250,78450,37821.6,777100
208110,137084,1332350,126830,92857.2,555250,81280,44226.8,777100
217580,149297.2,1332350,133570,99653.4,555250,84010,49643.8,777100
226890,145158.7,1332350,140290,99863.9,555250,86600,45294.8,777100
236340,130578.3,1332350,147020,91325.2,555250,89320,39253.1,777100
245700,124892.1,1332350,153740,90598.4,555250,91960,34293.7,777100
257330,141944.3,1332350,163180,103027.8,555250,94150,38916.5,777100
268930,169426.2,1332350,172630,124623.4,555250,96300,44802.8,777100
280630,230853.6,1332350,182080,168708.7,555250,98550,62144.9,777100
292260,264981.3,1332350,191520,191527.1,555250,100740,73454.2,777100
304980,317158.8,1332350,201980,226814,555250,103000,90344.8,777100
317710,334704.9,1332350,212460,240620.6,555250,105250,94084.3,777100
330350,396798.2,1332350,222900,280246.9,555250,107450,116551.3,777100
343030,421485.8,1332350,233360,297337.3,555250,109670,124148.5,777100
356210,479517.9,1332350,244160,335155.1,555250,112050,144362.8,777100
369500,495411.2,1332350,254960,346633.4,555250,114540,148777.8,777100
382600,514921.6,1332350,265710,359330.8,555250,116890,155590.8,777100
395730,549010.4,1332350,276520,382320.3,555250,119210,166690.1,777100
401280,571124.8,1332350,281860,395459,555250,119420,175665.8,777100
406760,557733.7,1332350,287160,387696.5,555250,119600,170037.2,777100
412180,554949.4,1332350,292500,388534.4,555250,119680,166415,777100
417660,591618.8,1332350,297860,412490,555250,119800,179128.8,777100
421040,585975,1332350,300880,408602.2,555250,120160,177372.8,777100
424450,597251.6,1332350,303940,417126.2,555250,120510,180125.4,777100
427870,617139.1,1332350,307000,430419.1,555250,120870,186720,777100
431230,602565.9,1332350,310020,421931,555250,121210,180634.9,777100
433030,585760.4,1332350,311700,413447.5,555250,121330,172312.9,777100
434860,579583.7,1332350,313370,410408.4,555250,121490,169175.3,777100
436630,602015.6,1332350,315020,426655.8,555250,121610,175359.8,777100
438490,605723.5,1332350,316710,425072.5,555250,121780,180651,777100
437910,612875.4,1332350,315090,427631.9,555250,122820,185243.5,777100
437380,607151.3,1332350,313460,425229.5,555250,123920,181921.8,777100
436770,603570.5,1332350,311840,423402,555250,124930,180168.5,777100
436170,591074.9,1332350,310190,413634.2,555250,125980,177440.7,777100
435340,588162,1332350,308240,410348.1,555250,127100,177813.9,777100
434460,592932.5,1332350,306220,409888.8,555250,128240,183043.7,777100
433620,598449.1,1332350,304200,409305.8,555250,129420,189143.3,777100
432760,613596.3,1332350,302200,418810.1,555250,130560,194786.2,777100
432620,595829.3,1332350,300620,407708,555250,132000,188121.3,777100
432480,608177.3,1332350,299010,408769.1,555250,133470,199408.2,777100
432320,591689.3,1332350,297430,394379.6,555250,134890,197309.7,777100
432180,569383.2,1332350,295850,380687.4,555250,136330,188695.8,777100
430380,608964.3,1332350,292180,397266.2,555250,138200,211698.1,777100
428670,623277.2,1332350,288490,401085.8,555250,140180,222191.4,777100
427030,620198.6,1332350,284840,396886.4,555250,142190,223312.2,777100
436390,609944.3,1332350,302220,396744.6,555250,134170,213199.7,777100
436350,592084.9,1332350,299760,385383.6,555250,136590,206701.3,777100
436330,599260.1,1332350,297310,387202.9,555250,139020,212057.2,777100
436310,591415.9,1332350,294850,379493.9,555250,141460,211922,777100
436310,583175.1,1332350,292400,374372.9,555250,143910,208802.2,777100
437870,567940.1,1332350,291590,363880.5,555250,146280,204059.6,777100
439390,540104.8,1332350,290800,347310.4,555250,148590,192794.4,777100
440920,517808.1,1332350,290000,333452.9,555250,150920,184355.2,777100
442430,475080.8,1332350,289190,307793.3,555250,153240,167287.5,777100
436480,432899.9,1332350,283120,278519.5,555250,153360,154380.4,777100
430580,444322.7,1332350,277040,280108.9,555250,153540,164213.8,777100
424670,442130.1,1332350,270930,274376.3,555250,153740,167753.8,777100
418830,452311.5,1332350,264890,277377.6,555250,153940,174933.9,777100
411040,429497.6,1332350,257340,261285.3,555250,153700,168212.3,777100
403290,367995.4,1332350,249790,241518.8,555250,153500,126476.6,777100
395500,358459.4,1332350,242240,223553.8,555250,153260,134905.6,777100
387770,303999.4,1332350,234700,195033.2,555250,153070,108966.2,777100
380140,311421.3,1332350,227120,185214.9,555250,153020,126206.4,777100
372470,299415.8,1332350,219540,176713,555250,152930,122702.8,777100
364870,267347.9,1332350,211980,157908.9,555250,152890,109439,777100
357210,238662.9,1332350,204380,140437.2,555250,152830,98225.7,777100
350040,244834.8,1332350,200940,141405.8,555250,149100,103429,777100
342820,249092.9,1332350,197500,146455.9,555250,145320,102637,777100
335710,224747.2,1332350,194060,131650.6,555250,141650,93096.6,777100
328500,213372,1332350,190610,122992.7,555250,137890,90379.3,777100
321250,217110.5,1332350,187520,125622.2,555250,133730,91488.3,777100
313940,207795.4,1332350,184430,120414.3,555250,129510,87381.1,777100
306650,213500,1332350,181370,129713.8,555250,125280,83786.2,777100
299360,197717.5,1332350,178270,123128.8,555250,121090,74588.7,777100
291860,186024.7,1332350,175420,120532.3,555250,116440,65492.4,777100
284440,198069.9,1332350,172620,130685,555250,111820,67384.9,777100
276880,185909.8,1332350,169780,125382.4,555250,107100,60527.4,777100
269410,215086.7,1332350,166920,144699.7,555250,102490,70387,777100
268150,241446.7,1332350,166570,162073.5,555250,101580,79373.2,777100
266990,212750.4,1332350,166190,146215.2,555250,100800,66535.2,777100
265770,201961.2,1332350,165830,140820.8,555250,99940,61140.4,777100
264590,194415.6,1332350,165470,138935.8,555250,99120,55479.8,777100
266100,185334.6,1332350,166650,132898.7,555250,99450,52435.9,777100
267560,169185.3,1332350,167860,125447.9,555250,99700,43737.4,777100
268920,181579.3,1332350,169040,131216.4,555250,99880,50362.9,777100
270390,203297.1,1332350,170250,142925.8,555250,100140,60371.3,777100
269430,211815.5,1332350,169020,146934.4,555250,100410,64881.1,777100
268450,208352.2,1332350,167790,146419.9,555250,100660,61932.3,777100
267380,191926.9,1332350,166540,137471,555250,100840,54455.9,777100
266410,181395.5,1332350,165320,130470,555250,101090,50925.5,777100
265670,175534.5,1332350,162910,125670.4,555250,102760,49864.1,777100
264910,163783.3,1332350,160460,116167.8,555250,104450,47615.5,777100
264090,161263.7,1332350,158030,111013.1,555250,106060,50250.6,777100
263360,151250.5,1332350,155600,104523.7,555250,107760,46726.8,777100
262500,175200.6,1332350,152990,117607.4,555250,109510,57593.2,777100
261620,175770.6,1332350,150380,115049.8,555250,111240,60720.8,777100
260770,195883.2,1332350,147750,122082.9,555250,113020,73800.3,777100
259860,196057.3,1332350,145130,119612.5,555250,114730,76444.8,777100
260860,191286.2,1332350,143730,115333.8,555250,117130,75952.4,777100
261860,205095.8,1332350,142330,121297.3,555250,119530,83798.5,777100
262820,226689.1,1332350,140890,130913.1,555250,121930,95776,777100
263880,236598.7,1332350,139490,134853.4,555250,124390,101745.3,777100
264660,234608.7,1332350,138490,133151.2,555250,126170,101457.5,777100
265410,248434.5,1332350,137490,136460.4,555250,127920,111974.1,777100
266270,247450.3,1332350,136530,139791.8,555250,129740,107658.5,777100
267070,250650.9,1332350,135530,139963.3,555250,131540,110687.6,777100
267830,276556.2,1332350,135790,156320.4,555250,132040,120235.8,777100
268540,294591,1332350,136080,164275,555250,132460,130316,777100
269290,298779.2,1332350,136360,166961.9,555250,132930,131817.3,777100
270040,294057.5,1332350,136630,160381.4,555250,133410,133676.1,777100
271100,277507.6,1332350,137740,155154.4,555250,133360,122353.2,777100
272190,274882.8,1332350,138850,154639.6,555250,133340,120243.2,777100
273330,286570.6,1332350,139990,157606.7,555250,133340,128963.9,777100
274440,300136.8,1332350,141110,167166.2,555250,133330,132970.6,777100
268480,335957.8,1332350,141040,189551.9,555250,127440,146405.9,777100
262610,345712.8,1332350,141010,198198.1,555250,121600,147514.7,777100
256540,332619.6,1332350,140920,194797.6,555250,115620,137822,777100
250600,337441.1,1332350,140890,199562.8,555250,109710,137878.3,777100
243550,366907.4,1332350,139440,223391.5,555250,104110,143515.9,777100
236430,379423.2,1332350,138020,235669.3,555250,98410,143753.9,777100
229340,392555.5,1332350,136580,244811.8,555250,92760,147743.7,777100
222280,386429.2,1332350,135150,243211,555250,87130,143218.2,777100
215520,387364.9,1332350,133850,243247.4,555250,81670,144117.5,777100
208730,365855.8,1332350,132590,236314.5,555250,76140,129541.3,777100
202050,337302.1,1332350,131330,221639.8,555250,70720,115662.3,777100
195290,324301.6,1332350,130040,215955.8,555250,65250,108345.8,777100
188090,307133.6,1332350,126110,204859.7,555250,61980,102273.9,777100
180900,281368.3,1332350,122190,186848.6,555250,58710,94519.7,777100
173580,245264.2,1332350,118260,162869.8,555250,55320,82394.4,777100
166480,188891.4,1332350,114330,130888.7,555250,52150,58002.7,777100
160230,163986.8,1332350,111320,116931.1,555250,48910,47055.7,777100
153900,174034.1,1332350,108330,121640.4,555250,45570,52393.7,777100
147680,173575.1,1332350,105350,122113.1,555250,42330,51462,777100
141450,156006.9,1332350,102340,113585.1,555250,39110,42421.8,777100
136410,128086.9,1332350,99910,98934,555250,36500,29152.9,777100
131360,105484.9,1332350,97490,85298.1,555250,33870,20186.8,777100
126250,76416.1,1332350,95060,64031.6,555250,31190,12384.5,777100
121210,78317.7,1332350,92600,65167.3,555250,28610,13150.4,777100
115210,94187.2,1332350,87740,75330.8,555250,27470,18856.4,777100
109210,109948.6,1332350,82860,84322.4,555250,26350,25626.2,777100
103240,89227.4,1332350,77940,69195,555250,25300,20032.4,777100
60200,101550,1332350,44420,67375,555250,15780,34175,777100
57940,82844,1332350,42840,54662.2,555250,15100,28181.8,777100
55650,72986,1332350,41260,47943,555250,14390,25043,777100
53370,72796.5,1332350,39670,47569.8,555250,13700,25226.7,777100
51190,62520.6,1332350,38110,40594.6,555250,13080,21926,777100
49240,50498.1,1332350,36730,32766.5,555250,12510,17731.6,777100
47360,38674.4,1332350,35380,23950.3,555250,11980,14724.1,777100
45420,33520.6,1332350,34010,19809.8,555250,11410,13710.8,777100
43490,30984.6,1332350,32630,17324.3,555250,10860,13660.3,777100
41540,29842.3,1332350,30910,15672.3,555250,10630,14170,777100
39610,20394.6,1332350,29190,8522.4,555250,10420,11872.2,777100
37630,17965.1,1332350,27450,7210.2,555250,10180,10754.9,777100
35620,16183.7,1332350,25710,7121.3,555250,9910,9062.4,777100
34380,9902.3,1332350,24650,3616.5,555250,9730,6285.8,777100
33080,9560.5,1332350,23560,4154.6,555250,9520,5405.9,777100
31790,10347.3,1332350,22470,4746.6,555250,9320,5600.7,777100
30460,10355.3,1332350,21380,5027.1,555250,9080,5328.2,777100
28550,10161.2,1332350,19680,5215.1,555250,8870,4946.1,777100
26540,10132.2,1332350,17950,5088.2,555250,8590,5044,777100
24570,11256.9,1332350,16220,5344.1,555250,8350,5912.8,777100
22580,12858.2,1332350,14500,5594.4,555250,8080,7263.8,777100
23640,17887.6,1332350,15310,8463.6,555250,8330,9424,777100
24770,19418.1,1332350,16120,7985.9,555250,8650,11432.2,777100
25820,25206.5,1332350,16920,10444.9,555250,8900,14761.6,777100
26920,41829.6,1332350,17750,20098.2,555250,9170,21731.4,777100
28590,39802.2,1332350,18900,20257,555250,9690,19545.2,777100
30300,39225.5,1332350,20040,20785.8,555250,10260,18439.7,777100
31980,34740.2,1332350,21190,19368,555250,10790,15372.2,777100
33620,29515.3,1332350,22330,16799.2,555250,11290,12716.1,777100
35710,29271.1,1332350,23670,17812.5,555250,12040,11458.6,777100
37730,33507,1332350,24980,21696,555250,12750,11811,777100
39740,29821.7,1332350,26310,20515.1,555250,13430,9306.6,777100
41830,31092.3,1332350,27620,21346.6,555250,14210,9745.7,777100
45380,39544.1,1332350,29860,27274.4,555250,15520,12269.7,777100
48920,49144.7,1332350,32080,33759.1,555250,16840,15385.6,777100
52510,36098.9,1332350,34290,26599.7,555250,18220,9499.2,777100
56130,27135.9,1332350,36540,20523.4,555250,19590,6612.5,777100
59310,34143.4,1332350,38330,24028.4,555250,20980,10115,777100
62570,38326.1,1332350,40160,25950.9,555250,22410,12375.2,777100
65870,33519.3,1332350,41990,23154.7,555250,23880,10364.6,777100
69080,27317.1,1332350,43810,18015.1,555250,25270,9302,777100
72870,25889.2,1332350,45620,15341.7,555250,27250,10547.5,777100
76650,30414.3,1332350,47410,18506,555250,29240,11908.3,777100
80530,34355.1,1332350,49240,20773.9,555250,31290,13581.2,777100
84320,47821.8,1332350,51050,26494.1,555250,33270,21327.7,777100
84160,40863.7,1332350,49450,21022.7,555250,34710,19841,777100
83960,50960,1332350,47840,27106.2,555250,36120,23853.8,777100
83850,86985.7,1332350,46250,43607.8,555250,37600,43377.9,777100
83710,82831.7,1332350,44660,39832.5,555250,39050,42999.2,777100
83140,67157.5,1332350,42810,31112.3,555250,40330,36045.2,777100
82680,60801.8,1332350,40970,24191,555250,41710,36610.8,777100
82140,69604,1332350,39120,28296.2,555250,43020,41307.8,777100
81630,92585.1,1332350,37280,40199.8,555250,44350,52385.3,777100
82230,86435.6,1332350,36070,34804.3,555250,46160,51631.3,777100
82800,77794.8,1332350,34850,25287.8,555250,47950,52507,777100
83330,70741.4,1332350,33660,19403.3,555250,49670,51338.1,777100
83980,67451.9,1332350,32440,16177.9,555250,51540,51274,777100
83480,64061.1,1332350,31300,17456.2,555250,52180,46604.9,777100
82910,65953,1332350,30120,15628.8,555250,52790,50324.2,777100
82390,69374,1332350,28970,20100,555250,53420,49274,777100
81880,70999.7,1332350,27820,21313.8,555250,54060,49685.9,777100
80650,80701,1332350,26600,27441,555250,54050,53260,777100
79420,90809.1,1332350,25400,33270.8,555250,54020,57538.3,777100
78070,96045.7,1332350,24130,37444.9,555250,53940,58600.8,777100
76780,103300.1,1332350,22910,41265.3,555250,53870,62034.8,777100
75060,93498.4,1332350,22170,36835,555250,52890,56663.4,777100
73380,95138.2,1332350,21440,38571.2,555250,51940,56567,777100
71660,114966.3,1332350,20690,51123.4,555250,50970,63842.9,777100
69880,115907.9,1332350,19930,51697.7,555250,49950,64210.2,777100
67320,113207.5,1332350,19030,50320.9,555250,48290,62886.6,777100
64850,113807.2,1332350,18110,50654.5,555250,46740,63152.7,777100
62310,99313.8,1332350,17200,42805.3,555250,45110,56508.5,777100
59790,102133.8,1332350,16290,42387.5,555250,43500,59746.3,777100
58080,117888.3,1332350,16880,49721.2,555250,41200,68167.1,777100
56430,123843.2,1332350,17480,52909.9,555250,38950,70933.3,777100
54660,109936.3,1332350,18100,47529.8,555250,36560,62406.5,777100
53020,85738.1,1332350,18670,35054.2,555250,34350,50683.9,777100
51740,78844.8,1332350,19370,31805.2,555250,32370,47039.6,777100
50410,65276.4,1332350,20070,26704.5,555250,30340,38571.9,777100
49200,51175.3,1332350,20780,20721.4,555250,28420,30453.9,777100
47900,52947.8,1332350,21480,22838.3,555250,26420,30109.5,777100
60370,90066.9,1332350,28570,45831.5,555250,31800,44235.4,777100
72760,148701.5,1332350,35690,81076.6,555250,37070,67624.9,777100
85180,128136,1332350,42800,68000.5,555250,42380,60135.5,777100
97630,110867.9,1332350,49920,54280.9,555250,47710,56587,777100
109770,158417.7,1332350,55910,78184.8,555250,53860,80232.9,777100
121940,170300,1332350,61890,87550.4,555250,60050,82749.6,777100
134120,170105.2,1332350,67880,93704.1,555250,66240,76401.1,777100
146290,172767.7,1332350,73900,94790.8,555250,72390,77976.9,777100
160340,158135.8,1332350,80610,86059.8,555250,79730,72076,777100
174270,150824.2,1332350,87300,81320.3,555250,86970,69503.9,777100
188280,134889.8,1332350,94010,73236.1,555250,94270,61653.7,777100
202320,127810.1,1332350,100730,70531.2,555250,101590,57278.9,777100
212350,139512.8,1332350,106840,76205.6,555250,105510,63307.2,777100
222520,171103.9,1332350,112990,90708,555250,109530,80395.9,777100
232550,234315.7,1332350,119150,125984.6,555250,113400,108331.1,777100
306190,197665.8,1332350,163230,108991.3,555250,142960,88674.5,777100
307550,155118.4,1332350,159190,80739,555250,148360,74379.4,777100
308910,131318.7,1332350,155080,66447.4,555250,153830,64871.3,777100
310190,145165.8,1332350,151010,68305.5,555250,159180,76860.3,777100
311480,138928.6,1332350,146940,52370.8,555250,164540,86557.8,777100
317090,149805.5,1332350,148770,57576.9,555250,168320,92228.6,777100
322800,167308,1332350,150600,73406.3,555250,172200,93901.7,777100
328420,207765.9,1332350,152420,94944.9,555250,176000,112821,777100
334010,209681.3,1332350,154230,97673.5,555250,179780,112007.8,777100
338930,208501.1,1332350,157670,97280.9,555250,181260,111220.2,777100
343810,201912.5,1332350,161160,95244,555250,182650,106668.5,777100
348660,192632.5,1332350,164590,86687.6,555250,184070,105944.9,777100
353530,168076.7,1332350,168060,74080,555250,185470,93996.7,777100
359810,169086.1,1332350,172370,75175.8,555250,187440,93910.3,777100
365870,191730.9,1332350,176660,90032.2,555250,189210,101698.7,777100
372170,223981.9,1332350,180980,109092.8,555250,191190,114889.1,777100
378340,287490.9,1332350,185290,142213.2,555250,193050,145277.7,777100
384230,288419.6,1332350,190770,143595.2,555250,193460,144824.4,777100
390040,276800.2,1332350,196230,144724.6,555250,193810,132075.6,777100
395850,305482.1,1332350,201710,167329.1,555250,194140,138153,777100
401750,356974.3,1332350,207180,197429.6,555250,194570,159544.7,777100
409420,343406.1,1332350,210700,188892.2,555250,198720,154513.9,777100
417120,266812.9,1332350,214230,145322.8,555250,202890,121490.1,777100
424770,216604.9,1332350,217770,123870.7,555250,207000,92734.2,777100
432360,204548.9,1332350,221270,125397.7,555250,211090,79151.2,777100
438680,213813.8,1332350,223640,132179.7,555250,215040,81634.1,777100
444890,287901.3,1332350,225990,171747.1,555250,218900,116154.2,777100
451100,336332.9,1332350,228360,197363.3,555250,222740,138969.6,777100
457320,320229.8,1332350,230700,184518.5,555250,226620,135711.3,777100
463200,319816.6,1332350,233740,186656.9,555250,229460,133159.7,777100
468960,361029.6,1332350,236700,213040,555250,232260,147989.6,777100
474820,339838.4,1332350,239700,203666.6,555250,235120,136171.8,777100
480590,355401.8,1332350,242690,211763.5,555250,237900,143638.3,777100
481240,345465,1332350,240460,203827.6,555250,240780,141637.4,777100
481960,322261.5,1332350,238210,185238,555250,243750,137023.5,777100
482610,336051.6,1332350,235940,189012.1,555250,246670,147039.5,777100
483260,332996.1,1332350,233730,190062.3,555250,249530,142933.8,777100
481750,370734.8,1332350,229540,212547.2,555250,252210,158187.6,777100
480190,420340.9,1332350,225370,239180,555250,254820,181160.9,777100
478670,423029.5,1332350,221230,235933.8,555250,257440,187095.7,777100
477150,378809.8,1332350,217050,206650.5,555250,260100,172159.3,777100
478340,270933,1332350,214850,140439.7,555250,263490,130493.3,777100
479590,268727.4,1332350,212650,139956,555250,266940,128771.4,777100
480760,270266.5,1332350,210410,137241.1,555250,270350,133025.4,777100
482050,294806.7,1332350,208210,149627.2,555250,273840,145179.5,777100
480030,281797.4,1332350,207950,142418,555250,272080,139379.4,777100
478030,278034.2,1332350,207650,138836.8,555250,270380,139197.4,777100
476050,250017,1332350,207370,118682,555250,268680,131335,777100
474020,234738.5,1332350,207120,112132.7,555250,266900,122605.8,777100
471840,240617.6,1332350,205830,114797,555250,266010,125820.6,777100
469600,259391.2,1332350,204480,126417.8,555250,265120,132973.4,777100
467390,285090,1332350,203180,142310,555250,264210,142780,777100
465170,289092.7,1332350,201890,142698.3,555250,263280,146394.4,777100
462580,272330.9,1332350,200700,133825,555250,261880,138505.9,777100
459960,270705.8,1332350,199540,130935.2,555250,260420,139770.6,777100
457400,279480.8,1332350,198370,133011.7,555250,259030,146469.1,777100
454800,276217.7,1332350,197200,129591.1,555250,257600,146626.6,777100
445170,299911.4,1332350,192670,146440.5,555250,252500,153470.9,777100
435510,345596.2,1332350,188100,173754.5,555250,247410,171841.7,777100
425880,357093.1,1332350,183580,181940.8,555250,242300,175152.3,777100
416250,333184.1,1332350,179060,162588.6,555250,237190,170595.5,777100
404220,330530,1332350,172480,164275.1,555250,231740,166254.9,777100
392260,332472.5,1332350,165920,160138.9,555250,226340,172333.6,777100
380180,292086.8,1332350,159340,141786,555250,220840,150300.8,777100
368220,273870.4,1332350,152770,129339.4,555250,215450,144531,777100
356360,270660,1332350,147160,127275.7,555250,209200,143384.3,777100
344500,253677.2,1332350,141510,115133.9,555250,202990,138543.3,777100
332590,279421.2,1332350,135870,126478.4,555250,196720,152942.8,777100
320690,275801.2,1332350,130220,126588.9,555250,190470,149212.3,777100
306950,279791.2,1332350,124730,123760.2,555250,182220,156031,777100
293200,271751,1332350,119220,124386.5,555250,173980,147364.5,777100
279410,243909.5,1332350,113690,110299.2,555250,165720,133610.3,777100
265580,255454.3,1332350,108170,118213.2,555250,157410,137241.1,777100
253010,262327,1332350,103360,120908.9,555250,149650,141418.1,777100
240400,233197.6,1332350,98510,108586.9,555250,141890,124610.7,777100
227790,206155.7,1332350,93660,98625.9,555250,134130,107529.8,777100
215240,203589.8,1332350,88840,100552.9,555250,126400,103036.9,777100
202270,209423.4,1332350,83510,103819.8,555250,118760,105603.6,777100
189280,203063.1,1332350,78150,100598.1,555250,111130,102465,777100
176320,201062.8,1332350,72830,103450.2,555250,103490,97612.6,777100
163400,228358.1,1332350,67470,120291.4,555250,95930,108066.7,777100
159610,227698.5,1332350,65650,120364.9,555250,93960,107333.6,777100
155850,213656,1332350,63790,113272.7,555250,92060,100383.3,777100
152080,224929.9,1332350,61990,117369.8,555250,90090,107560.1,777100
148320,246443.3,1332350,60150,130755.1,555250,88170,115688.2,777100
144030,228558.9,1332350,57690,119498.4,555250,86340,109060.5,777100
139770,192669.4,1332350,55310,97257.2,555250,84460,95412.2,777100
135490,173941.8,1332350,52890,86672.1,555250,82600,87269.7,777100
131290,174540.2,1332350,50500,88578.4,555250,80790,85961.8,777100
128430,147282.9,1332350,48940,71809.2,555250,79490,75473.7,777100
125570,142253.9,1332350,47420,66807,555250,78150,75446.9,777100
122810,152722.6,1332350,45890,73208.5,555250,76920,79514.1,777100
120030,169539,1332350,44350,84645.5,555250,75680,84893.5,777100
123540,172925.8,1332350,47360,85465.9,555250,76180,87459.9,777100
127020,153619.6,1332350,50390,74655.4,555250,76630,78964.2,777100
130550,142445.5,1332350,53380,68562.3,555250,77170,73883.2,777100
133510,102901.2,1332350,78820,62944.3,555250,54690,39956.9,777100
132950,101106.2,1332350,77960,65648.4,555250,54990,35457.8,777100
132320,121855,1332350,77050,76766.7,555250,55270,45088.3,777100
131750,122700.7,1332350,76180,75644.4,555250,55570,47056.3,777100
131220,134388.2,1332350,75330,82289.1,555250,55890,52099.1,777100
129860,137903.4,1332350,73500,83616.8,555250,56360,54286.6,777100
128400,132895.8,1332350,71660,79117,555250,56740,53778.8,777100
126960,133963.6,1332350,69850,78462.7,555250,57110,55500.9,777100
125510,156534.2,1332350,68010,89748.4,555250,57500,66785.8,777100
121900,148094.2,1332350,65660,82815.3,555250,56240,65278.9,777100
118250,130984.8,1332350,63250,72438.6,555250,55000,58546.2,777100
114580,111886,1332350,60910,60348.6,555250,53670,51537.4,777100
110910,74748.6,1332350,58500,38455.7,555250,52410,36292.9,777100
106080,75514.9,1332350,55030,38054.4,555250,51050,37460.5,777100
101240,75583.8,1332350,51520,37778.5,555250,49720,37805.3,777100
96340,60320,1332350,48030,28492.4,555250,48310,31827.6,777100
91490,48039.2,1332350,44530,20424.5,555250,46960,27614.7,777100
88040,46606.4,1332350,42310,18874.3,555250,45730,27732.1,777100
84460,43931.4,1332350,40100,17062.8,555250,44360,26868.6,777100
80920,44126.9,1332350,37850,16623.3,555250,43070,27503.6,777100
77360,40390.7,1332350,35630,14139.3,555250,41730,26251.4,777100
79250,38042.9,1332350,38080,13794.4,555250,41170,24248.5,777100
81190,36801.7,1332350,40560,14132.3,555250,40630,22669.4,777100
83030,30566.4,1332350,42990,10968,555250,40040,19598.4,777100
84990,32158,1332350,45440,12752.1,555250,39550,19405.9,777100
87690,37851.6,1332350,49150,17982.1,555250,38540,19869.5,777100
90340,46141.5,1332350,52810,24971.1,555250,37530,21170.4,777100
93160,55341.3,1332350,56520,33267.6,555250,36640,22073.7,777100
95800,74527.3,1332350,60200,47053.7,555250,35600,27473.6,777100
95240,109262.8,1332350,61410,69654.8,555250,33830,39608,777100
94620,131862.7,1332350,62600,84243.9,555250,32020,47618.8,777100
94080,134322.7,1332350,63770,87260.7,555250,30310,47062,777100
93500,130291.9,1332350,64960,85345.7,555250,28540,44946.2,777100
99090,138088.8,1332350,70820,92539.7,555250,28270,45549.1,777100
104650,166901.4,1332350,76620,111676.9,555250,28030,55224.5,777100
110310,192808.9,1332350,82480,130272.8,555250,27830,62536.1,777100
115820,215940.8,1332350,88280,146441.5,555250,27540,69499.3,777100
121620,247954.4,1332350,93870,168897.3,555250,27750,79057.1,777100
127540,282680.7,1332350,99450,192150,555250,28090,90530.7,777100
133410,326659.3,1332350,105030,218983.1,555250,28380,107676.2,777100
139130,301785.5,1332350,110600,205243.4,555250,28530,96542.1,777100
145710,295962.5,1332350,116860,203724.4,555250,28850,92238.1,777100
152190,326514.3,1332350,123080,222782,555250,29110,103732.3,777100
158760,365113.1,1332350,129350,247922.2,555250,29410,117190.9,777100
165250,361515.3,1332350,135580,245744.9,555250,29670,115770.4,777100
176770,381649.5,1332350,143690,260376.3,555250,33080,121273.2,777100
188220,407061.8,1332350,151820,275736.8,555250,36400,131325,777100
199670,356947.3,1332350,159900,248581.8,555250,39770,108365.5,777100
211140,366391.7,1332350,168020,254608.2,555250,43120,111783.5,777100
222720,378869.4,1332350,175900,260224.1,555250,46820,118645.3,777100
234340,360353,1332350,183840,250318.8,555250,50500,110034.2,777100
245820,363060.8,1332350,191730,252503.3,555250,54090,110557.5,777100
257330,385132.3,1332350,199620,266112.5,555250,57710,119019.8,777100
268830,385633.1,1332350,207590,267940.4,555250,61240,117692.7,777100
280340,405087,1332350,215550,279007.4,555250,64790,126079.6,777100
291920,425260.7,1332350,223530,292216.8,555250,68390,133043.9,777100
303500,458842.1,1332350,231510,314294.2,555250,71990,144547.9,777100
311820,483705.3,1332350,237200,333013.6,555250,74620,150691.7,777100
320120,479200.1,1332350,242910,327706.8,555250,77210,151493.3,777100
328470,497197.2,1332350,248610,340499,555250,79860,156698.2,777100
336790,525715.9,1332350,254310,359495.3,555250,82480,166220.6,777100
344840,502516.2,1332350,260090,349432.9,555250,84750,153083.3,777100
352790,520674.9,1332350,265840,359939.4,555250,86950,160735.5,777100
360780,547328.4,1332350,271650,379095.1,555250,89130,168233.3,777100
368720,468740.4,1332350,277400,335279.2,555250,91320,133461.2,777100
375620,432717.8,1332350,281920,316530.4,555250,93700,116187.4,777100
382520,410937.5,1332350,286430,304152.1,555250,96090,106785.4,777100
389380,368307.7,1332350,290920,276941.8,555250,98460,91365.9,777100
396210,349922.1,1332350,295410,267354.4,555250,100800,82567.7,777100
393940,348182.7,1332350,293050,265252.3,555250,100890,82930.4,777100
391540,371275.4,1332350,290650,278928.7,555250,100890,92346.7,777100
389220,391841.4,1332350,288280,292042.9,555250,100940,99798.5,777100
386980,413366.3,1332350,285900,304861.1,555250,101080,108505.2,777100
385180,487848.1,1332350,284500,350752.4,555250,100680,137095.7,777100
383410,565286.3,1332350,283090,396064.5,555250,100320,169221.8,777100
381640,578920.9,1332350,281670,405386.4,555250,99970,173534.5,777100
379870,545306.6,1332350,280280,384357.2,555250,99590,160949.4,777100
377170,509433.4,1332350,278000,363538,555250,99170,145895.4,777100
374460,471869.4,1332350,275720,340496.6,555250,98740,131372.8,777100
371740,441529.1,1332350,273430,321929.2,555250,98310,119599.9,777100
369010,428367.8,1332350,271120,312801.8,555250,97890,115566,777100
362760,424734.6,1332350,266370,309273.6,555250,96390,115461,777100
356450,409011.9,1332350,261650,296936,555250,94800,112075.9,777100
350290,386931.4,1332350,256900,288294.4,555250,93390,98637,777100
343990,393309.1,1332350,252160,290957.5,555250,91830,102351.6,777100
338020,380520.6,1332350,247920,282222.6,555250,90100,98298,777100
332020,365882.7,1332350,243660,274019.4,555250,88360,91863.3,777100
326070,359555,1332350,239420,269449.7,555250,86650,90105.3,777100
320100,345476.8,1332350,235180,261697,555250,84920,83779.8,777100
313170,348199.7,1332350,229600,261255.6,555250,83570,86944.1,777100
306200,330076.8,1332350,224030,248078.8,555250,82170,81998,777100
299320,359324.6,1332350,218430,260744.5,555250,80890,98580.1,777100
292370,386120.2,1332350,212870,277699.3,555250,79500,108420.9,777100
282990,394283.5,1332350,205000,279867.2,555250,77990,114416.3,777100
273570,424160.6,1332350,197130,295172.3,555250,76440,128988.3,777100
264180,409839.2,1332350,189260,281992.1,555250,74920,127847.1,777100
258330,372552.9,1332350,190360,262532.7,555250,67970,110020.2,777100
251140,371081.5,1332350,184950,261194.1,555250,66190,109887.4,777100
244010,328110.8,1332350,179560,234660.1,555250,64450,93450.7,777100
236820,303240.9,1332350,174100,218164.4,555250,62720,85076.5,777100
229670,274812.9,1332350,168720,200744.7,555250,60950,74068.2,777100
222400,258404.9,1332350,163330,190217.3,555250,59070,68187.6,777100
215060,222723.8,1332350,157950,167214.5,555250,57110,55509.3,777100
207760,202061.4,1332350,152530,154176.5,555250,55230,47884.9,777100
200500,171987.8,1332350,147170,135068.8,555250,53330,36919,777100
190160,155277.6,1332350,138740,123122.8,555250,51420,32154.8,777100
179850,164631.2,1332350,130330,126850.8,555250,49520,37780.4,777100
169540,162524.6,1332350,121900,120829,555250,47640,41695.6,777100
159250,145817.2,1332350,113470,109396.7,555250,45780,36420.5,777100
149100,127133.3,1332350,105150,95218.2,555250,43950,31915.1,777100
139030,108747.1,1332350,96810,82818.8,555250,42220,25928.3,777100
128900,99034,1332350,88470,72429.5,555250,40430,26604.5,777100
118860,85261.6,1332350,80150,60505.2,555250,38710,24756.4,777100
110700,75539.5,1332350,73910,53373.3,555250,36790,22166.2,777100
102560,78045.7,1332350,67630,54699.7,555250,34930,23346,777100
94440,76354,1332350,61340,51952.8,555250,33100,24401.2,777100
86370,54043.8,1332350,55080,37016.4,555250,31290,17027.4,777100
80720,51337.8,1332350,51330,34685.9,555250,29390,16651.9,777100
75160,49310,1332350,47610,33073.1,555250,27550,16236.9,777100
69560,30659.7,1332350,43890,20593.3,555250,25670,10066.4,777100
64110,16572.6,1332350,40180,10625.7,555250,23930,5946.9,777100
58000,8371.9,1332350,35780,3714.7,555250,22220,4657.2,777100
51920,11066.9,1332350,31400,4424.5,555250,20520,6642.4,777100
45920,13030.4,1332350,27030,5481.5,555250,18890,7548.9,777100
39830,7738.4,1332350,22620,1792.2,555250,17210,5946.2,777100
33860,13212,1332350,18440,1802.3,555250,15420,11409.7,777100
27950,11175.1,1332350,14250,1873.6,555250,13700,9301.5,777100
22010,12163.5,1332350,10070,2339.4,555250,11940,9824.1,777100
16040,12571.8,1332350,5870,1684,555250,10170,10887.8,777100
15230,13032.2,1332350,5670,2107.9,555250,9560,10924.3,777100
14320,11329.2,1332350,5450,1949.9,555250,8870,9379.3,777100
13480,9092.2,1332350,5220,997.7,555250,8260,8094.5,777100
12700,11085.9,1332350,5020,1820.3,555250,7680,9265.6,777100
11580,12355.4,1332350,4750,3040.9,555250,6830,9314.5,777100
10630,10619.6,1332350,4460,2612.9,555250,6170,8006.7,777100
9580,6922.7,1332350,4220,696.5,555250,5360,6226.2,777100
8580,6062.7,1332350,3950,503.3,555250,4630,5559.4,777100
7730,5858,1332350,3730,559.6,555250,4000,5298.4,777100
6820,5765,1332350,3520,694.9,555250,3300,5070.1,777100
5960,7699.4,1332350,3310,2102.2,555250,2650,5597.2,777100
5110,4611.9,1332350,3080,564.4,555250,2030,4047.5,777100
5270,7642.2,1332350,3190,2274.3,555250,2080,5367.9,777100
5510,4180.4,1332350,3330,1224.8,555250,2180,2955.6,777100
5770,2136.9,1332350,3470,286.3,555250,2300,1850.6,777100
5870,1796.5,1332350,3570,292.6,555250,2300,1503.9,777100
6270,2186.2,1332350,3760,530.5,555250,2510,1655.7,777100
6520,2353.2,1332350,3890,484.9,555250,2630,1868.3,777100
6830,4360.5,1332350,4060,1881.8,555250,2770,2478.7,777100
7100,5980.9,1332350,4210,3289.6,555250,2890,2691.3,777100
7630,15537.2,1332350,4520,8902.3,555250,3110,6634.9,777100
8250,9866.2,1332350,4880,5693.3,555250,3370,4172.9,777100
8760,10414.1,1332350,5180,5980.3,555250,3580,4433.8,777100
9270,14162.1,1332350,5510,8246.1,555250,3760,5916,777100
10740,9848.6,1332350,6260,5571.1,555250,4480,4277.5,777100
12250,5795.7,1332350,7060,2599.2,555250,5190,3196.5,777100
13690,6777.2,1332350,7800,2283.1,555250,5890,4494.1,777100
15210,6110.8,1332350,8580,1188.3,555250,6630,4922.5,777100
16690,10543.6,1332350,9240,4436.6,555250,7450,6107,777100
18190,10325,1332350,9910,4093.2,555250,8280,6231.8,777100
19630,10239.3,1332350,10560,2917.7,555250,9070,7321.6,777100
21090,9178.9,1332350,11240,1641.5,555250,9850,7537.4,777100
22480,10350,1332350,11670,1404.8,555250,10810,8945.2,777100
23960,10501.4,1332350,12140,1573.9,555250,11820,8927.5,777100
25370,10256.9,1332350,12580,1553.4,555250,12790,8703.5,777100
26880,10805.7,1332350,13060,1573.3,555250,13820,9232.4,777100
29810,11322,1332350,14180,2104.7,555250,15630,9217.3,777100
32710,14310.3,1332350,15290,3310.4,555250,17420,10999.9,777100
35720,19127.7,1332350,16430,6302.8,555250,19290,12824.9,777100
38580,25905.4,1332350,17530,9505.9,555250,21050,16399.5,777100
41400,33305.3,1332350,18520,13246,555250,22880,20059.3,777100
44160,35200.5,1332350,19460,14608.3,555250,24700,20592.2,777100
47030,34734.1,1332350,20440,13545.8,555250,26590,21188.3,777100
49790,35802.4,1332350,21390,13562.8,555250,28400,22239.6,777100
52090,40459,1332350,22120,15306.7,555250,29970,25152.3,777100
54510,41229.6,1332350,22880,15470.4,555250,31630,25759.2,777100
56890,46004.5,1332350,23610,18549.5,555250,33280,27455,777100
59290,43046.6,1332350,24380,15345.8,555250,34910,27700.8,777100
62190,42462.9,1332350,25580,13427.9,555250,36610,29035,777100
65080,40789.7,1332350,26780,12854.9,555250,38300,27934.8,777100
67980,46420.3,1332350,28010,14073.9,555250,39970,32346.4,777100
70880,50016,1332350,29240,15743.1,555250,41640,34272.9,777100
73650,60885.5,1332350,30200,21142.5,555250,43450,39743,777100
76360,65454,1332350,31150,24098.5,555250,45210,41355.5,777100
79090,69918,1332350,32100,26156.5,555250,46990,43761.5,777100
81850,73392.2,1332350,33080,26456.3,555250,48770,46935.9,777100
85770,76887.7,1332350,34960,28081.3,555250,50810,48806.4,777100
89750,82643,1332350,36840,30422.4,555250,52910,52220.6,777100
93720,87227.2,1332350,38730,33813.9,555250,54990,53413.3,777100
97650,91817.9,1332350,40600,35903.4,555250,57050,55914.5,777100
98300,96190,1332350,40560,38078.1,555250,57740,58111.9,777100
98980,103083.9,1332350,40520,40712.5,555250,58460,62371.4,777100
99630,106411.3,1332350,40450,42048.4,555250,59180,64362.9,777100
85870,101342.9,1332350,36260,39556.4,555250,49610,61786.5,777100
85000,100687.5,1332350,35180,35427.7,555250,49820,65259.8,777100
84080,108181.5,1332350,34090,37062.7,555250,49990,71118.8,777100
83130,109270.9,1332350,33010,36376.8,555250,50120,72894.1,777100
82240,105184.2,1332350,31930,35711.8,555250,50310,69472.4,777100
81450,104199.5,1332350,31120,34872.8,555250,50330,69326.7,777100
80540,107663.9,1332350,30310,36828.2,555250,50230,70835.7,777100
79710,118825.1,1332350,29490,42592.5,555250,50220,76232.6,777100
78880,116087.3,1332350,28690,40003.6,555250,50190,76083.7,777100
77090,118092.4,1332350,27490,40856.6,555250,49600,77235.8,777100
75370,126559,1332350,26340,44695,555250,49030,81864,777100
73670,128304.2,1332350,25220,45573.3,555250,48450,82730.9,777100
72010,121078.6,1332350,24060,40968.3,555250,47950,80110.3,777100
70360,112810.8,1332350,22910,36799.7,555250,47450,76011.1,777100
68750,109576.7,1332350,21800,34920.4,555250,46950,74656.3,777100
67090,108120.8,1332350,20660,34619,555250,46430,73501.8,777100
65470,104248.8,1332350,19520,32578.8,555250,45950,71670,777100
63770,96359.8,1332350,18370,28041.3,555250,45400,68318.5,777100
62010,95472.5,1332350,17190,27762.4,555250,44820,67710.1,777100
60290,100324.8,1332350,16010,29515.8,555250,44280,70809,777100
58570,98055.5,1332350,14870,26543.3,555250,43700,71512.2,777100
56800,96855.4,1332350,14690,26408.2,555250,42110,70447.2,777100
54970,96016.4,1332350,14470,28049.5,555250,40500,67966.9,777100
53220,99124.6,1332350,14310,30443.1,555250,38910,68681.5,777100
51520,95075.8,1332350,14150,29370.4,555250,37370,65705.4,777100
49850,100431.5,1332350,13790,33727.5,555250,36060,66704,777100
48190,94688,1332350,13420,30371.3,555250,34770,64316.7,777100
46480,91108.8,1332350,13050,30352.2,555250,33430,60756.6,777100
44800,90086.3,1332350,12690,30242,555250,32110,59844.3,777100
43230,85389,1332350,12510,28977.1,555250,30720,56411.9,777100
41660,70743.2,1332350,12320,23676,555250,29340,47067.2,777100
40120,55187.4,1332350,12100,18549.3,555250,28020,36638.1,777100
38590,45573.7,1332350,11930,15516.6,555250,26660,30057.1,777100
36730,41897.8,1332350,11420,14838.1,555250,25310,27059.7,777100
34880,34984.5,1332350,10890,11673.9,555250,23990,23310.6,777100
32970,27561.8,1332350,10370,9267.4,555250,22600,18294.4,777100
31100,21703.3,1332350,9850,7646,555250,21250,14057.3,777100
29570,17148.6,1332350,9340,5888.3,555250,20230,11260.3,777100
28080,12794,1332350,8870,3997.9,555250,19210,8796.1,777100
26580,14757.9,1332350,8400,5018,555250,18180,9739.9,777100
25000,11702.5,1332350,7910,3100.3,555250,17090,8602.2,777100
23890,9813.2,1332350,7500,1538.6,555250,16390,8274.6,777100
22800,8379.8,1332350,7100,633.5,555250,15700,7746.3,777100
21640,7798.8,1332350,6680,305.9,555250,14960,7492.9,777100
20550,7727.6,1332350,6270,302.4,555250,14280,7425.2,777100
20900,7464.2,1332350,6360,346.1,555250,14540,7118.1,777100
21310,8737.6,1332350,6430,560.6,555250,14880,8177,777100
21660,9902.8,1332350,6510,759,555250,15150,9143.8,777100
22070,9573,1332350,6580,1021.6,555250,15490,8551.4,777100
22710,10484,1332350,6890,1351,555250,15820,9133,777100
23380,12467.8,1332350,7210,1721.8,555250,16170,10746,777100
24050,13531.7,1332350,7550,2031.5,555250,16500,11500.2,777100
24770,15986.3,1332350,7900,2300.4,555250,16870,13685.9,777100
25540,18295.4,1332350,8350,2747.7,555250,17190,15547.7,777100
26410,18641.7,1332350,8830,3646.1,555250,17580,14995.6,777100
27270,22627,1332350,9280,5541.2,555250,17990,17085.8,777100
28080,23853.3,1332350,9740,6045.2,555250,18340,17808.1,777100
30750,29347.6,1332350,11490,8944.8,555250,19260,20402.8,777100
33410,34376.3,1332350,13240,12317.8,555250,20170,22058.5,777100
36090,38008.7,1332350,15000,14712.3,555250,21090,23296.4,777100
38720,45021.5,1332350,16730,19728.5,555250,21990,25293,777100
41740,53513,1332350,18730,24464.6,555250,23010,29048.4,777100
44800,56230.7,1332350,20720,27684,555250,24080,28546.7,777100
47840,70276,1332350,22700,36166,555250,25140,34110,777100
50910,96976.2,1332350,24690,50404.8,555250,26220,46571.4,777100
53750,115075.4,1332350,26490,62698.4,555250,27260,52377,777100
56660,130223.3,1332350,28330,70945.2,555250,28330,59278.1,777100
59570,147849.3,1332350,30140,82751.7,555250,29430,65097.6,777100
62420,172230.3,1332350,31980,96147.2,555250,30440,76083.1,777100
67550,186149,1332350,34750,103770.1,555250,32800,82378.9,777100
72620,197733.7,1332350,37550,112717.2,555250,35070,85016.5,777100
77630,205955.1,1332350,40320,115810.9,555250,37310,90144.2,777100
82730,217664.4,1332350,43090,123151.7,555250,39640,94512.7,777100
87550,220263.3,1332350,45700,125531,555250,41850,94732.3,777100
92210,234587.7,1332350,48250,133897.2,555250,43960,100690.5,777100
96870,253534.3,1332350,50830,142294.2,555250,46040,111240.1,777100
101660,272510.7,1332350,53400,155510.3,555250,48260,117000.4,777100
105720,297105.4,1332350,55180,169723.5,555250,50540,127381.9,777100
109770,317387.4,1332350,56960,180867.9,555250,52810,136519.5,777100
113780,333479.4,1332350,58780,192144.7,555250,55000,141334.7,777100
117860,354100.2,1332350,60570,204298.7,555250,57290,149801.5,777100
124130,362836.1,1332350,62510,208324,555250,61620,154512.1,777100
130400,364001.7,1332350,64440,208443,555250,65960,155558.7,777100
136720,363344.5,1332350,66410,204614.2,555250,70310,158730.3,777100
142960,380824,1332350,68340,211466.9,555250,74620,169357.1,777100
149710,374380.3,1332350,71340,205600.4,555250,78370,168779.9,777100
156480,376986.4,1332350,74310,206208.7,555250,82170,170777.7,777100
163180,374118.5,1332350,77290,201559.1,555250,85890,172559.4,777100
169930,356781.2,1332350,80270,187270.3,555250,89660,169510.9,777100
175360,344548.5,1332350,82190,176806.2,555250,93170,167742.3,777100
180810,328987.4,1332350,84160,165724.5,555250,96650,163262.9,777100
186200,328389.1,1332350,86100,162437.3,555250,100100,165951.8,777100
191630,320382.3,1332350,88060,152833.9,555250,103570,167548.4,777100
189570,312850.6,1332350,86970,144159.8,555250,102600,168690.8,777100
187480,318588.4,1332350,85870,150042.5,555250,101610,168545.9,777100
185420,337355.5,1332350,84790,162365.9,555250,100630,174989.6,777100
284200,265549.7,1332350,165350,145344.6,555250,118850,120205.1,777100
278380,257648.1,1332350,160770,143508.9,555250,117610,114139.2,777100
272690,254766.8,1332350,156200,144365.4,555250,116490,110401.4,777100
266970,259490.6,1332350,151620,146165.3,555250,115350,113325.3,777100
261250,257136.4,1332350,147050,142274.8,555250,114200,114861.6,777100
255840,251974.2,1332350,142890,137851.6,555250,112950,114122.6,777100
250450,255702.7,1332350,138740,138533.3,555250,111710,117169.4,777100
245010,251949.9,1332350,134560,137521.1,555250,110450,114428.8,777100
239620,241991.8,1332350,130370,131828.4,555250,109250,110163.4,777100
230280,233554.8,1332350,123230,125943.3,555250,107050,107611.5,777100
220960,226282.9,1332350,116050,120701.1,555250,104910,105581.8,777100
211560,230168.4,1332350,108850,119775.2,555250,102710,110393.2,777100
202190,226448.7,1332350,101670,114846.2,555250,100520,111602.5,777100
193320,220843,1332350,94840,111307,555250,98480,109536,777100
184360,198272,1332350,88030,97364.1,555250,96330,100907.9,777100
175330,182616.2,1332350,81180,87901.6,555250,94150,94714.6,777100
166440,173806.9,1332350,74360,81207.1,555250,92080,92599.8,777100
158200,149933.5,1332350,68130,65525.5,555250,90070,84408,777100
149940,123849.2,1332350,61880,51135.9,555250,88060,72713.3,777100
141680,106781.1,1332350,55640,40158.4,555250,86040,66622.7,777100
133430,108142.1,1332350,49400,38225.7,555250,84030,69916.4,777100
129760,100129.5,1332350,48150,34539.1,555250,81610,65590.4,777100
126050,92322.3,1332350,46820,31374.9,555250,79230,60947.4,777100
122460,87834.1,1332350,45540,29199.2,555250,76920,58634.9,777100
118770,86456.7,1332350,44260,29051,555250,74510,57405.7,777100
115770,84819.2,1332350,43260,28608.5,555250,72510,56210.7,777100
112650,75884.1,1332350,42260,25546.2,555250,70390,50337.9,777100
109640,75534.2,1332350,41280,26610.6,555250,68360,48923.6,777100
106500,65569.1,1332350,40280,22562.9,555250,66220,43006.2,777100
103760,60832,1332350,39400,20679.3,555250,64360,40152.7,777100
101000,59756.4,1332350,38510,21057.1,555250,62490,38699.3,777100
98090,56489.2,1332350,37610,21536.8,555250,60480,34952.4,777100
95340,44480.8,1332350,36750,16450.1,555250,58590,28030.7,777100
93520,33541.6,1332350,36270,11692.3,555250,57250,21849.3,777100
91800,24532.7,1332350,35820,7674.7,555250,55980,16858,777100
89980,20654.3,1332350,35370,6586.7,555250,54610,14067.6,777100
88200,18520.5,1332350,34910,5284.6,555250,53290,13235.9,777100
86710,16849.4,1332350,34580,4099.7,555250,52130,12749.7,777100
85260,14618,1332350,34230,2400,555250,51030,12218,777100
83760,16418,1332350,33890,2899.1,555250,49870,13518.9,777100
82340,22905.5,1332350,33540,4319,555250,48800,18586.5,777100
82370,34656.3,1332350,33780,8074.3,555250,48590,26582,777100
82310,46542.6,1332350,34000,12965.7,555250,48310,33576.9,777100
82350,58651.5,1332350,34230,17237,555250,48120,41414.5,777100
82370,60278.2,1332350,34440,18493.9,555250,47930,41784.3,777100
85750,64405.2,1332350,36570,20812.4,555250,49180,43592.8,777100
89160,71527.6,1332350,38740,25431.6,555250,50420,46096,777100
92540,81546.1,1332350,40860,31450.1,555250,51680,50096,777100
95900,91611.3,1332350,43020,38655,555250,52880,52956.3,777100
99000,97516.1,1332350,45150,43376.7,555250,53850,54139.4,777100
102100,102497.3,1332350,47290,47601.6,555250,54810,54895.7,777100
105210,110826.1,1332350,49440,52084.3,555250,55770,58741.8,777100
108330,126958.4,1332350,51590,61819.6,555250,56740,65138.8,777100
110940,161867.7,1332350,53570,81970.1,555250,57370,79897.6,777100
113510,158948,1332350,55560,82131.4,555250,57950,76816.6,777100
116200,181216.1,1332350,57550,93855,555250,58650,87361.1,777100
118760,184650.2,1332350,59550,95571.5,555250,59210,89078.7,777100
130930,188320.8,1332350,67840,99120.9,555250,63090,89199.9,777100
143100,198243.2,1332350,76150,106590.6,555250,66950,91652.6,777100
155330,223529.6,1332350,84460,124427,555250,70870,99102.6,777100
167510,249285.4,1332350,92770,138992.6,555250,74740,110292.8,777100
181360,257976.5,1332350,102370,146469.9,555250,78990,111506.6,777100
195280,262562.3,1332350,112030,151839.6,555250,83250,110722.7,777100
209140,264426.6,1332350,121610,154828.8,555250,87530,109597.8,777100
223080,279893.4,1332350,131250,166099,555250,91830,113794.4,777100
236840,300659.6,1332350,140480,179844.8,555250,96360,120814.8,777100
250710,316764.7,1332350,149710,192025.5,555250,101000,124739.2,777100
264560,334640.6,1332350,158950,201841.6,555250,105610,132799,777100
278400,342762.6,1332350,168170,209137.8,555250,110230,133624.8,777100
288430,354179.9,1332350,174570,216519.7,555250,113860,137660.2,777100
298520,381952.9,1332350,180960,233195,555250,117560,148757.9,777100
308520,401986.6,1332350,187360,245430.8,555250,121160,156555.8,777100
318670,414712.6,1332350,193780,253882.5,555250,124890,160830.1,777100
327580,448137.7,1332350,199550,272227.4,555250,128030,175910.3,777100
336620,452123.2,1332350,205360,272129.7,555250,131260,179993.5,777100
345620,402004.3,1332350,211150,243670.8,555250,134470,158333.5,777100
354610,397018.4,1332350,216940,242092.3,555250,137670,154926.1,777100
362140,369974.7,1332350,222220,228817.3,555250,139920,141157.4,777100
369760,394289.5,1332350,227500,244064,555250,142260,150225.5,777100
377320,404016.3,1332350,232760,253214.9,555250,144560,150801.4,777100
384970,386834.5,1332350,238080,242466.6,555250,146890,144367.9,777100
387850,389984.4,1332350,238810,244814.1,555250,149040,145170.3,777100
390720,393720.1,1332350,239550,246624.4,555250,151170,147095.7,777100
393670,386379.3,1332350,240320,242252.3,555250,153350,144127,777100
396600,431062.7,1332350,241050,266696.6,555250,155550,164366.1,777100
400380,479965.5,1332350,241890,293265,555250,158490,186700.5,777100
404200,510235.3,1332350,242770,310145.9,555250,161430,200089.4,777100
408030,523161,1332350,243640,319383.3,555250,164390,203777.7,777100
411820,548563.7,1332350,244520,331625.4,555250,167300,216938.3,777100
415340,580506.2,1332350,245270,346293.5,555250,170070,234212.7,777100
418950,573148.3,1332350,246050,339049.9,555250,172900,234098.4,777100
422510,570403.5,1332350,246820,336314.6,555250,175690,234088.9,777100
426060,593187.7,1332350,247580,350280.3,555250,178480,242907.4,777100
420760,606859,1332350,244110,356824.7,555250,176650,250034.3,777100
415450,588717.4,1332350,240650,347478.4,555250,174800,241239,777100
410190,560191.1,1332350,237180,325744.5,555250,173010,234446.6,777100
391380,533276.5,1332350,227880,308502.2,555250,163500,224774.3,777100
386520,508066.8,1332350,225000,293735.2,555250,161520,214331.6,777100
381670,467596.7,1332350,222160,269739.9,555250,159510,197856.8,777100
376890,469462.5,1332350,219340,270557,555250,157550,198905.5,777100
372080,460957.9,1332350,216500,263106.9,555250,155580,197851,777100
367670,431113.3,1332350,213780,247960.8,555250,153890,183152.5,777100
363180,413939.7,1332350,211080,238617.9,555250,152100,175321.8,777100
358800,382776.1,1332350,208360,226313.8,555250,150440,156462.3,777100
354320,356655.2,1332350,205660,212197.5,555250,148660,144457.7,777100
351360,326457.8,1332350,204240,194789.7,555250,147120,131668.1,777100
348350,307068.1,1332350,202820,184978.8,555250,145530,122089.3,777100
345430,306864.7,1332350,201390,182981,555250,144040,123883.7,777100
342460,307560.7,1332350,199990,181509.1,555250,142470,126051.6,777100
339870,303756.3,1332350,198890,177599.9,555250,140980,126156.4,777100
337230,292464.6,1332350,197810,171233.1,555250,139420,121231.5,777100
334590,291258.5,1332350,196710,171357.8,555250,137880,119900.7,777100
332010,287347.6,1332350,195620,168245.7,555250,136390,119101.9,777100
330400,270657.6,1332350,195100,158669.2,555250,135300,111988.4,777100
328720,272712,1332350,194590,160578.1,555250,134130,112133.9,777100
327080,279262.3,1332350,194060,162040.7,555250,133020,117221.6,777100
325330,284190,1332350,193550,165588.3,555250,131780,118601.7,777100
321080,282166.2,1332350,192540,167860.7,555250,128540,114305.5,777100
316790,280282.5,1332350,191530,169156.9,555250,125260,111125.6,777100
312450,275416.3,1332350,190490,169410.1,555250,121960,106006.2,777100
308150,277550.1,1332350,189460,173850.6,555250,118690,103699.5,777100
305010,281948.6,1332350,188810,179812.8,555250,116200,102135.8,777100
301950,302626.6,1332350,188170,194616.5,555250,113780,108010.1,777100
298810,300885.7,1332350,187500,194984.3,555250,111310,105901.4,777100
295700,289000.9,1332350,186890,190841.7,555250,108810,98159.2,777100
290710,317263.1,1332350,185490,208227.8,555250,105220,109035.3,777100
285770,320081.3,1332350,184140,212142.6,555250,101630,107938.7,777100
280900,289866.4,1332350,182790,198252.4,555250,98110,91614,777100
275870,261048.3,1332350,181420,185156.7,555250,94450,75891.6,777100
268410,247400.6,1332350,178570,180099.7,555250,89840,67300.9,777100
260830,236434.2,1332350,175680,177287,555250,85150,59147.2,777100
253350,234844.1,1332350,172820,178611.7,555250,80530,56232.4,777100
245740,233169.3,1332350,169930,178069.3,555250,75810,55100,777100
242640,218317.2,1332350,167730,168984,555250,74910,49333.2,777100
239560,213538.8,1332350,165520,164454.4,555250,74040,49084.4,777100
236330,242526.4,1332350,163290,180391.9,555250,73040,62134.5,777100
233240,266674.2,1332350,161100,193155,555250,72140,73519.2,777100
231330,287890.3,1332350,159510,201198.2,555250,71820,86692.1,777100
229520,286458.4,1332350,158000,199342.8,555250,71520,87115.6,777100
227750,303893.9,1332350,156440,206456.2,555250,71310,97437.7,777100
225950,326170.3,1332350,154910,217038,555250,71040,109132.3,777100
232830,336770,1332350,158680,222046.6,555250,74150,114723.4,777100
239700,346042.6,1332350,162470,227128.1,555250,77230,118914.5,777100
246650,365099.1,1332350,166260,237268.9,555250,80390,127830.2,777100
253550,352891.7,1332350,170050,230094.5,555250,83500,122797.2,777100
261270,341899.2,1332350,174430,223717.6,555250,86840,118181.6,777100
269020,348985.2,1332350,178800,226582.1,555250,90220,122403.1,777100
276760,354333.4,1332350,183170,227386.3,555250,93590,126947.1,777100
284420,354025.6,1332350,187570,227605.6,555250,96850,126420,777100
291800,344918.9,1332350,191720,221674.2,555250,100080,123244.7,777100
299130,341558,1332350,195900,217979.4,555250,103230,123578.6,777100
306520,351326.3,1332350,200070,228152.2,555250,106450,123174.1,777100
313850,373182.9,1332350,204260,240110.4,555250,109590,133072.5,777100
325840,394126.8,1332350,211600,256114.3,555250,114240,138012.5,777100
337730,418030.2,1332350,218970,269826.2,555250,118760,148204,777100
349670,416598.2,1332350,226350,269938.3,555250,123320,146659.9,777100
361620,407171.2,1332350,233700,266917.4,555250,127920,140253.8,777100
375050,416039.1,1332350,241610,272542.8,555250,133440,143496.3,777100
388310,424680.7,1332350,249500,277109.6,555250,138810,147571.1,777100
401680,404184.8,1332350,257420,265908.2,555250,144260,138276.6,777100
415060,417427.9,1332350,265320,273239.6,555250,149740,144188.3,777100
427120,415393,1332350,272100,270390.7,555250,155020,145002.3,777100
439200,414209.9,1332350,278940,272521.7,555250,160260,141688.2,777100
451320,449871.6,1332350,285760,292235.5,555250,165560,157636.1,777100
463350,479239.9,1332350,292540,307350.2,555250,170810,171889.7,777100
468870,496428.1,1332350,295500,316073.7,555250,173370,180354.4,777100
474360,524354.1,1332350,298420,332357.3,555250,175940,191996.8,777100
479820,520595.1,1332350,301360,330420.1,555250,178460,190175,777100
485260,531989.1,1332350,304270,336232.2,555250,180990,195756.9,777100
488860,548082,1332350,306700,345803.6,555250,182160,202278.4,777100
492380,580066.9,1332350,309110,363327.4,555250,183270,216739.5,777100
495920,605609.4,1332350,311490,381052.5,555250,184430,224556.9,777100
499500,615136.9,1332350,313900,388253.3,555250,185600,226883.6,777100
501690,626548.2,1332350,316000,395055.6,555250,185690,231492.6,777100
503920,659337.2,1332350,318120,413595.4,555250,185800,245741.8,777100
506050,679634.3,1332350,320210,429432.3,555250,185840,250202,777100
508230,683131.8,1332350,322300,435259.4,555250,185930,247872.4,777100
508970,692689.1,1332350,320980,439092.9,555250,187990,253596.2,777100
509610,684306,1332350,319680,434363.3,555250,189930,249942.7,777100
510360,672921.9,1332350,318360,430287.2,555250,192000,242634.7,777100
511130,683594.5,1332350,317050,433908.7,555250,194080,249685.8,777100
511520,693415.8,1332350,315560,435682.2,555250,195960,257733.6,777100
511890,709217.2,1332350,314070,441956.6,555250,197820,267260.6,777100
512380,726870.7,1332350,312560,448889,555250,199820,277981.7,777100
512740,725844.5,1332350,311060,445896.6,555250,201680,279947.9,777100
511960,728323.5,1332350,308730,447279.7,555250,203230,281043.8,777100
511280,740266.8,1332350,306440,453026.8,555250,204840,287240,777100
510570,729778.2,1332350,304130,444369,555250,206440,285409.2,777100
509770,716622.9,1332350,301800,431887.5,555250,207970,284735.4,777100
501920,691874.3,1332350,296680,411624.8,555250,205240,280249.5,777100
494080,668195.8,1332350,291550,399265.3,555250,202530,268930.5,777100
486170,647345.2,1332350,286420,387463.6,555250,199750,259881.6,777100
489880,618289.7,1332350,297330,372799.6,555250,192550,245490.1,777100
482450,602027.4,1332350,292510,365505.4,555250,189940,236522,777100
474970,570964.1,1332350,287640,346813.3,555250,187330,224150.8,777100
467530,543478,1332350,282830,331893.1,555250,184700,211584.9,777100
460040,534190.4,1332350,277980,326531.9,555250,182060,207658.5,777100
453420,509028.9,1332350,273300,311364.9,555250,180120,197664,777100
446780,484895.5,1332350,268580,300098.9,555250,178200,184796.6,777100
440120,474602.4,1332350,263860,294489.5,555250,176260,180112.9,777100
433570,474407.9,1332350,259180,291670.6,555250,174390,182737.3,777100
426390,479652,1332350,253990,291411.7,555250,172400,188240.3,777100
419170,475608,1332350,248770,286641,555250,170400,188967,777100
411980,446878.6,1332350,243570,266343.4,555250,168410,180535.2,777100
404770,419998,1332350,238330,248976.5,555250,166440,171021.5,777100
397550,404584.2,1332350,232860,237223.3,555250,164690,167360.9,777100
390120,398979.7,1332350,227320,228690.4,555250,162800,170289.3,777100
382840,394250.3,1332350,221830,224256,555250,161010,169994.3,777100
375490,396420.5,1332350,216300,222895.4,555250,159190,173525.1,777100
367590,395614.1,1332350,210580,221887.2,555250,157010,173726.9,777100
359610,390002.7,1332350,204900,219790.2,555250,154710,170212.5,777100
351760,372988.7,1332350,199190,210830.6,555250,152570,162158.1,777100
343800,353709,1332350,193470,201004.3,555250,150330,152704.7,777100
334230,332576.7,1332350,189270,195657,555250,144960,136919.7,777100
324680,329749.1,1332350,185100,198082.1,555250,139580,131667,777100
315110,318669.5,1332350,180930,193571.9,555250,134180,125097.6,777100
305550,310719.6,1332350,176730,189201.1,555250,128820,121518.5,777100
295440,286253.2,1332350,172530,175889.3,555250,122910,110363.9,777100
285310,278936.9,1332350,168300,172566.7,555250,117010,106370.2,777100
275240,255470.2,1332350,164090,160926.9,555250,111150,94543.3,777100
265140,227376.9,1332350,159890,144514.3,555250,105250,82862.6,777100
255660,194188.1,1332350,156190,127044.5,555250,99470,67143.6,777100
246170,180990.9,1332350,152490,121221.9,555250,93680,59769,777100
236690,178609.2,1332350,148820,124216.6,555250,87870,54392.6,777100
227200,165605.2,1332350,145120,120616.9,555250,82080,44988.3,777100
220430,161621.8,1332350,142870,121868.1,555250,77560,39753.7,777100
213550,158254.5,1332350,140610,121217.3,555250,72940,37037.2,777100
206810,137248.7,1332350,138370,110650.1,555250,68440,26598.6,777100
199980,124442.2,1332350,136110,103725.2,555250,63870,20717,777100
196970,119806.1,1332350,134970,101732.3,555250,62000,18073.8,777100
194020,131952.2,1332350,133830,109313.4,555250,60190,22638.8,777100
190990,145127.8,1332350,132680,116624.6,555250,58310,28503.2,777100
187990,171419.6,1332350,131550,131817.9,555250,56440,39601.7,777100
186270,191005.2,1332350,130560,142122.2,555250,55710,48883,777100
184440,198656.6,1332350,129570,145743,555250,54870,52913.6,777100
182650,211659.2,1332350,128580,153265.1,555250,54070,58394.1,777100
180870,209377.3,1332350,127610,150774.5,555250,53260,58602.8,777100
185700,217595.7,1332350,129380,153886,555250,56320,63709.7,777100
190350,202304,1332350,131120,143241.5,555250,59230,59062.5,777100
195180,206025.7,1332350,132950,145858.7,555250,62230,60167,777100
200010,206374.2,1332350,134740,144906.9,555250,65270,61467.3,777100
204510,200911.7,1332350,136410,140414.6,555250,68100,60497.1,777100
209090,218344.4,1332350,138100,149590.9,555250,70990,68753.5,777100
213770,233230.8,1332350,139780,155515.5,555250,73990,77715.3,777100
218270,250024.8,1332350,141440,165717.8,555250,76830,84307,777100
222900,258759.9,1332350,143410,169508.7,555250,79490,89251.2,777100
227550,270657.5,1332350,145360,175531.7,555250,82190,95125.8,777100
232190,278290.6,1332350,147380,179817.3,555250,84810,98473.3,777100
236820,277492.2,1332350,149330,178386.8,555250,87490,99105.4,777100
241750,271294.3,1332350,152100,173000.9,555250,89650,98293.4,777100
246770,244163,1332350,154910,159233.5,555250,91860,84929.5,777100
251710,249680,1332350,157680,161425.3,555250,94030,88254.7,777100
256670,261986.4,1332350,160460,167684.5,555250,96210,94301.9,777100
262690,270727.3,1332350,164160,175029.7,555250,98530,95697.6,777100
268590,269307,1332350,167850,173547.7,555250,100740,95759.3,777100
274590,297054.4,1332350,171570,190389.5,555250,103020,106664.9,777100
280530,302440.9,1332350,175250,195638.7,555250,105280,106802.2,777100
285850,313697.3,1332350,178340,202461.4,555250,107510,111235.9,777100
291160,318669.9,1332350,181410,206842.3,555250,109750,111827.6,777100
296520,306523.1,1332350,184480,200793.7,555250,112040,105729.4,777100
301840,314405.3,1332350,187590,202718.1,555250,114250,111687.2,777100
307400,300210.5,1332350,191350,196747.1,555250,116050,103463.4,777100
313130,311251.3,1332350,195110,203865.7,555250,118020,107385.6,777100
318800,300819.4,1332350,198880,198097.9,555250,119920,102721.5,777100
324400,299595.3,1332350,202640,197323.5,555250,121760,102271.8,777100
330000,292293.5,1332350,206640,193892.8,555250,123360,98400.7,777100
335540,276885.9,1332350,210670,184707.8,555250,124870,92178.1,777100
341050,275951.6,1332350,214650,183894.7,555250,126400,92056.9,777100
346670,269033.9,1332350,218670,179096.2,555250,128000,89937.7,777100
352060,263573.4,1332350,223160,178595.4,555250,128900,84978,777100
357570,292379.4,1332350,227670,199268.9,555250,129900,93110.5,777100
363020,290337.7,1332350,232160,196212.8,555250,130860,94124.9,777100
368480,286543.1,1332350,236650,196315.6,555250,131830,90227.5,777100
369970,291831.8,1332350,236340,199617.9,555250,133630,92213.9,777100
371490,254835.6,1332350,236060,178047.6,555250,135430,76788,777100
372980,233915.9,1332350,235760,165640.1,555250,137220,68275.8,777100
374410,249655.6,1332350,235460,175994.5,555250,138950,73661.1,777100
376040,280871.1,1332350,234410,191263.2,555250,141630,89607.9,777100
377540,290914,1332350,233390,194019.2,555250,144150,96894.8,777100
379160,303128.8,1332350,232350,200069,555250,146810,103059.8,777100
380670,303196.3,1332350,231330,200462.9,555250,149340,102733.4,777100
382030,319429.1,1332350,230130,206864.7,555250,151900,112564.4,777100
383280,346109.9,1332350,228920,221749.6,555250,154360,124360.3,777100
384550,385168.9,1332350,227730,243214.2,555250,156820,141954.7,777100
385830,379292.9,1332350,226500,239818.1,555250,159330,139474.8,777100
382020,344515.1,1332350,223720,220361.2,555250,158300,124153.9,777100
378080,319949.9,1332350,220910,202831.6,555250,157170,117118.3,777100
374300,336130.1,1332350,218120,211340.7,555250,156180,124789.4,777100
337070,335927.7,1332350,188840,204404.7,555250,148230,131523,777100
334750,342630.2,1332350,188530,207783.2,555250,146220,134847,777100
332410,390522.1,1332350,188200,235748.6,555250,144210,154773.5,777100
330120,415750.6,1332350,187890,254833.7,555250,142230,160916.9,777100
327780,450440.6,1332350,187570,273742.8,555250,140210,176697.8,777100
326960,423498.5,1332350,188230,251932,555250,138730,171566.5,777100
326280,388744.9,1332350,188920,231603.6,555250,137360,157141.3,777100
325550,348179.5,1332350,189590,211063,555250,135960,137116.5,777100
324850,320484.5,1332350,190250,195265.3,555250,134600,125219.2,777100
321380,313868.8,1332350,187510,189660.6,555250,133870,124208.2,777100
317880,348507.8,1332350,184770,206125.4,555250,133110,142382.4,777100
314450,372251.3,1332350,182020,217150.8,555250,132430,155100.5,777100
310950,357351.6,1332350,179280,205792.2,555250,131670,151559.4,777100
306990,335055.9,1332350,176660,194332.2,555250,130330,140723.7,777100
302880,319706.1,1332350,174040,186269.1,555250,128840,133437,777100
298910,293048.5,1332350,171430,169780.9,555250,127480,123267.6,777100
294840,325148.7,1332350,168840,190683,555250,126000,134465.7,777100
289160,348190.2,1332350,164830,204299.8,555250,124330,143890.4,777100
283390,358637.7,1332350,160810,208908.8,555250,122580,149728.9,777100
277720,324554.4,1332350,156840,190243.7,555250,120880,134310.7,777100
272010,298797.2,1332350,152820,175789.9,555250,119190,123007.3,777100
263090,302975.4,1332350,147870,177032.6,555250,115220,125942.8,777100
254210,288395.9,1332350,142900,167480.2,555250,111310,120915.7,777100
245260,260653,1332350,137940,153094.3,555250,107320,107558.7,777100
236350,230334.8,1332350,132970,136364.6,555250,103380,93970.2,777100
228490,219843.4,1332350,129220,129386.8,555250,99270,90456.6,777100
220600,206521.7,1332350,125450,119787.1,555250,95150,86734.6,777100
212810,156507,1332350,121720,89368.2,555250,91090,67138.8,777100
205010,144234.4,1332350,117930,87681.6,555250,87080,56552.8,777100
196270,191003.4,1332350,114200,118412.2,555250,82070,72591.2,777100
187630,221201.5,1332350,110490,138857.1,555250,77140,82344.4,777100
178810,271040.4,1332350,106720,171513.7,555250,72090,99526.7,777100
170130,286032.5,1332350,102990,181539.8,555250,67140,104492.7,777100
172470,257552.5,1332350,105880,166077.3,555250,66590,91475.2,777100
174900,214455.2,1332350,108800,142573.6,555250,66100,71881.6,777100
177300,183550.2,1332350,111670,125336.3,555250,65630,58213.9,777100
179600,162730.2,1332350,114560,113752.9,555250,65040,48977.3,777100
184130,159943.3,1332350,117410,111756.7,555250,66720,48186.6,777100
188640,165234.1,1332350,120280,114327.7,555250,68360,50906.4,777100
193150,181188.2,1332350,123160,124053.9,555250,69990,57134.3,777100
197660,205575.1,1332350,125980,137697.1,555250,71680,67878,777100
202570,238967.4,1332350,128790,155655.3,555250,73780,83312.1,777100
207460,223675.3,1332350,131550,145022.2,555250,75910,78653.1,777100
212360,193865.7,1332350,134350,126290.9,555250,78010,67574.8,777100
217290,207925.7,1332350,137140,134924,555250,80150,73001.7,777100
225670,192773.3,1332350,140650,125809.9,555250,85020,66963.4,777100
234120,206884.7,1332350,144180,133120,555250,89940,73764.7,777100
242620,230776.6,1332350,147700,146232.4,555250,94920,84544.2,777100
251030,300215.1,1332350,151190,186728.2,555250,99840,113486.9,777100
259210,349315.8,1332350,154580,214590.9,555250,104630,134724.9,777100
267360,353942.9,1332350,157930,216604.4,555250,109430,137338.5,777100
275440,333484.6,1332350,161300,202897.2,555250,114140,130587.4,777100
283620,369645.8,1332350,164700,222499.7,555250,118920,147146.1,777100
291990,384461.2,1332350,168620,234705.5,555250,123370,149755.7,777100
300280,404410.4,1332350,172580,246250.8,555250,127700,158159.6,777100
308570,367938.9,1332350,176510,223002.5,555250,132060,144936.4,777100
316940,353325.7,1332350,180480,214933.2,555250,136460,138392.5,777100
328520,391059.2,1332350,185780,235826.9,555250,142740,155232.3,777100
339920,380522.6,1332350,191040,229275.2,555250,148880,151247.4,777100
351410,377662.5,1332350,196320,225912,555250,155090,151750.5,777100
362940,375418.2,1332350,201590,222038.8,555250,161350,153379.4,777100
376900,420846.1,1332350,208090,249492.7,555250,168810,171353.4,777100
390870,481041.5,1332350,214570,282326.1,555250,176300,198715.4,777100
404890,500409,1332350,221100,294620.2,555250,183790,205788.8,777100
418830,512142.2,1332350,227580,300078.7,555250,191250,212063.5,777100
431600,536416.7,1332350,233160,316231.8,555250,198440,220184.9,777100
444480,544648.1,1332350,238750,317920.2,555250,205730,226727.9,777100
457270,586741.1,1332350,244330,338345.1,555250,212940,248396,777100
470140,627895.2,1332350,249910,360383.9,555250,220230,267511.3,777100
478930,626136.3,1332350,255450,353961.9,555250,223480,272174.4,777100
487820,592287.1,1332350,261060,330197.8,555250,226760,262089.3,777100
496650,562340.6,1332350,266620,311070.1,555250,230030,251270.5,777100
505440,580331.2,1332350,272200,324394,555250,233240,255937.2,777100
511330,625310.7,1332350,276040,354700.7,555250,235290,270610,777100
517100,636301.5,1332350,279840,357039.1,555250,237260,279262.4,777100
522930,621616.7,1332350,283690,344179,555250,239240,277437.7,777100
528640,651991.1,1332350,287480,364603.1,555250,241160,287388,777100
532830,665898.6,1332350,290400,377162.4,555250,242430,288736.2,777100
536970,644778.7,1332350,293300,366335,555250,243670,278443.7,777100
541090,644860.2,1332350,296220,371439.3,555250,244870,273420.9,777100
545200,651021.4,1332350,299110,376807.3,555250,246090,274214.1,777100
538830,640088.2,1332350,295720,366210.6,555250,243110,273877.6,777100
532440,680848.6,1332350,292340,388532.2,555250,240100,292316.4,777100
526040,738180.3,1332350,288950,423226.1,555250,237090,314954.2,777100
519650,751279.9,1332350,285530,429864.9,555250,234120,321415,777100
515030,740228.9,1332350,282970,421917.2,555250,232060,318311.7,777100
510390,704748,1332350,280400,401082.2,555250,229990,303665.8,777100
505890,663878,1332350,277850,380838.8,555250,228040,283039.2,777100
501220,702360.3,1332350,275270,403720,555250,225950,298640.3,777100
498850,714372,1332350,274750,405077,555250,224100,309295,777100
496450,697023.4,1332350,274220,390097.4,555250,222230,306926,777100
494130,693483,1332350,273710,392519.5,555250,220420,300963.5,777100
491750,660837.9,1332350,273200,382344.5,555250,218550,278493.4,777100
480510,688162.8,1332350,266340,394135.1,555250,214170,294027.7,777100
469270,670529.7,1332350,259460,383116.5,555250,209810,287413.2,777100
458080,655869.5,1332350,252630,373119,555250,205450,282750.5,777100
454700,639652.3,1332350,249290,363477.2,555250,205410,276175.1,777100
442080,601204.3,1332350,242840,349132.5,555250,199240,252071.8,777100
429480,604704,1332350,236390,348637,555250,193090,256067,777100
416840,567954,1332350,229950,327864.1,555250,186890,240089.9,777100
404260,548938,1332350,223500,318194.8,555250,180760,230743.2,777100
391830,544968.3,1332350,217250,313023.9,555250,174580,231944.4,777100
379390,485609.1,1332350,211010,278894.3,555250,168380,206714.8,777100
366900,496593.1,1332350,204720,281738.4,555250,162180,214854.7,777100
354470,445935.9,1332350,198450,258487.8,555250,156020,187448.1,777100
346910,382778.3,1332350,194360,216839.1,555250,152550,165939.2,777100
339200,386885.2,1332350,190250,212945.9,555250,148950,173939.3,777100
331530,354039.1,1332350,186110,200240.1,555250,145420,153799,777100
323880,382136.7,1332350,182010,222149.3,555250,141870,159987.4,777100
316270,366138.6,1332350,178180,212738.2,555250,138090,153400.4,777100
308670,306534,1332350,174360,179503.7,555250,134310,127030.3,777100
301010,343480.2,1332350,170550,197018.7,555250,130460,146461.5,777100
293360,302519,1332350,166710,173943.9,555250,126650,128575.1,777100
285860,290723.6,1332350,162690,163864.7,555250,123170,126858.9,777100
278350,288216.5,1332350,158670,161302.2,555250,119680,126914.3,777100
270740,292890.8,1332350,154610,165117,555250,116130,127773.8,777100
263260,324389.1,1332350,150600,182090.5,555250,112660,142298.6,777100
260810,326030.9,1332350,148690,185040.8,555250,112120,140990.1,777100
258410,329322.6,1332350,146770,182872.6,555250,111640,146450,777100
256020,319743.8,1332350,144840,179261.6,555250,111180,140482.2,777100
253550,321965.9,1332350,142940,183354.2,555250,110610,138611.7,777100
252100,299344.6,1332350,141490,171879.5,555250,110610,127465.1,777100
250600,288244.4,1332350,139990,166508.8,555250,110610,121735.6,777100
249140,287280,1332350,138560,163904.9,555250,110580,123375.1,777100
247600,289822.9,1332350,137060,164870.1,555250,110540,124952.8,777100
244610,299176.7,1332350,134760,166239.2,555250,109850,132937.5,777100
241620,323681.3,1332350,132460,181481.5,555250,109160,142199.8,777100
238600,351643.1,1332350,130150,194353.1,555250,108450,157290,777100
235570,372294,1332350,127830,204874,555250,107740,167420,777100
229820,364795.8,1332350,125180,201388.6,555250,104640,163407.2,777100
224060,343535.6,1332350,122550,185004.4,555250,101510,158531.2,777100
218260,332147.1,1332350,119900,181236.2,555250,98360,150910.9,777100
212570,290948.8,1332350,117270,156994.4,555250,95300,133954.4,777100
206890,278287.1,1332350,114800,154918,555250,92090,123369.1,777100
201250,287963,1332350,112360,159299.5,555250,88890,128663.5,777100
195530,272807.2,1332350,109880,150936.7,555250,85650,121870.5,777100
189920,274948.6,1332350,107410,155634.9,555250,82510,119313.7,777100
184590,231067.5,1332350,105260,131253.5,555250,79330,99814,777100
179290,169640.9,1332350,103110,97614.8,555250,76180,72026.1,777100
174040,190861.2,1332350,100970,111749.4,555250,73070,79111.8,777100
168680,193392.4,1332350,98810,115607.4,555250,69870,77785,777100
167060,198719.9,1332350,97430,116981.4,555250,69630,81738.5,777100
165440,194442.3,1332350,96050,115216.9,555250,69390,79225.4,777100
163750,188662.4,1332350,94660,111925.5,555250,69090,76736.9,777100
162230,192819.3,1332350,93300,112853.1,555250,68930,79966.2,777100
161210,191727.3,1332350,92240,112373.9,555250,68970,79353.4,777100
160160,204905.2,1332350,91210,119651.7,555250,68950,85253.5,777100
159210,227616.7,1332350,90140,131719.3,555250,69070,95897.4,777100
158200,229844.6,1332350,89100,134522.2,555250,69100,95322.4,777100
156920,235817.6,1332350,87760,135907.8,555250,69160,99909.8,777100
155640,236773.9,1332350,86440,133094.9,555250,69200,103679,777100
154340,223209.6,1332350,85120,128055.8,555250,69220,95153.8,777100
152990,211365.5,1332350,83800,118708,555250,69190,92657.5,777100
158920,213628.4,1332350,87290,121883.4,555250,71630,91745,777100
164760,211717.7,1332350,90780,120951,555250,73980,90766.7,777100
170610,209786.4,1332350,94280,121112.7,555250,76330,88673.7,777100
176500,207413,1332350,97800,120714.4,555250,78700,86698.6,777100
182780,195144.6,1332350,101530,115843.7,555250,81250,79300.9,777100
189060,192945.7,1332350,105240,116224.9,555250,83820,76720.8,777100
195350,194441.4,1332350,109010,118743.7,555250,86340,75697.7,777100
201630,200922.5,1332350,112760,121769.2,555250,88870,79153.3,777100
208600,229373.1,1332350,116940,138553.8,555250,91660,90819.3,777100
215550,210754,1332350,121120,128962.2,555250,94430,81791.8,777100
222500,200813.1,1332350,125290,122995.2,555250,97210,77817.9,777100
229420,230585.1,1332350,129480,140967.6,555250,99940,89617.5,777100
235630,206811.8,1332350,132590,126044.4,555250,103040,80767.4,777100
241900,188080.7,1332350,135740,114457.4,555250,106160,73623.3,777100
248050,166238.2,1332350,138850,104289.2,555250,109200,61949,777100
254220,193278,1332350,141960,119015,555250,112260,74263,777100
260210,194201.4,1332350,145170,120563.5,555250,115040,73637.9,777100
266220,184917.2,1332350,148360,114173.9,555250,117860,70743.3,777100
272210,184698.3,1332350,151570,113549.3,555250,120640,71149,777100
278190,184331.9,1332350,154770,112902.9,555250,123420,71429,777100
282980,193271.2,1332350,157830,118883.9,555250,125150,74387.3,777100
287790,211563.6,1332350,160880,132412,555250,126910,79151.6,777100
292520,197921.9,1332350,163940,123947.7,555250,128580,73974.2,777100
297400,184937.3,1332350,167010,116254.5,555250,130390,68682.8,777100
293120,215438.3,1332350,164480,132345.3,555250,128640,83093,777100
288770,231809.3,1332350,161880,142536.1,555250,126890,89273.2,777100
284520,247528.1,1332350,159310,150984.9,555250,125210,96543.2,777100
280180,253088.1,1332350,156750,153984.3,555250,123430,99103.8,777100
276150,237988.2,1332350,153930,141989.8,555250,122220,95998.4,777100
272060,250107.3,1332350,151100,146900.7,555250,120960,103206.6,777100
267980,241602.6,1332350,148290,141316.9,555250,119690,100285.7,777100
263920,241129.8,1332350,145470,139884.1,555250,118450,101245.7,777100
259520,266371.3,1332350,141660,150662.8,555250,117860,115708.5,777100
255080,270337.8,1332350,137850,152731.8,555250,117230,117606,777100
250650,259882.9,1332350,134050,145461.8,555250,116600,114421.1,777100
246290,257776.8,1332350,130230,144853.6,555250,116060,112923.2,777100
236050,242879.8,1332350,123650,136077.1,555250,112400,106802.7,777100
225810,236774.7,1332350,117050,129327.5,555250,108760,107447.2,777100
215650,238476.5,1332350,110490,130668.9,555250,105160,107807.6,777100
194760,256841.9,1332350,94890,137667.2,555250,99870,119174.7,777100
185610,272488.6,1332350,88630,142788.8,555250,96980,129699.8,777100
176470,262471,1332350,82400,135188.1,555250,94070,127282.9,777100
167270,264707.8,1332350,76120,133531.9,555250,91150,131175.9,777100
158130,251471.4,1332350,69890,124619.1,555250,88240,126852.3,777100
150380,256305.2,1332350,64950,121712.1,555250,85430,134593.1,777100
142570,253151.9,1332350,60020,118806.6,555250,82550,134345.3,777100
134750,266417.6,1332350,55060,122764.7,555250,79690,143652.9,777100
126920,261768.9,1332350,50150,118951.7,555250,76770,142817.2,777100
124170,232918.4,1332350,48520,100609.4,555250,75650,132309,777100
121300,205344.3,1332350,46910,84598.3,555250,74390,120746,777100
118470,208107.3,1332350,45260,88034.4,555250,73210,120072.9,777100
115620,201032.5,1332350,43660,83630.5,555250,71960,117402,777100
113560,182570.2,1332350,42340,71090.2,555250,71220,111480,777100
111360,166605.2,1332350,41000,60301.6,555250,70360,106303.6,777100
109290,165819.4,1332350,39700,58833.2,555250,69590,106986.2,777100
107120,175804.2,1332350,38390,63716.8,555250,68730,112087.4,777100
105330,178971.1,1332350,37560,63602.7,555250,67770,115368.4,777100
103500,168292.5,1332350,36690,59043.7,555250,66810,109248.8,777100
101670,152197.9,1332350,35830,54776.4,555250,65840,97421.5,777100
99810,135862.4,1332350,34970,47371,555250,64840,88491.4,777100
95990,131131.7,1332350,34470,44257.2,555250,61520,86874.5,777100
92260,125245.9,1332350,33970,42743.3,555250,58290,82502.6,777100
88440,113583.1,1332350,33480,39949.4,555250,54960,73633.7,777100
84740,104795,1332350,33000,37070.9,555250,51740,67724.1,777100
80920,112728.5,1332350,32570,44089.9,555250,48350,68638.6,777100
77180,107850.5,1332350,32110,44613.8,555250,45070,63236.7,777100
73400,88037.2,1332350,31690,36345,555250,41710,51692.2,777100
69670,74018.6,1332350,31260,30367,555250,38410,43651.6,777100
66310,67426.8,1332350,31030,28486.5,555250,35280,38940.3,777100
62950,64386.3,1332350,30790,27741.8,555250,32160,36644.5,777100
59660,50045.8,1332350,30590,21728.3,555250,29070,28317.5,777100
56320,41460.5,1332350,30360,20218.6,555250,25960,21241.9,777100
56160,25365.9,1332350,31400,13371.9,555250,24760,11994,777100
56080,22638,1332350,32440,13648.7,555250,23640,8989.3,777100
55900,28710.5,1332350,33490,19371.7,555250,22410,9338.8,777100
55770,34143.3,1332350,34510,22877.5,555250,21260,11265.8,777100
56050,29802.7,1332350,35510,20133.3,555250,20540,9669.4,777100
56220,24317.7,1332350,36460,15795.5,555250,19760,8522.2,777100
56480,15813.1,1332350,37410,9041.3,555250,19070,6771.8,777100
56820,14415,1332350,38400,8571.8,555250,18420,5843.2,777100
57080,21959.7,1332350,39320,14713.6,555250,17760,7246.1,777100
57420,29864.2,1332350,40300,20972.7,555250,17120,8891.5,777100
57670,29586.6,1332350,41220,21407.5,555250,16450,8179.1,777100
57910,34701.7,1332350,42160,24974.7,555250,15750,9727,777100
58310,43427.3,1332350,41440,30189,555250,16870,13238.3,777100
58710,40657.7,1332350,40720,27580.2,555250,17990,13077.5,777100
59090,41858.2,1332350,40040,28297.1,555250,19050,13561.1,777100
59440,40230.2,1332350,39330,26721.1,555250,20110,13509.1,777100
60110,33831,1332350,38870,21831.1,555250,21240,11999.9,777100
60690,30547.8,1332350,38450,18689.8,555250,22240,11858,777100
61300,33266.7,1332350,38020,19452.5,555250,23280,13814.2,777100
61940,51195.5,1332350,37590,30674.8,555250,24350,20520.7,777100
62620,70526.1,1332350,37320,42103.2,555250,25300,28422.9,777100
63290,73298.5,1332350,37060,43819.9,555250,26230,29478.6,777100
63930,76381.1,1332350,36800,45057,555250,27130,31324.1,777100
64610,74073.5,1332350,36540,42692.5,555250,28070,31381,777100
68810,76912.7,1332350,38230,43633,555250,30580,33279.7,777100
73090,77751.9,1332350,39930,43157,555250,33160,34594.9,777100
77370,75602.7,1332350,41640,42127,555250,35730,33475.7,777100
81600,72282.4,1332350,43360,40147.8,555250,38240,32134.6,777100
86470,69250.1,1332350,45350,37326.4,555250,41120,31923.7,777100
91300,63694.1,1332350,47350,33720.9,555250,43950,29973.2,777100
96120,64089.3,1332350,49350,33203.6,555250,46770,30885.7,777100
100920,64954.7,1332350,51360,34044,555250,49560,30910.7,777100
105460,65876.8,1332350,52790,33389.7,555250,52670,32487.1,777100
109890,73107.9,1332350,54220,36982.3,555250,55670,36125.6,777100
114480,77838.2,1332350,55650,38125.1,555250,58830,39713.1,777100
119060,70553.6,1332350,57110,32854,555250,61950,37699.6,777100
121450,71546,1332350,57560,31976.3,555250,63890,39569.7,777100
123990,60279.9,1332350,58050,25636.5,555250,65940,34643.4,777100
126410,58819.5,1332350,58510,22932,555250,67900,35887.5,777100
128880,68383.7,1332350,58970,27554.9,555250,69910,40828.8,777100
131250,64829.1,1332350,59510,24530.6,555250,71740,40298.5,777100
133730,65820.6,1332350,60060,23717.7,555250,73670,42102.9,777100
136110,70786.5,1332350,60620,24897.5,555250,75490,45889,777100
138480,73185.5,1332350,61140,26536.1,555250,77340,46649.4,777100
139810,68401.9,1332350,61210,23280.7,555250,78600,45121.2,777100
141160,75922.1,1332350,61280,27197,555250,79880,48725.1,777100
142470,72777.5,1332350,61340,25099.4,555250,81130,47678.1,777100
143780,73515.3,1332350,61450,24757.7,555250,82330,48757.6,777100
142170,78354.9,1332350,60440,27068.9,555250,81730,51286,777100
140640,78086,1332350,59470,27199.9,555250,81170,50886.1,777100
139020,86308.9,1332350,58470,32790.2,555250,80550,53518.7,777100
137360,88190.5,1332350,57470,34199.8,555250,79890,53990.7,777100
135090,85488.9,1332350,55580,29992.7,555250,79510,55496.2,777100
132750,91643.1,1332350,53650,29367.1,555250,79100,62276,777100
130410,88102.3,1332350,51780,25752.7,555250,78630,62349.6,777100
127980,85351.3,1332350,49850,25501.1,555250,78130,59850.2,777100
125840,91022.4,1332350,47870,25245.2,555250,77970,65777.2,777100
123730,87785.5,1332350,45910,22291.4,555250,77820,65494.1,777100
121520,86094.1,1332350,43930,23029.7,555250,77590,63064.4,777100
119430,77732.9,1332350,41990,18489.9,555250,77440,59243,777100
113680,78792.9,1332350,39410,20646.5,555250,74270,58146.4,777100
107960,74961.8,1332350,36840,20360.9,555250,71120,54600.9,777100
102170,67919.8,1332350,34260,16749,555250,67910,51170.8,777100
90360,67027.8,1332350,25650,14904.4,555250,64710,52123.4,777100
85730,70906,1332350,24020,15691.8,555250,61710,55214.2,777100
81120,67773.9,1332350,22400,14138.4,555250,58720,53635.5,777100
76520,60542.2,1332350,20790,10843.8,555250,55730,49698.4,777100
71940,57883.6,1332350,19180,9377,555250,52760,48506.6,777100
67420,59437.9,1332350,17570,8327.4,555250,49850,51110.5,777100
62970,60259.3,1332350,15960,7761.9,555250,47010,52497.4,777100
58430,56778.8,1332350,14360,7135.8,555250,44070,49643,777100
53910,54053.9,1332350,12730,8258.3,555250,41180,45795.6,777100
53160,57942,1332350,12510,9550,555250,40650,48392,777100
52470,62480.6,1332350,12330,13479.1,555250,40140,49001.5,777100
51790,63883.9,1332350,12100,13702.7,555250,39690,50181.2,777100
51000,61062.7,1332350,11880,11390.8,555250,39120,49671.9,777100
50210,56002.4,1332350,11630,10114.3,555250,38580,45888.1,777100
49430,56348.2,1332350,11400,11041.4,555250,38030,45306.8,777100
48600,61123.9,1332350,11170,12456.4,555250,37430,48667.5,777100
47810,62396,1332350,10950,12727.6,555250,36860,49668.4,777100
47220,61489.1,1332350,10800,11584.8,555250,36420,49904.3,777100
46670,63950.3,1332350,10640,14890.7,555250,36030,49059.6,777100
46010,51164.2,1332350,10490,12115.6,555250,35520,39048.6,777100
45410,43845.5,1332350,10340,8140.3,555250,35070,35705.2,777100
43900,38393,1332350,9980,4667.2,555250,33920,33725.8,777100
42320,33097.9,1332350,9580,3392.5,555250,32740,29705.4,777100
40840,32651.3,1332350,9230,3823.7,555250,31610,28827.6,777100
39200,32034.1,1332350,8870,3814,555250,30330,28220.1,777100
37780,31080.3,1332350,8560,2732.4,555250,29220,28347.9,777100
36320,28135.3,1332350,8240,2104.3,555250,28080,26031,777100
34750,27349.3,1332350,7930,1991.4,555250,26820,25357.9,777100
33270,27058.9,1332350,7610,1832.9,555250,25660,25226,777100
31450,24398.6,1332350,7220,1679.3,555250,24230,22719.3,777100
29610,22269.2,1332350,6820,1500.2,555250,22790,20769,777100
27680,18541.9,1332350,6420,1048.2,555250,21260,17493.7,777100
25850,18889.1,1332350,6020,2122.6,555250,19830,16766.5,777100
24710,19376.3,1332350,5600,3954.8,555250,19110,15421.5,777100
23540,13719.7,1332350,5220,1376.3,555250,18320,12343.4,777100
22330,12004.6,1332350,4790,556.6,555250,17540,11448,777100
21180,11370.3,1332350,4400,498.5,555250,16780,10871.8,777100
21170,11249.5,1332350,4220,536,555250,16950,10713.5,777100
21260,12179.1,1332350,4050,534,555250,17210,11645.1,777100
21270,15132,1332350,3880,657.5,555250,17390,14474.5,777100
21280,18983.3,1332350,3690,857.5,555250,17590,18125.8,777100
21460,19102.3,1332350,3580,909.7,555250,17880,18192.6,777100
21650,20282.5,1332350,3470,1679.3,555250,18180,18603.2,777100
21760,22791.4,1332350,3340,2235,555250,18420,20556.4,777100
21980,27143.6,1332350,3220,2302.9,555250,18760,24840.7,777100
22200,25287.5,1332350,3280,2233.9,555250,18920,23053.6,777100
22440,24147.6,1332350,3330,1622.6,555250,19110,22525,777100
22720,24250.3,1332350,3370,1748.3,555250,19350,22502,777100
23010,22523.1,1332350,3440,1451.9,555250,19570,21071.2,777100
23080,23557,1332350,3460,2309.7,555250,19620,21247.3,777100
23210,23922,1332350,3510,2755.7,555250,19700,21166.3,777100
23320,22939.9,1332350,3520,2184.1,555250,19800,20755.8,777100
23440,22536.2,1332350,3550,1949.6,555250,19890,20586.6,777100
23840,22460.4,1332350,3640,2105.9,555250,20200,20354.5,777100
24350,22486.7,1332350,3760,1954.5,555250,20590,20532.2,777100
24790,22267.2,1332350,3830,2057,555250,20960,20210.2,777100
25250,24404.7,1332350,3910,2462.6,555250,21340,21942.1,777100
27550,24298,1332350,4260,2204,555250,23290,22094,777100
29860,24513.5,1332350,4600,2338.1,555250,25260,22175.4,777100
32100,24527.6,1332350,4950,2347.5,555250,27150,22180.1,777100
34490,26466.8,1332350,5320,2456.4,555250,29170,24010.4,777100
36570,24124.9,1332350,5620,2141.1,555250,30950,21983.8,777100
38670,26974.3,1332350,5950,2760.5,555250,32720,24213.8,777100
40810,27138.6,1332350,6270,2580.7,555250,34540,24557.9,777100
42940,28499.7,1332350,6580,3179,555250,36360,25320.7,777100
44890,31680.9,1332350,6970,3736.4,555250,37920,27944.5,777100
46800,31626.2,1332350,7270,3385.3,555250,39530,28240.9,777100
48700,31039.2,1332350,7610,3108.4,555250,41090,27930.8,777100
50590,31426.7,1332350,7940,3538,555250,42650,27888.7,777100
50880,35728.9,1332350,7940,6099.4,555250,42940,29629.5,777100
51110,37708.8,1332350,7920,5843.7,555250,43190,31865.1,777100
51320,35500.3,1332350,7940,4734.4,555250,43380,30765.9,777100
51600,36807.9,1332350,7930,4869.9,555250,43670,31938,777100
51520,40763.1,1332350,7920,5862.7,555250,43600,34900.4,777100
51480,40401.1,1332350,7900,6314.3,555250,43580,34086.8,777100
51360,42844.3,1332350,7860,5685,555250,43500,37159.3,777100
51330,47055.8,1332350,7850,5990,555250,43480,41065.8,777100
51460,43497.8,1332350,7930,4038.7,555250,43530,39459.1,777100
51600,45147.4,1332350,7990,4436.6,555250,43610,40710.8,777100
51660,46311.9,1332350,8040,5285.3,555250,43620,41026.6,777100
51790,43651.4,1332350,8100,5178.9,555250,43690,38472.5,777100
52280,41105.9,1332350,8330,4279.7,555250,43950,36826.2,777100
52760,41100.9,1332350,8590,3980.7,555250,44170,37120.2,777100
53310,40681.1,1332350,8840,5229.6,555250,44470,35451.5,777100
53830,40315.8,1332350,9090,4739.6,555250,44740,35576.2,777100
54460,40773.1,1332350,9290,4801.3,555250,45170,35971.8,777100
55110,43090.2,1332350,9500,5709.7,555250,45610,37380.5,777100
55640,50364,1332350,9680,8170.9,555250,45960,42193.1,777100
56200,52974.5,1332350,9890,8667.8,555250,46310,44306.7,777100
56640,58813.4,1332350,10070,9847.7,555250,46570,48965.7,777100
57020,60487.5,1332350,10260,9863.5,555250,46760,50624,777100
57430,61002.1,1332350,10420,9382.4,555250,47010,51619.7,777100
57810,64121.3,1332350,10580,11675.4,555250,47230,52445.9,777100
55400,66969.6,1332350,10280,15209.1,555250,45120,51760.5,777100
53180,69198,1332350,10000,17141.9,555250,43180,52056.1,777100
50800,70804,1332350,9650,17289.6,555250,41150,53514.4,777100
60130,74475.2,1332350,10870,15820.3,555250,49260,58654.9,777100
57090,73750.2,1332350,10330,13729.3,555250,46760,60020.9,777100
53980,69478.6,1332350,9770,11591.6,555250,44210,57887,777100
50810,63889.8,1332350,9210,9389,555250,41600,54500.8,777100
47670,60066,1332350,8640,8984.5,555250,39030,51081.5,777100
44910,51453,1332350,8170,5766.4,555250,36740,45686.6,777100
42090,54197.6,1332350,7730,8467.2,555250,34360,45730.4,777100
39270,46499,1332350,7270,5767.8,555250,32000,40731.2,777100
36410,46685.9,1332350,6810,6542,555250,29600,40143.9,777100
34510,50072.9,1332350,6450,7343.2,555250,28060,42729.7,777100
32560,45416.2,1332350,6040,6218,555250,26520,39198.2,777100
30600,43222.2,1332350,5650,5941.8,555250,24950,37280.4,777100
28740,39774.9,1332350,5280,5338.1,555250,23460,34436.8,777100
27010,39142,1332350,5040,4485,555250,21970,34657,777100
25330,36503.8,1332350,4780,4369.4,555250,20550,32134.4,777100
23620,32623.1,1332350,4550,4074.8,555250,19070,28548.3,777100
21890,29037.3,1332350,4300,3699.6,555250,17590,25337.7,777100
20210,26456.2,1332350,3930,3538,555250,16280,22918.2,777100
18410,26931.9,1332350,3540,4146.4,555250,14870,22785.5,777100
16600,22370.3,1332350,3160,3277.1,555250,13440,19093.2,777100
14830,17029.1,1332350,2760,2270.5,555250,12070,14758.6,777100
13910,14026,1332350,2570,1676.8,555250,11340,12349.2,777100
12920,12709,1332350,2420,1184.4,555250,10500,11524.6,777100
11930,11025,1332350,2210,1091,555250,9720,9934,777100
11000,9932.7,1332350,2030,1091,555250,8970,8841.7,777100
10150,8602.3,1332350,1880,885.1,555250,8270,7717.2,777100
9220,6374.7,1332350,1730,363.8,555250,7490,6010.9,777100
8360,5619.6,1332350,1600,236,555250,6760,5383.6,777100
7510,4969.3,1332350,1490,236,555250,6020,4733.3,777100
6810,4644.7,1332350,1490,236,555250,5320,4408.7,777100
6160,4902.9,1332350,1520,236,555250,4640,4666.9,777100
5400,4088.9,1332350,1500,136,555250,3900,3952.9,777100
4750,3906.5,1332350,1540,136,555250,3210,3770.5,777100
4680,2586.1,1332350,1550,136,555250,3130,2450.1,777100
4670,1770.3,1332350,1560,136,555250,3110,1634.3,777100
4640,1762,1332350,1570,136,555250,3070,1626,777100
4590,1593,1332350,1580,136,555250,3010,1457,777100
4500,1849.7,1332350,1500,194.8,555250,3000,1654.9,777100
4420,1992.1,1332350,1440,145.6,555250,2980,1846.5,777100
4360,3479.6,1332350,1370,136,555250,2990,3343.6,777100
4300,3760.8,1332350,1310,136,555250,2990,3624.8,777100
4300,4411.6,1332350,1280,136,555250,3020,4275.6,777100
4360,3800.9,1332350,1290,172.5,555250,3070,3628.4,777100
4430,3015.5,1332350,1270,172.5,555250,3160,2843,777100
4530,3340.1,1332350,1270,136,555250,3260,3204.1,777100
4580,5643.3,1332350,1170,325.9,555250,3410,5317.4,777100
4630,7049.8,1332350,1080,332,555250,3550,6717.8,777100
4740,8870.1,1332350,1000,381.6,555250,3740,8488.5,777100
4790,9590.4,1332350,920,536.3,555250,3870,9054.1,777100
5310,10881.6,1332350,1130,767.1,555250,4180,10114.5,777100
5830,9105.1,1332350,1330,899.9,555250,4500,8205.2,777100
6330,7074.2,1332350,1530,585,555250,4800,6489.2,777100
6860,8081.6,1332350,1740,577.4,555250,5120,7504.2,777100
7840,7536.7,1332350,2410,557,555250,5430,6979.7,777100
8780,5613.8,1332350,3050,403.2,555250,5730,5210.6,777100
9770,5950.5,1332350,3700,372.1,555250,6070,5578.4,777100
10770,4995.9,1332350,4340,480.2,555250,6430,4515.7,777100
11410,5471.2,1332350,4100,897.1,555250,7310,4574.1,777100
12190,6869.6,1332350,3890,797.1,555250,8300,6072.5,777100
12840,9153.4,1332350,3660,628.4,555250,9180,8525,777100
13550,10118.7,1332350,3410,866.6,555250,10140,9252.1,777100
14850,14541.3,1332350,3660,1124.1,555250,11190,13417.2,777100
16190,15266.5,1332350,3950,1325.7,555250,12240,13940.8,777100
17440,15146.5,1332350,4230,1171.1,555250,13210,13975.4,777100
18700,13036,1332350,4490,992.4,555250,14210,12043.6,777100
19670,13081.8,1332350,4840,764.5,555250,14830,12317.3,777100
20620,15233.6,1332350,5180,1211.5,555250,15440,14022.1,777100
21530,19721.9,1332350,5530,1519.9,555250,16000,18202,777100
22500,19360.4,1332350,5880,1487.8,555250,16620,17872.6,777100
23960,19318.1,1332350,6260,1277,555250,17700,18041.1,777100
25430,19113.8,1332350,6670,1295.5,555250,18760,17818.3,777100
26970,18826.2,1332350,7080,1269.8,555250,19890,17556.4,777100
28480,15906.6,1332350,7500,865.8,555250,20980,15040.8,777100
29400,16874.8,1332350,7450,1033.5,555250,21950,15841.3,777100
30270,19550.2,1332350,7350,1144.5,555250,22920,18405.7,777100
31130,20397.8,1332350,7290,1129.2,555250,23840,19268.6,777100
32100,21829.6,1332350,7250,1303.8,555250,24850,20525.8,777100
34440,23947.1,1332350,8760,1676.7,555250,25680,22270.4,777100
36790,24653.8,1332350,10320,1939.3,555250,26470,22714.5,777100
39130,21639,1332350,11850,1719.9,555250,27280,19919.1,777100
41440,18150,1332350,13370,1314,555250,28070,16836,777100
40120,17816.5,1332350,12400,1283.9,555250,27720,16532.6,777100
38730,17013.1,1332350,11430,1369.5,555250,27300,15643.6,777100
37410,18210.3,1332350,10500,1575.9,555250,26910,16634.4,777100
36060,18972.4,1332350,9520,1523.5,555250,26540,17448.9,777100
36010,18844.6,1332350,9810,1636,555250,26200,17208.6,777100
36010,18313.3,1332350,10120,1636,555250,25890,16677.3,777100
35940,17665.8,1332350,10370,1536,555250,25570,16129.8,777100
35830,17724,1332350,10650,1611,555250,25180,16113,777100
35460,17194.2,1332350,10640,1436,555250,24820,15758.2,777100
35130,15618.9,1332350,10640,1311,555250,24490,14307.9,777100
34810,14642,1332350,10640,1261,555250,24170,13381,777100
34470,13568.8,1332350,10640,1148.5,555250,23830,12420.3,777100
32680,11811.5,1332350,10340,1048.5,555250,22340,10763,777100
30830,11696.2,1332350,9990,1211,555250,20840,10485.2,777100
29040,10860.9,1332350,9640,1198.5,555250,19400,9662.4,777100
9950,6361.2,1332350,1680,696.5,555250,8270,5664.7,777100
8960,5029,1332350,1500,620,555250,7460,4409,777100
7950,4904.1,1332350,1340,620,555250,6610,4284.1,777100
6920,4169.4,1332350,1210,743.3,555250,5710,3426.1,777100
5920,3901,1332350,1060,658.9,555250,4860,3242.1,777100
4980,3879.6,1332350,920,636,555250,4060,3243.6,777100
4090,3859.4,1332350,780,636,555250,3310,3223.4,777100
3180,3572.8,1332350,660,636,555250,2520,2936.8,777100
2290,2946.5,1332350,520,461,555250,1770,2485.5,777100
2370,2701.5,1332350,560,536,555250,1810,2165.5,777100
2420,2791.3,1332350,600,536,555250,1820,2255.3,777100
2530,2845.9,1332350,630,536,555250,1900,2309.9,777100
2610,3249,1332350,670,613.5,555250,1940,2635.5,777100
2710,2887.2,1332350,740,620,555250,1970,2267.2,777100
2860,3058.3,1332350,840,620,555250,2020,2438.3,777100
2930,3067.5,1332350,910,620,555250,2020,2447.5,777100
3010,3105.2,1332350,980,622,555250,2030,2483.2,777100
3180,3632.9,1332350,1040,581.5,555250,2140,3051.4,777100
3330,4881,1332350,1110,900,555250,2220,3981,777100
3440,4801.3,1332350,1160,809.1,555250,2280,3992.2,777100
3600,5240.8,1332350,1220,873,555250,2380,4367.8,777100
4540,6638.2,1332350,1950,873,555250,2590,5765.2,777100
5470,6888.1,1332350,2700,563.8,555250,2770,6324.3,777100
6410,5140.2,1332350,3440,556,555250,2970,4584.2,777100
7400,4399.6,1332350,4190,494.1,555250,3210,3905.5,777100
7770,3574,1332350,4340,261,555250,3430,3313,777100
8170,3383.6,1332350,4530,323.5,555250,3640,3060.1,777100
8550,3328.9,1332350,4710,436,555250,3840,2892.9,777100
8860,3795.4,1332350,4880,424,555250,3980,3371.4,777100
8710,4409.3,1332350,4550,420,555250,4160,3989.3,777100
8640,4528.5,1332350,4280,507.5,555250,4360,4021,777100
8540,5226,1332350,3960,580.8,555250,4580,4645.2,777100
8380,5102.8,1332350,3650,709.1,555250,4730,4393.7,777100
8310,3673.9,1332350,4000,524,555250,4310,3149.9,777100
8240,3039.5,1332350,4310,448.5,555250,3930,2591,777100
8180,2616.6,1332350,4650,436,555250,3530,2180.6,777100
8150,2211,1332350,4990,261,555250,3160,1950,777100
8540,2395.6,1332350,5660,249.1,555250,2880,2146.5,777100
8980,2201.8,1332350,6370,247.3,555250,2610,1954.5,777100
9420,1957.7,1332350,7060,136,555250,2360,1821.7,777100
9790,2033.1,1332350,7760,136,555250,2030,1897.1,777100
10410,2259.1,1332350,8440,136,555250,1970,2123.1,777100
10990,2338.5,1332350,9120,136,555250,1870,2202.5,777100
11520,2824.4,1332350,9790,151,555250,1730,2673.4,777100
12040,3460.8,1332350,10450,139.4,555250,1590,3321.4,777100
12600,3626.1,1332350,10230,139.4,555250,2370,3486.7,777100
13180,3482.9,1332350,9970,137.7,555250,3210,3345.2,777100
13800,3397.6,1332350,9720,141.6,555250,4080,3256,777100
14330,4234.2,1332350,9490,186,555250,4840,4048.2,777100
15560,3810.7,1332350,9860,277.3,555250,5700,3533.4,777100
16770,4392.9,1332350,10210,426,555250,6560,3966.9,777100
17860,5742.7,1332350,10560,627.2,555250,7300,5115.5,777100
18990,4373.1,1332350,10920,609,555250,8070,3764.1,777100
20570,4940.1,1332350,11540,667.9,555250,9030,4272.2,777100
22130,6390.7,1332350,12160,1304.3,555250,9970,5086.4,777100
23720,5602.7,1332350,12810,896.6,555250,10910,4706.1,777100
25290,7982.7,1332350,13420,1512.7,555250,11870,6470,777100
27670,7627,1332350,14060,1749,555250,13610,5878,777100
30150,8401.3,1332350,14770,1960.8,555250,15380,6440.5,777100
32550,9393,1332350,15440,2129.7,555250,17110,7263.3,777100
35010,10976.9,1332350,16120,2232.8,555250,18890,8744.1,777100
37320,11889.8,1332350,16580,2476.2,555250,20740,9413.6,777100
39700,13486.4,1332350,17030,2939.5,555250,22670,10546.9,777100
42120,14726.2,1332350,17480,2978.2,555250,24640,11748,777100
44530,15868.3,1332350,17960,3012.4,555250,26570,12855.9,777100
47280,14444.2,1332350,18930,2851.4,555250,28350,11592.8,777100
50070,16065,1332350,19930,3294.5,555250,30140,12770.5,777100
52890,18784.7,1332350,20930,3637.5,555250,31960,15147.2,777100
55710,19985.1,1332350,21910,4257.9,555250,33800,15727.2,777100
57790,20207.9,1332350,22310,4860.5,555250,35480,15347.4,777100
59900,21130.8,1332350,22740,4291.8,555250,37160,16839,777100
62110,20254.7,1332350,23160,3219.8,555250,38950,17034.9,777100
64250,21051.1,1332350,23590,3212.4,555250,40660,17838.7,777100
65620,25653.7,1332350,23570,4803.6,555250,42050,20850.1,777100
67110,29676.1,1332350,23570,6877.4,555250,43540,22798.7,777100
68460,35617,1332350,23590,8992.4,555250,44870,26624.6,777100
69900,33078.1,1332350,23580,7345.3,555250,46320,25732.8,777100
70580,31133.1,1332350,22920,5874.7,555250,47660,25258.4,777100
71250,30810.4,1332350,22290,4973.4,555250,48960,25837,777100
71920,32709.7,1332350,21660,5656.7,555250,50260,27053,777100
72620,35734.1,1332350,21010,8160.5,555250,51610,27573.6,777100
74220,35654.4,1332350,22840,9319,555250,51380,26335.4,777100
74320,31832.1,1332350,22770,6596.3,555250,51550,25235.8,777100
74380,29466.1,1332350,22660,4769.3,555250,51720,24696.8,777100
74480,30559.5,1332350,22590,3471.1,555250,51890,27088.4,777100
74320,29081.3,1332350,22930,2378.6,555250,51390,26702.7,777100
74150,29693.7,1332350,23260,2715.5,555250,50890,26978.2,777100
74000,35405.4,1332350,23600,5661.9,555250,50400,29743.5,777100
73890,37673,1332350,23970,7215.1,555250,49920,30457.9,777100
73160,40589.4,1332350,23140,9750.1,555250,50020,30839.3,777100
72540,43097.8,1332350,22330,10562.4,555250,50210,32535.4,777100
71870,39378.2,1332350,21520,8280.4,555250,50350,31097.8,777100
71240,37617.4,1332350,20730,6954.1,555250,50510,30663.3,777100
67920,31207.1,1332350,19980,4256.8,555250,47940,26950.3,777100
64640,27602.9,1332350,19200,2418.3,555250,45440,25184.6,777100
61280,26244.6,1332350,18440,2559.4,555250,42840,23685.2,777100
25170,24195.4,1332350,4340,2875,555250,20830,21320.4,777100
23880,22171.7,1332350,4200,2900,555250,19680,19271.7,777100
22600,20927.6,1332350,4060,2681.8,555250,18540,18245.8,777100
21350,20885.6,1332350,3920,2569.2,555250,17430,18316.4,777100
19980,20401.6,1332350,3770,2507.1,555250,16210,17894.5,777100
18960,19500.9,1332350,3610,2460,555250,15350,17040.9,777100
17850,19794.5,1332350,3390,2443.5,555250,14460,17351,777100
16800,19346.8,1332350,3220,2661.9,555250,13580,16684.9,777100
15700,19910.3,1332350,3040,3281.5,555250,12660,16628.8,777100
14790,17573.3,1332350,2840,3073.4,555250,11950,14499.9,777100
13820,15942.7,1332350,2590,2740.2,555250,11230,13202.5,777100
12850,14603.4,1332350,2380,2370.6,555250,10470,12232.8,777100
11890,13669.8,1332350,2160,2227.2,555250,9730,11442.6,777100
10960,10895.2,1332350,1970,2136.3,555250,8990,8758.9,777100
10060,12294.2,1332350,1800,2986,555250,8260,9308.2,777100
9140,10623.6,1332350,1640,2196,555250,7500,8427.6,777100
8220,9051.5,1332350,1460,1698,555250,6760,7353.5,777100
7330,8554.6,1332350,1220,1854.2,555250,6110,6700.4,777100
6380,9016.1,1332350,970,2036.1,555250,5410,6980,777100
5420,7906.4,1332350,730,1933.5,555250,4690,5972.9,777100
4500,7680.6,1332350,490,1799.8,555250,4010,5880.8,777100
4260,7850.1,1332350,430,1808.3,555250,3830,6041.8,777100
4070,6768.8,1332350,380,1407.4,555250,3690,5361.4,777100
3830,6684.6,1332350,320,1419.4,555250,3510,5265.2,777100
3570,6538.2,1332350,250,1498.4,555250,3320,5039.8,777100
3330,5110.3,1332350,220,1168.4,555250,3110,3941.9,777100
3130,3790.5,1332350,210,811.3,555250,2920,2979.2,777100
2920,2602.9,1332350,180,472.5,555250,2740,2130.4,777100
2710,2804.8,1332350,160,322.1,555250,2550,2482.7,777100
2560,3081.5,1332350,130,254.2,555250,2430,2827.3,777100
2390,2838.7,1332350,140,241.6,555250,2250,2597.1,777100
2290,2792.6,1332350,120,245.4,555250,2170,2547.2,777100
2110,2704.1,1332350,100,239.8,555250,2010,2464.3,777100
1970,2497,1332350,120,249.1,555250,1850,2247.9,777100
1800,2468.4,1332350,120,173.5,555250,1680,2294.9,777100
1660,2279,1332350,130,136,555250,1530,2143,777100
1500,2099.3,1332350,140,136,555250,1360,1963.3,777100
1400,2060.5,1332350,180,136,555250,1220,1924.5,777100
1300,2071.2,1332350,230,136,555250,1070,1935.2,777100
1200,1962.7,1332350,290,136,555250,910,1826.7,777100
1100,1972.1,1332350,340,136,555250,760,1836.1,777100
990,1554.8,1332350,350,136,555250,640,1418.8,777100
890,1681.8,1332350,360,136,555250,530,1545.8,777100
830,1770.5,1332350,390,236,555250,440,1534.5,777100
730,1731.9,1332350,400,236,555250,330,1495.9,777100
780,2122.3,1332350,390,236,555250,390,1886.3,777100
820,2419,1332350,360,249.1,555250,460,2169.9,777100
870,2623.9,1332350,350,245.4,555250,520,2378.5,777100
1000,3784.3,1332350,330,236,555250,670,3548.3,777100
1010,2609.2,1332350,300,249.1,555250,710,2360.1,777100
1020,2679.3,1332350,250,239.8,555250,770,2439.5,777100
1080,2529.4,1332350,230,245.4,555250,850,2284,777100
1140,2589.9,1332350,200,249.1,555250,940,2340.8,777100
1210,2629.7,1332350,280,236,555250,930,2393.7,777100
1350,2751.9,1332350,360,241.6,555250,990,2510.3,777100
1480,3679.5,1332350,450,261.8,555250,1030,3417.7,777100
1600,3446.4,1332350,520,283.6,555250,1080,3162.8,777100
2070,3653.8,1332350,650,356.1,555250,1420,3297.7,777100
2510,3574.9,1332350,780,260.1,555250,1730,3314.8,777100
3020,4367.6,1332350,910,282,555250,2110,4085.6,777100
3530,3601.5,1332350,1020,599.5,555250,2510,3002,777100
4110,3555.7,1332350,1180,530,555250,2930,3025.7,777100
4650,3893.3,1332350,1350,794.9,555250,3300,3098.4,777100
5300,5741.4,1332350,1520,1445.5,555250,3780,4295.9,777100
5870,7856.6,1332350,1660,1852.6,555250,4210,6004,777100
6790,11074,1332350,2040,2786.9,555250,4750,8287.1,777100
7710,11684.5,1332350,2450,2884.2,555250,5260,8800.3,777100
8580,12575.2,1332350,2810,2714,555250,5770,9861.2,777100
9530,12305.5,1332350,3210,2712.4,555250,6320,9593.1,777100
11910,14485.6,1332350,3690,3058.4,555250,8220,11427.2,777100
14260,17882.2,1332350,4190,4805.6,555250,10070,13076.6,777100
16580,23171,1332350,4650,6297.6,555250,11930,16873.4,777100
19050,23006.5,1332350,5180,5514.1,555250,13870,17492.4,777100
21160,25928.7,1332350,5360,5437.8,555250,15800,20490.9,777100
23340,30921.6,1332350,5560,7066.8,555250,17780,23854.8,777100
25480,34850.1,1332350,5780,7943.2,555250,19700,26906.9,777100
27530,39337.2,1332350,5930,8835.4,555250,21600,30501.8,777100
30270,48014.3,1332350,6360,11075.9,555250,23910,36938.4,777100
32950,51954.5,1332350,6820,11729.7,555250,26130,40224.8,777100
35560,58760.9,1332350,7210,13063.6,555250,28350,45697.3,777100
38160,59934.2,1332350,7620,13502,555250,30540,46432.2,777100
42870,64657.4,1332350,8990,16375.2,555250,33880,48282.2,777100
47490,56785,1332350,10330,12183.1,555250,37160,44601.9,777100
52160,61652.9,1332350,11670,13184.9,555250,40490,48468,777100
56890,68410.5,1332350,13050,16077.6,555250,43840,52332.9,777100
60900,78403.4,1332350,13890,20194.1,555250,47010,58209.3,777100
64850,84910.1,1332350,14710,22411.8,555250,50140,62498.3,777100
68820,94406.9,1332350,15540,25375.4,555250,53280,69031.5,777100
72910,100955.7,1332350,16400,27637.2,555250,56510,73318.5,777100
76240,99374.8,1332350,17220,26546.7,555250,59020,72828.1,777100
79540,100022.9,1332350,18010,26872.6,555250,61530,73150.3,777100
82940,115980.5,1332350,18850,33861.6,555250,64090,82118.9,777100
86340,118891.4,1332350,19690,35838.9,555250,66650,83052.5,777100
85550,120628.3,1332350,19780,36110.2,555250,65770,84518.1,777100
84820,128610.5,1332350,19880,38557.6,555250,64940,90052.9,777100
84180,136776.1,1332350,19970,42975.1,555250,64210,93801,777100
114750,141286.9,1332350,42370,50678.3,555250,72380,90608.6,777100
114240,136551.7,1332350,42820,48518.5,555250,71420,88033.2,777100
113810,137990.2,1332350,43280,49080.2,555250,70530,88910,777100
113290,128601.4,1332350,43740,47405.4,555250,69550,81196,777100
112850,122472.2,1332350,44200,45463.6,555250,68650,77008.6,777100
110090,122726,1332350,42540,45027.8,555250,67550,77698.2,777100
107220,114477.9,1332350,40880,40189.8,555250,66340,74288.1,777100
104320,125446.9,1332350,39240,45720.3,555250,65080,79726.6,777100
101420,131900.7,1332350,37560,45539.2,555250,63860,86361.5,777100
97510,135871.1,1332350,35630,48808,555250,61880,87063.1,777100
93630,128829.6,1332350,33670,46791.6,555250,59960,82038,777100
89680,123761,1332350,31690,46118.3,555250,57990,77642.7,777100
85750,129422.5,1332350,29730,50397.3,555250,56020,79025.2,777100
82230,132438.4,1332350,28040,53741.6,555250,54190,78696.8,777100
78690,139594.3,1332350,26340,57767.2,555250,52350,81827.1,777100
75130,145327.2,1332350,24650,60406.5,555250,50480,84920.7,777100
71630,139064.1,1332350,22940,57162.2,555250,48690,81901.9,777100
68590,122891.2,1332350,21610,50677.6,555250,46980,72213.6,777100
65600,118036.1,1332350,20260,49516.2,555250,45340,68519.9,777100
62540,102078.8,1332350,18900,40445.5,555250,43640,61633.3,777100
59510,92228.9,1332350,17550,34203,555250,41960,58025.9,777100
57910,80181.3,1332350,17140,27898.3,555250,40770,52283,777100
56160,77658.5,1332350,16670,25535.4,555250,39490,52123.1,777100
54470,73830.2,1332350,16200,24104.3,555250,38270,49725.9,777100
52790,74336.3,1332350,15760,25678.5,555250,37030,48657.8,777100
51060,76494.8,1332350,15080,28412.4,555250,35980,48082.4,777100
49390,71965.4,1332350,14430,25854.8,555250,34960,46110.6,777100
47630,64765.3,1332350,13740,22156.9,555250,33890,42608.4,777100
45920,69073.5,1332350,13070,24994.6,555250,32850,44078.9,777100
44460,74015.6,1332350,12740,27897.8,555250,31720,46117.8,777100
43010,58121.5,1332350,12410,18971.3,555250,30600,39150.2,777100
41620,49835.8,1332350,12080,16406.5,555250,29540,33429.3,777100
40150,46445.6,1332350,11780,15762.6,555250,28370,30683,777100
38630,40795,1332350,11840,13359.3,555250,26790,27435.7,777100
37110,29057.9,1332350,11910,8186.5,555250,25200,20871.4,777100
35540,23210.8,1332350,11970,6719.8,555250,23570,16491,777100
34040,16356.3,1332350,12020,5051.8,555250,22020,11304.5,777100
32540,11108.9,1332350,11790,2581.3,555250,20750,8527.6,777100
31110,9004.2,1332350,11590,1704.4,555250,19520,7299.8,777100
29610,8408.4,1332350,11350,1343.5,555250,18260,7064.9,777100
28150,9324.3,1332350,11120,1091.8,555250,17030,8232.5,777100
27520,9237.8,1332350,11190,718,555250,16330,8519.8,777100
26980,10543.8,1332350,11250,1221.7,555250,15730,9322.1,777100
26370,13340.5,1332350,11310,1514,555250,15060,11826.5,777100
25700,20133.4,1332350,11340,4028.1,555250,14360,16105.3,777100
26340,22614.7,1332350,11130,4316.3,555250,15210,18298.4,777100
26910,26753.5,1332350,10900,5908.5,555250,16010,20845,777100
27520,26572.3,1332350,10670,5204.4,555250,16850,21367.9,777100
28050,25880.4,1332350,10460,4276.9,555250,17590,21603.5,777100
28700,27172.8,1332350,10410,4741.9,555250,18290,22430.9,777100
29360,26619.1,1332350,10410,5589.8,555250,18950,21029.3,777100
30060,31005.9,1332350,10390,7928,555250,19670,23077.9,777100
30690,30025.3,1332350,10390,7931.3,555250,20300,22094,777100
31230,28472.5,1332350,10700,6231.3,555250,20530,22241.2,777100
31840,30198.9,1332350,11060,7620.6,555250,20780,22578.3,777100
32400,32538.5,1332350,11370,10373.1,555250,21030,22165.4,777100
33010,39663.1,1332350,11730,13794,555250,21280,25869.1,777100
37090,41936.7,1332350,13980,16129.9,555250,23110,25806.8,777100
41230,46832.8,1332350,16260,18875,555250,24970,27957.8,777100
45320,51607.9,1332350,18530,20811,555250,26790,30796.9,777100
49480,46420.1,1332350,20820,18438.8,555250,28660,27981.3,777100
54420,58477.5,1332350,23410,26807.1,555250,31010,31670.4,777100
59150,72573,1332350,25990,33597.3,555250,33160,38975.7,777100
64000,74813.4,1332350,28560,34994.6,555250,35440,39818.8,777100
68870,81033.7,1332350,31150,38393.2,555250,37720,42640.5,777100
74550,82624,1332350,34050,40924.7,555250,40500,41699.3,777100
80160,96222,1332350,36910,47446.3,555250,43250,48775.7,777100
85860,100571.2,1332350,39800,51607.6,555250,46060,48963.6,777100
91540,118253.8,1332350,42670,61018.9,555250,48870,57234.9,777100
99450,124724.5,1332350,46750,62626.3,555250,52700,62098.2,777100
107410,129868.9,1332350,50850,66597.8,555250,56560,63271.1,777100
115310,130161.2,1332350,54940,66890.8,555250,60370,63270.4,777100
123170,131612.5,1332350,59020,67225.6,555250,64150,64386.9,777100
129050,131482,1332350,61880,66114,555250,67170,65368,777100
135120,138210.2,1332350,64780,68747.4,555250,70340,69462.8,777100
141010,130880.3,1332350,67640,62417.3,555250,73370,68463,777100
146980,132475.2,1332350,70540,63010.4,555250,76440,69464.8,777100
152550,135798.7,1332350,73350,65919,555250,79200,69879.7,777100
158110,164983.6,1332350,76130,83899.5,555250,81980,81084.1,777100
163650,170606.1,1332350,78950,85866.2,555250,84700,84739.9,777100
169220,186241,1332350,81730,92375.7,555250,87490,93865.3,777100
174480,200298.5,1332350,83690,102304.2,555250,90790,97994.3,777100
179660,228296.2,1332350,85630,119303.9,555250,94030,108992.3,777100
184920,260414.5,1332350,87570,137938.6,555250,97350,122475.9,777100
190090,287337.7,1332350,89510,152580.5,555250,100580,134757.2,777100
195670,306417.1,1332350,91480,163568.6,555250,104190,142848.5,777100
201160,301623.6,1332350,93460,156511.2,555250,107700,145112.4,777100
206780,292898.2,1332350,95450,151244,555250,111330,141654.2,777100
212350,306664.8,1332350,97440,158809.7,555250,114910,147855.1,777100
215770,310107.2,1332350,98620,161621.8,555250,117150,148485.4,777100
219160,319170.8,1332350,99790,165207.3,555250,119370,153963.5,777100
222590,307317.8,1332350,100960,156466.3,555250,121630,150851.5,777100
226100,329992,1332350,102160,167866,555250,123940,162126,777100
221960,337961,1332350,99800,168872.3,555250,122160,169088.7,777100
217930,318753.7,1332350,97430,157303.6,555250,120500,161450.1,777100
213700,320948,1332350,95050,156043.8,555250,118650,164904.2,777100
242800,324292.5,1332350,120140,167038.3,555250,122660,157254.2,777100
241240,319738.1,1332350,120070,164373.3,555250,121170,155364.8,777100
239700,309994.8,1332350,120020,157895.9,555250,119680,152098.9,777100
238090,314642.5,1332350,119950,165013.8,555250,118140,149628.7,777100
236650,301613.3,1332350,119910,157621.1,555250,116740,143992.2,777100
234780,295292.4,1332350,119060,149986.8,555250,115720,145305.6,777100
232920,287639.6,1332350,118210,143911.4,555250,114710,143728.2,777100
231090,272853.2,1332350,117400,133741.6,555250,113690,139111.6,777100
229230,273503.5,1332350,116520,136721.6,555250,112710,136781.9,777100
227740,250982.6,1332350,116060,127687.7,555250,111680,123294.9,777100
226130,228760.7,1332350,115610,117556.8,555250,110520,111203.9,777100
224540,206312.7,1332350,115130,104278,555250,109410,102034.7,777100
222960,194730.3,1332350,114650,96382.7,555250,108310,98347.6,777100
221650,191706.8,1332350,114490,94790,555250,107160,96916.8,777100
220350,198545.5,1332350,114330,98296.3,555250,106020,100249.2,777100
219040,190270.2,1332350,114160,93044.6,555250,104880,97225.6,777100
217770,210256.8,1332350,114000,104228.2,555250,103770,106028.6,777100
215360,238516.5,1332350,112880,122819.8,555250,102480,115696.7,777100
212910,230961.9,1332350,111710,120336.7,555250,101200,110625.2,777100
210500,204749,1332350,110560,105036.8,555250,99940,99712.2,777100
208050,216343.8,1332350,109440,112343,555250,98610,104000.8,777100
203450,230541.9,1332350,107310,119990.4,555250,96140,110551.5,777100
198620,211436.3,1332350,105160,106658.8,555250,93460,104777.5,777100
193990,222578.8,1332350,103100,112635,555250,90890,109943.8,777100
189290,226502.5,1332350,100990,114474.3,555250,88300,112028.2,777100
186460,231590.6,1332350,100190,119015,555250,86270,112575.6,777100
183560,219263.3,1332350,99370,113226.9,555250,84190,106036.4,777100
180760,208271.8,1332350,98590,108829,555250,82170,99442.8,777100
177880,198340.6,1332350,97770,104238.5,555250,80110,94102.1,777100
176540,176185.3,1332350,98040,95247,555250,78500,80938.3,777100
175200,149087.5,1332350,98330,82137.5,555250,76870,66950,777100
173940,143647,1332350,98610,81979.2,555250,75330,61667.8,777100
172510,133064.1,1332350,98870,77774.2,555250,73640,55289.9,777100
169620,113871.8,1332350,98190,70978.7,555250,71430,42893.1,777100
166740,97504.9,1332350,97510,65263.1,555250,69230,32241.8,777100
163850,80265.7,1332350,96870,57308.8,555250,66980,22956.9,777100
160950,84293.1,1332350,96220,60806.3,555250,64730,23486.8,777100
161800,101099.2,1332350,97200,72169.6,555250,64600,28929.6,777100
162640,118339.9,1332350,98190,83052.7,555250,64450,35287.2,777100
163440,113365,1332350,99190,81785.9,555250,64250,31579.1,777100
164310,122591.7,1332350,100230,86845.4,555250,64080,35746.3,777100
163520,135471.3,1332350,98530,92767.2,555250,64990,42704.1,777100
162670,155017,1332350,96840,102243.7,555250,65830,52773.3,777100
161880,172088.2,1332350,95150,109294.7,555250,66730,62793.5,777100
161060,173525.9,1332350,93490,107175.9,555250,67570,66350,777100
169150,187925,1332350,96770,108231.2,555250,72380,79693.8,777100
177170,198697.7,1332350,100010,113713.8,555250,77160,84983.9,777100
185200,207588.5,1332350,103270,118266.4,555250,81930,89322.1,777100
193270,221384.5,1332350,106540,124156.1,555250,86730,97228.4,777100
203280,233386.7,1332350,112140,128568.2,555250,91140,104818.5,777100
213330,218789.3,1332350,117740,121520.8,555250,95590,97268.5,777100
223450,226744.8,1332350,123340,128418.4,555250,100110,98326.4,777100
233440,233719.2,1332350,128910,132188.7,555250,104530,101530.5,777100
242830,233580.5,1332350,134910,134074,555250,107920,99506.5,777100
252250,207181.1,1332350,140900,117907.8,555250,111350,89273.3,777100
261710,204076.5,1332350,146890,116260,555250,114820,87816.5,777100
271130,211829.8,1332350,152870,121542,555250,118260,90287.8,777100
282700,219787.5,1332350,160930,127835,555250,121770,91952.5,777100
294260,229848,1332350,169020,135863.8,555250,125240,93984.2,777100
305830,216028.1,1332350,177040,128960,555250,128790,87068.1,777100
317420,218592.3,1332350,185100,131413,555250,132320,87179.3,777100
329860,204421.2,1332350,193500,122167.8,555250,136360,82253.4,777100
342370,198297.4,1332350,201890,120319.9,555250,140480,77977.5,777100
354790,213728.2,1332350,210270,129865.1,555250,144520,83863.1,777100
367240,245211.1,1332350,218660,152553.6,555250,148580,92657.5,777100
379050,276882.6,1332350,226280,175452.3,555250,152770,101430.3,777100
390710,295674.5,1332350,233910,188260,555250,156800,107414.5,777100
402530,339133.4,1332350,241570,211138.2,555250,160960,127995.2,777100
414300,371230.7,1332350,249210,229498.7,555250,165090,141732,777100
419250,428147.3,1332350,252340,265293.7,555250,166910,162853.6,777100
424170,474768.5,1332350,255450,293730.3,555250,168720,181038.2,777100
429180,453842.5,1332350,258600,281091.8,555250,170580,172750.7,777100
434150,440918.6,1332350,261730,274871.9,555250,172420,166046.7,777100
438710,461599.7,1332350,265200,286895.8,555250,173510,174703.9,777100
443230,462660.1,1332350,268630,285633.1,555250,174600,177027,777100
447780,461318.6,1332350,272060,287639.2,555250,175720,173679.4,777100
452280,452414.8,1332350,275520,283935.5,555250,176760,168479.3,777100
456700,476305.1,1332350,278880,300779.3,555250,177820,175525.8,777100
461220,501657.9,1332350,282230,315548.5,555250,178990,186109.4,777100
465600,542914.4,1332350,285580,340308.8,555250,180020,202605.6,777100
470070,531781.2,1332350,288960,336040.9,555250,181110,195740.3,777100
473880,521439.5,1332350,289230,329910,555250,184650,191529.5,777100
477720,511036.9,1332350,289520,323093.1,555250,188200,187943.8,777100
481600,531442.8,1332350,289810,336506.7,555250,191790,194936.1,777100
485400,549796.9,1332350,290060,345709.8,555250,195340,204087.1,777100
489000,574103.2,1332350,290470,360460.9,555250,198530,213642.3,777100
492540,557353.4,1332350,290840,350161.8,555250,201700,207191.6,777100
496250,546945.6,1332350,291250,340398.3,555250,205000,206547.3,777100
499770,569698.2,1332350,291620,349640.1,555250,208150,220058.1,777100
502130,566745.5,1332350,291300,346071.8,555250,210830,220673.7,777100
504430,565651.8,1332350,290950,342203.5,555250,213480,223448.3,777100
506750,567603.3,1332350,290620,340693.1,555250,216130,226910.2,777100
509080,557196.7,1332350,290300,335283.5,555250,218780,221913.2,777100
503760,563773.3,1332350,287090,338370.9,555250,216670,225402.4,777100
498300,567561.8,1332350,283850,338944.8,555250,214450,228617,777100
492880,568982.7,1332350,280640,340249.7,555250,212240,228733,777100
450300,583744.3,1332350,246500,339893.6,555250,203800,243850.7,777100
445820,584512.8,1332350,244230,334986.6,555250,201590,249526.2,777100
441230,571842.5,1332350,241910,325960.5,555250,199320,245882,777100
436730,538493.8,1332350,239610,305583.1,555250,197120,232910.7,777100
432150,546249.9,1332350,237310,307254.9,555250,194840,238995,777100
426430,558927.3,1332350,233660,313210.7,555250,192770,245716.6,777100
420670,552440.3,1332350,229990,308630.1,555250,190680,243810.2,777100
414820,505241.5,1332350,226360,279214,555250,188460,226027.5,777100
409110,446705.7,1332350,222690,240650.9,555250,186420,206054.8,777100
402400,381340.3,1332350,218290,203534.5,555250,184110,177805.8,777100
395710,396420,1332350,213910,209497.4,555250,181800,186922.6,777100
389120,430893,1332350,209520,228123.9,555250,179600,202769.1,777100
382450,433512.5,1332350,205120,233524.6,555250,177330,199987.9,777100
376670,450429.9,1332350,202250,243116.8,555250,174420,207313.1,777100
370840,442690.9,1332350,199340,243475.2,555250,171500,199215.7,777100
365010,414720.1,1332350,196470,228435.5,555250,168540,186284.6,777100
359170,390447.4,1332350,193560,214683,555250,165610,175764.4,777100
352410,367274,1332350,190070,202491.1,555250,162340,164782.9,777100
345600,342962.6,1332350,186570,189564.6,555250,159030,153398,777100
338850,349241.2,1332350,183060,190914.7,555250,155790,158326.5,777100
332000,370096.1,1332350,179560,206074.8,555250,152440,164021.3,777100
327020,379424.8,1332350,178510,216658.6,555250,148510,162766.2,777100
322140,375592,1332350,177510,217995,555250,144630,157597,777100
317180,393353.5,1332350,176460,227937.4,555250,140720,165416.1,777100
312230,395530.1,1332350,175440,230412.3,555250,136790,165117.8,777100
307470,421626.1,1332350,173750,248339.3,555250,133720,173286.8,777100
302930,420758,1332350,172090,248442.6,555250,130840,172315.4,777100
298180,424003.4,1332350,170390,252028.9,555250,127790,171974.5,777100
293570,411968.1,1332350,168720,245792.9,555250,124850,166175.2,777100
289410,392221.6,1332350,168440,238500.7,555250,120970,153720.9,777100
285310,382673.5,1332350,168180,236635.8,555250,117130,146037.7,777100
281160,344862.9,1332350,167900,219759.3,555250,113260,125103.6,777100
277130,325548.5,1332350,167650,211050.1,555250,109480,114498.4,777100
272560,291258.3,1332350,166030,194061.6,555250,106530,97196.7,777100
268100,271748.6,1332350,164420,184335.9,555250,103680,87412.7,777100
263580,267640.9,1332350,162760,181269.9,555250,100820,86371,777100
259120,234069.2,1332350,161160,161889.7,555250,97960,72179.5,777100
257330,199442.8,1332350,158500,139720.8,555250,98830,59722,777100
255560,187727.9,1332350,155850,130941.4,555250,99710,56786.5,777100
253730,190421.2,1332350,153150,131213.9,555250,100580,59207.3,777100
251970,189143.5,1332350,150530,126592.6,555250,101440,62550.9,777100
253280,184601,1332350,149910,120684.4,555250,103370,63916.6,777100
254560,172688.7,1332350,149260,111933.8,555250,105300,60754.9,777100
255850,190455.7,1332350,148640,117032,555250,107210,73423.7,777100
257170,195054.6,1332350,148000,114987,555250,109170,80067.6,777100
263820,165892.5,1332350,150800,97802.5,555250,113020,68090,777100
270460,159712.2,1332350,153560,89868.8,555250,116900,69843.4,777100
277060,162308.2,1332350,156330,92131.8,555250,120730,70176.4,777100
283710,156744.5,1332350,159110,89523.8,555250,124600,67220.7,777100
290040,167605.6,1332350,162040,94241.8,555250,128000,73363.8,777100
296340,190634.8,1332350,164950,104272.8,555250,131390,86362,777100
302660,184777.1,1332350,167880,99449.9,555250,134780,85327.2,777100
308940,195724.4,1332350,170790,104540.4,555250,138150,91184,777100
314360,210586.6,1332350,173510,116638.3,555250,140850,93948.3,777100
319750,246141.5,1332350,176230,138605.1,555250,143520,107536.4,777100
325150,287881,1332350,178940,162595.2,555250,146210,125285.8,777100
330490,295076.5,1332350,181640,165839.1,555250,148850,129237.4,777100
342850,288103.8,1332350,190280,162627.9,555250,152570,125475.9,777100
355150,286621.3,1332350,198890,164808.6,555250,156260,121812.7,777100
367410,297131.5,1332350,207490,173962.8,555250,159920,123168.7,777100
379770,339215.8,1332350,216120,196182.3,555250,163650,143033.5,777100
392900,398409.8,1332350,225560,232533.3,555250,167340,165876.5,777100
405990,428625.2,1332350,234960,251643.2,555250,171030,176982,777100
419160,449395.5,1332350,244400,263450.4,555250,174760,185945.1,777100
432330,489218,1332350,253830,290639.9,555250,178500,198578.1,777100
446970,575621.5,1332350,264790,346398.4,555250,182180,229223.1,777100
461560,596905.8,1332350,275750,363475.6,555250,185810,233430.2,777100
476200,644658,1332350,286700,395383.1,555250,189500,249274.9,777100
490910,665734,1332350,297680,411888.6,555250,193230,253845.4,777100
499260,713046.2,1332350,303460,441462.8,555250,195800,271583.4,777100
507640,746970.6,1332350,309220,461096.4,555250,198420,285874.2,777100
516030,777734.3,1332350,315030,480706.9,555250,201000,297027.4,777100
524490,798633.3,1332350,320810,492659.4,555250,203680,305973.9,777100
531370,824825.3,1332350,325320,505722.3,555250,206050,319103,777100
538340,828291.7,1332350,329840,511308.3,555250,208500,316983.4,777100
545260,836707.7,1332350,334360,515048.5,555250,210900,321659.2,777100
552170,817814.9,1332350,338850,505180.8,555250,213320,312634.1,777100
557760,825788.3,1332350,342390,507035.2,555250,215370,318753.1,777100
563340,830757.8,1332350,345880,507922,555250,217460,322835.8,777100
568960,826695.4,1332350,349430,502890.1,555250,219530,323805.3,777100
574550,812988.1,1332350,352940,498590.8,555250,221610,314397.3,777100
575060,781421,1332350,350330,480545.4,555250,224730,300875.6,777100
575400,721321.3,1332350,347680,443264.3,555250,227720,278057,777100
575920,728488.6,1332350,345070,445996.3,555250,230850,282492.3,777100
576340,762913.8,1332350,342430,467420.2,555250,233910,295493.6,777100
575610,810006.9,1332350,339430,490547.2,555250,236180,319459.7,777100
574900,819886.8,1332350,336450,494932.5,555250,238450,324954.3,777100
574140,816509.9,1332350,333440,489670.8,555250,240700,326839.1,777100
573420,806036.5,1332350,330460,484628.3,555250,242960,321408.2,777100
572460,775399.9,1332350,327030,462564.7,555250,245430,312835.2,777100
571430,738537.6,1332350,323670,439752.7,555250,247760,298784.9,777100
570470,655573.8,1332350,320290,387875.8,555250,250180,267698,777100
569410,609603.2,1332350,316880,361665.7,555250,252530,247937.5,777100
557490,599753.8,1332350,310580,355890.7,555250,246910,243863.1,777100
545510,578737.5,1332350,304280,343107.8,555250,241230,235629.7,777100
533570,558382.7,1332350,297990,330393.8,555250,235580,227988.9,777100
446990,564293.1,1332350,232890,318999.5,555250,214100,245293.6,777100
435530,495888.9,1332350,226720,273435.5,555250,208810,222453.4,777100
424010,449328.7,1332350,220550,246348.8,555250,203460,202979.9,777100
412420,404226.9,1332350,214350,224820.6,555250,198070,179406.3,777100
400880,372543.2,1332350,208160,208651.7,555250,192720,163891.5,777100
389680,368273.6,1332350,201900,204639.3,555250,187780,163634.3,777100
378550,359244.3,1332350,195640,200764.6,555250,182910,158479.7,777100
367340,352375.6,1332350,189370,198365.8,555250,177970,154009.8,777100
356080,349107.1,1332350,183080,198277.3,555250,173000,150829.8,777100
348550,342818.7,1332350,180460,192893.3,555250,168090,149925.4,777100
340990,333789.3,1332350,177870,187904.4,555250,163120,145884.9,777100
333480,329087.4,1332350,175250,191043.9,555250,158230,138043.5,777100
325870,339639.5,1332350,172610,197314.2,555250,153260,142325.3,777100
318330,349819.6,1332350,169710,201054,555250,148620,148765.6,777100
310790,342638.5,1332350,166780,195785,555250,144010,146853.5,777100
303210,344251.9,1332350,163850,194931.4,555250,139360,149320.5,777100
295740,314728.6,1332350,160940,176431.1,555250,134800,138297.5,777100
288580,303250.6,1332350,158310,168791.3,555250,130270,134459.3,777100
281460,310418.3,1332350,155670,171623,555250,125790,138795.3,777100
274410,294949.3,1332350,153020,161659.4,555250,121390,133289.9,777100
267260,281265.9,1332350,150360,155452.9,555250,116900,125813,777100
262360,257438,1332350,148610,142501.2,555250,113750,114936.8,777100
257380,260757.3,1332350,146840,143300.6,555250,110540,117456.7,777100
252560,269330.4,1332350,145090,147579.2,555250,107470,121751.2,777100
247700,248123.2,1332350,143310,137013.2,555250,104390,111110,777100
241120,223829.7,1332350,141140,124557.7,555250,99980,99272,777100
234540,220784.6,1332350,138920,124046.6,555250,95620,96738,777100
228040,208977.6,1332350,136720,118723.5,555250,91320,90254.1,777100
221500,231329.1,1332350,134540,134365.3,555250,86960,96963.8,777100
214370,259003.2,1332350,131240,156945.5,555250,83130,102057.7,777100
207270,250334.4,1332350,127940,158335.4,555250,79330,91999,777100
200210,252603.2,1332350,124670,166686.7,555250,75540,85916.5,777100
193180,236698.6,1332350,121380,160905.9,555250,71800,75792.7,777100
190690,227728.6,1332350,120890,156612.1,555250,69800,71116.5,777100
188310,253074,1332350,120460,172894.3,555250,67850,80179.7,777100
185720,266538.4,1332350,119970,181602.1,555250,65750,84936.3,777100
183230,276613.8,1332350,119500,188323.3,555250,63730,88290.5,777100
181940,286668.4,1332350,119240,194396.1,555250,62700,92272.3,777100
180560,262829.8,1332350,118980,180639.6,555250,61580,82190.2,777100
179230,235337.8,1332350,118710,164419,555250,60520,70918.8,777100
177820,273809.4,1332350,118470,187522,555250,59350,86287.4,777100
177640,274404.7,1332350,119030,186807.3,555250,58610,87597.4,777100
177440,275545.1,1332350,119570,187507.1,555250,57870,88038,777100
177270,290029.2,1332350,120160,195337.2,555250,57110,94692,777100
176970,255995.6,1332350,120700,173684.1,555250,56270,82311.5,777100
177730,183588.2,1332350,120580,128574.5,555250,57150,55013.7,777100
178340,163470.6,1332350,120430,115582.3,555250,57910,47888.3,777100
179060,177254.8,1332350,120280,122965.5,555250,58780,54289.3,777100
179760,152990.4,1332350,120150,108074.7,555250,59610,44915.7,777100
181620,129099.8,1332350,121310,93364.2,555250,60310,35735.6,777100
183500,127852.6,1332350,122490,92166.5,555250,61010,35686.1,777100
185340,171192.1,1332350,123670,118403.7,555250,61670,52788.4,777100
187180,176511.8,1332350,124800,122302,555250,62380,54209.8,777100
188600,165348.8,1332350,125540,115308,555250,63060,50040.8,777100
190080,166103.3,1332350,126270,115066.4,555250,63810,51036.9,777100
191550,151042.5,1332350,126990,106147.7,555250,64560,44894.8,777100
192900,141364.1,1332350,127700,100733.2,555250,65200,40630.9,777100
198650,141869.9,1332350,131500,100994,555250,67150,40875.9,777100
204450,147695.3,1332350,135340,104415.8,555250,69110,43279.5,777100
210210,128359.7,1332350,139130,93452.5,555250,71080,34907.2,777100
216010,117147.3,1332350,142970,86318.8,555250,73040,30828.5,777100
221900,127071,1332350,147010,92269.6,555250,74890,34801.4,777100
227790,147565.8,1332350,151070,108063.8,555250,76720,39502,777100
233640,129916.6,1332350,155120,97452.1,555250,78520,32464.5,777100
239450,140334.7,1332350,159170,104230.8,555250,80280,36103.9,777100
246010,132731.4,1332350,164080,100582.5,555250,81930,32148.9,777100
252550,120062.5,1332350,168990,94124,555250,83560,25938.5,777100
259130,114666.5,1332350,173930,88524.5,555250,85200,26142,777100
265710,125681.3,1332350,178830,96355.5,555250,86880,29325.8,777100
268860,154357.1,1332350,180690,114357.4,555250,88170,39999.7,777100
272000,183006.7,1332350,182540,134276.6,555250,89460,48730.1,777100
275170,206766.6,1332350,184410,149526.4,555250,90760,57240.2,777100
278320,199418.2,1332350,186250,144459.7,555250,92070,54958.5,777100
281630,208834.9,1332350,188180,152195.7,555250,93450,56639.2,777100
284860,205269.7,1332350,190080,147520.1,555250,94780,57749.6,777100
288140,231486.5,1332350,191990,164584.2,555250,96150,66902.3,777100
291430,236589.3,1332350,193900,167045.5,555250,97530,69543.8,777100
295370,230363.7,1332350,196800,164876.9,555250,98570,65486.8,777100
299330,223722.5,1332350,199720,161582.7,555250,99610,62139.8,777100
303220,236672.7,1332350,202640,171488.3,555250,100580,65184.4,777100
307150,251414.2,1332350,205550,182392.3,555250,101600,69021.9,777100
305140,237005.1,1332350,202620,173823.9,555250,102520,63181.2,777100
303110,242374.2,1332350,199680,176957.1,555250,103430,65417.1,777100
301120,260156.7,1332350,196740,186498.1,555250,104380,73658.6,777100
299110,333024.6,1332350,193810,227414.2,555250,105300,105610.4,777100
297360,391097.5,1332350,190760,258986.7,555250,106600,132110.8,777100
295580,403104.2,1332350,187760,265742,555250,107820,137362.2,777100
293860,376978.3,1332350,184700,248361.5,555250,109160,128616.8,777100
292050,385437.5,1332350,181670,251398.3,555250,110380,134039.2,777100
288970,377913.4,1332350,178270,245641.6,555250,110700,132271.8,777100
285760,387128.5,1332350,174870,247365.8,555250,110890,139762.7,777100
282630,337424.3,1332350,171470,215282.6,555250,111160,122141.7,777100
279470,329488.7,1332350,168060,209174.7,555250,111410,120314,777100
274240,331412.2,1332350,164250,209711.1,555250,109990,121701.1,777100
269090,309910.1,1332350,160480,194865.3,555250,108610,115044.8,777100
263860,278955.3,1332350,156700,175585.7,555250,107160,103369.6,777100
256300,246069.2,1332350,148770,152021.1,555250,107530,94048.1,777100
249670,226695.6,1332350,142890,137968.1,555250,106780,88727.5,777100
243190,241685.8,1332350,137050,143047.9,555250,106140,98637.9,777100
236550,261638,1332350,131190,149067.9,555250,105360,112570.1,777100
230050,261844.3,1332350,125370,146574.2,555250,104680,115270.1,777100
224110,246746.1,1332350,120020,133903.5,555250,104090,112842.6,777100
218110,232946.6,1332350,114690,121701.5,555250,103420,111245.1,777100
212270,240508.5,1332350,109380,121269.3,555250,102890,119239.2,777100
206320,238942,1332350,104040,120583.7,555250,102280,118358.3,777100
204300,239124.3,1332350,103050,122262,555250,101250,116862.3,777100
202330,243092.4,1332350,102070,126991.6,555250,100260,116100.8,777100
200370,231785.2,1332350,101070,121092.8,555250,99300,110692.4,777100
198400,210402.7,1332350,100090,107222.9,555250,98310,103179.8,777100
196350,217706.4,1332350,99230,109644.5,555250,97120,108061.9,777100
194480,220111.3,1332350,98400,109752,555250,96080,110359.3,777100
192460,203185,1332350,97550,101059.8,555250,94910,102125.2,777100
190510,187161.8,1332350,96690,90303.8,555250,93820,96858,777100
188280,184640.1,1332350,95870,89067.2,555250,92410,95572.9,777100
186110,184896.7,1332350,95060,87010.3,555250,91050,97886.4,777100
183960,179635.2,1332350,94260,85918.3,555250,89700,93716.9,777100
181710,164220.3,1332350,93450,78381.1,555250,88260,85839.2,777100
174740,157385.8,1332350,90410,76496.1,555250,84330,80889.7,777100
167760,141768.7,1332350,87370,67576,555250,80390,74192.7,777100
160650,134415.3,1332350,84320,64292.8,555250,76330,70122.5,777100
153730,117233.1,1332350,81290,56255.8,555250,72440,60977.3,777100
146580,110575.7,1332350,77910,55149.4,555250,68670,55426.3,777100
139510,103735.7,1332350,74550,53504.8,555250,64960,50230.9,777100
132340,94554.9,1332350,71170,49576.7,555250,61170,44978.2,777100
125270,90448.6,1332350,67800,47063.6,555250,57470,43385,777100
119060,90905.3,1332350,65010,48880.4,555250,54050,42024.9,777100
112850,84317.4,1332350,62210,46321.6,555250,50640,37995.8,777100
106610,71441.5,1332350,59410,41087.3,555250,47200,30354.2,777100
100420,71877,1332350,56620,43139.5,555250,43800,28737.5,777100
93850,67494.2,1332350,53520,43274.2,555250,40330,24220,777100
87290,66176.6,1332350,50390,44470.2,555250,36900,21706.4,777100
80700,60091.7,1332350,47300,41865,555250,33400,18226.7,777100
74170,45570.9,1332350,44150,33387.5,555250,30020,12183.4,777100
68830,35413.1,1332350,41560,27377.8,555250,27270,8035.3,777100
63500,29848.9,1332350,38970,23561.2,555250,24530,6287.7,777100
58120,23821.3,1332350,36380,19016.6,555250,21740,4804.7,777100
52750,23159.6,1332350,33780,18562.9,555250,18970,4596.7,777100
47500,17043.6,1332350,30620,13215.1,555250,16880,3828.5,777100
42290,15858.6,1332350,27480,11967.4,555250,14810,3891.2,777100
37030,12188.9,1332350,24310,9090.7,555250,12720,3098.2,777100
31790,13986.9,1332350,21170,10335.7,555250,10620,3651.2,777100
31700,12675.3,1332350,21330,9333.5,555250,10370,3341.8,777100
31590,11051.1,1332350,21510,8169.7,555250,10080,2881.4,777100
31510,10562.7,1332350,21710,7485.5,555250,9800,3077.2,777100
31380,9699.9,1332350,21890,6847.8,555250,9490,2852.1,777100
31830,8972.4,1332350,22440,6014.9,555250,9390,2957.5,777100
32260,11099,1332350,22970,8268.6,555250,9290,2830.4,777100
32670,13167.8,1332350,23530,9903.8,555250,9140,3264,777100
33090,13033.1,1332350,24080,9691.5,555250,9010,3341.6,777100
33780,15958.2,1332350,24900,12618.5,555250,8880,3339.7,777100
34430,17811.8,1332350,25700,14357.5,555250,8730,3454.3,777100
35140,17550.2,1332350,26540,14451.5,555250,8600,3098.7,777100
35780,15650.9,1332350,27340,13043.2,555250,8440,2607.7,777100
38410,9195.8,1332350,29980,7527.4,555250,8430,1668.4,777100
40970,8514.1,1332350,32630,7051.1,555250,8340,1463,777100
43580,10411.8,1332350,35290,9143.9,555250,8290,1267.9,777100
46220,12415.6,1332350,37950,11018.9,555250,8270,1396.7,777100
48970,15329.1,1332350,40800,14029.1,555250,8170,1300,777100
51810,20093.8,1332350,43670,18561.4,555250,8140,1532.4,777100
54610,23670.7,1332350,46520,22226.8,555250,8090,1443.9,777100
57370,28045.4,1332350,49350,26085.5,555250,8020,1959.9,777100
61040,29908.4,1332350,52920,28023.5,555250,8120,1884.9,777100
64540,31626,1332350,56450,29246.2,555250,8090,2379.8,777100
68040,35888.7,1332350,59970,33407.9,555250,8070,2480.8,777100
71580,40707.7,1332350,63510,38383.2,555250,8070,2324.5,777100
74400,44180.3,1332350,65540,41624.5,555250,8860,2555.8,777100
77220,47035.9,1332350,67570,43953.1,555250,9650,3082.8,777100
80060,53556,1332350,69620,49842.8,555250,10440,3713.2,777100
82830,57177.6,1332350,71630,52862.4,555250,11200,4315.2,777100
84770,59662.6,1332350,72760,54751.8,555250,12010,4910.8,777100
86760,54953.5,1332350,73880,50455.6,555250,12880,4497.9,777100
88660,56315.3,1332350,74970,51077.2,555250,13690,5238.1,777100
90700,60620.9,1332350,76110,54155,555250,14590,6465.9,777100
92030,54362.9,1332350,76440,48198.5,555250,15590,6164.4,777100
93570,52384.1,1332350,76830,46066.4,555250,16740,6317.7,777100
94890,51934.9,1332350,77150,45325.1,555250,17740,6609.8,777100
96410,53909.4,1332350,77540,46631.5,555250,18870,7277.9,777100
97410,55637,1332350,75720,46295.5,555250,21690,9341.5,777100
98470,61202.1,1332350,73940,48637.4,555250,24530,12564.7,777100
99460,64923.9,1332350,72120,48982.5,555250,27340,15941.4,777100
100490,65454,1332350,70320,46547.7,555250,30170,18906.3,777100
102070,62531.6,1332350,69140,41183.1,555250,32930,21348.5,777100
103560,64555.1,1332350,67940,40044.9,555250,35620,24510.2,777100
105100,82364.7,1332350,66750,48140.5,555250,38350,34224.2,777100
106640,79080,1332350,65590,44473.8,555250,41050,34606.2,777100
108670,86221.7,1332350,65100,47895.6,555250,43570,38326.1,777100
110720,98227.8,1332350,64600,54432,555250,46120,43795.8,777100
112820,96826.7,1332350,64160,51259,555250,48660,45567.7,777100
114930,95700.3,1332350,63690,48195.3,555250,51240,47505,777100
112380,88005,1332350,61030,40017.7,555250,51350,47987.3,777100
109830,82772.4,1332350,58370,34511,555250,51460,48261.4,777100
107290,84520.2,1332350,55710,35585.4,555250,51580,48934.8,777100
63720,99719.9,1332350,27390,39735.2,555250,36330,59984.7,777100
61570,98148.1,1332350,25680,37552.6,555250,35890,60595.5,777100
59470,93254.9,1332350,23990,34754.5,555250,35480,58500.4,777100
57450,96168.7,1332350,22320,37291.3,555250,35130,58877.4,777100
55340,88340.1,1332350,20610,33749.2,555250,34730,54590.9,777100
53390,76794.9,1332350,19070,26074.8,555250,34320,50720.1,777100
51500,71689.9,1332350,17510,21258.9,555250,33990,50431,777100
49600,62611.8,1332350,15950,15831.3,555250,33650,46780.5,777100
47640,45645.3,1332350,14380,7792.7,555250,33260,37852.6,777100
45790,36899.6,1332350,13610,3491.5,555250,32180,33408.1,777100
43920,36011.7,1332350,12830,2767.4,555250,31090,33244.3,777100
42100,35119.1,1332350,12100,2204.6,555250,30000,32914.5,777100
40210,31635.4,1332350,11310,1900.5,555250,28900,29734.9,777100
38340,28375.3,1332350,10520,1926,555250,27820,26449.3,777100
36510,27493.7,1332350,9740,2000,555250,26770,25493.7,777100
34670,28176.7,1332350,8970,1629.6,555250,25700,26547.1,777100
32800,28849.2,1332350,8190,1436.6,555250,24610,27412.6,777100
30900,27084.1,1332350,7420,1092.1,555250,23480,25992,777100
28990,26645.5,1332350,6660,1036,555250,22330,25609.5,777100
27030,27261,1332350,5860,1327.2,555250,21170,25933.8,777100
25090,27453.5,1332350,5080,1471.7,555250,20010,25981.8,777100
24630,27398.1,1332350,4910,2074.7,555250,19720,25323.4,777100
24040,27061.6,1332350,4730,3888.3,555250,19310,23173.3,777100
23550,25671.9,1332350,4530,4073.1,555250,19020,21598.8,777100
23000,25297.8,1332350,4350,3493.5,555250,18650,21804.3,777100
22540,23435.8,1332350,4190,2827.4,555250,18350,20608.4,777100
22060,24739.4,1332350,3990,2916.8,555250,18070,21822.6,777100
21610,25331.9,1332350,3820,3128.6,555250,17790,22203.3,777100
21120,25415,1332350,3640,3253.7,555250,17480,22161.3,777100
20630,22917.3,1332350,3480,3058.4,555250,17150,19858.9,777100
20220,21993.6,1332350,3280,2865,555250,16940,19128.6,777100
19750,21882.7,1332350,3110,2691,555250,16640,19191.7,777100
19300,22660.3,1332350,2930,3043.8,555250,16370,19616.5,777100
17790,19643.3,1332350,2700,2385.5,555250,15090,17257.8,777100
16250,18409.3,1332350,2490,2533.7,555250,13760,15875.6,777100
14700,14283,1332350,2270,1727.8,555250,12430,12555.2,777100
13250,11379.6,1332350,2080,728.6,555250,11170,10651,777100
11700,8938,1332350,1870,238.2,555250,9830,8699.8,777100
10100,7421.2,1332350,1650,145.4,555250,8450,7275.8,777100
8630,5434.9,1332350,1440,143.5,555250,7190,5291.4,777100
7080,4720.2,1332350,1250,139.4,555250,5830,4580.8,777100
5540,3809.7,1332350,1040,135.9,555250,4500,3673.8,777100
4050,3410.8,1332350,820,151,555250,3230,3259.8,777100
2590,3006.4,1332350,610,136,555250,1980,2870.4,777100
1110,2453.7,1332350,390,149.1,555250,720,2304.6,777100
1180,2202.4,1332350,520,140,555250,660,2062.4,777100
1260,2234.1,1332350,660,178.5,555250,600,2055.6,777100
1350,2207.2,1332350,770,145.4,555250,580,2061.8,777100
1430,2084.8,1332350,900,139.8,555250,530,1945,777100
1470,2547.4,1332350,990,509.5,555250,480,2037.9,777100
1520,3752.3,1332350,1080,1382.5,555250,440,2369.8,777100
1580,5989.7,1332350,1190,2598.7,555250,390,3391,777100
1620,7757.4,1332350,1280,4384.7,555250,340,3372.7,777100
1680,11937.5,1332350,1380,7173.3,555250,300,4764.2,777100
1740,8664.1,1332350,1470,5227.8,555250,270,3436.3,777100
1820,6367.4,1332350,1580,3807.2,555250,240,2560.2,777100
1900,3316.9,1332350,1690,2381.9,555250,210,935,777100
2570,5179.9,1332350,2280,3497,555250,290,1682.9,777100
3250,7412.2,1332350,2880,5161.1,555250,370,2251.1,777100
3930,8521.3,1332350,3480,5715.3,555250,450,2806,777100
4600,4643.9,1332350,4070,3344.3,555250,530,1299.6,777100
5290,3048.8,1332350,4680,1835.7,555250,610,1213.1,777100
5910,2849.8,1332350,5280,1223.4,555250,630,1626.4,777100
6630,1676.9,1332350,5880,427.4,555250,750,1249.5,777100
7350,3409.6,1332350,6490,2292.5,555250,860,1117.1,777100
8050,5585.4,1332350,7140,3911.7,555250,910,1673.7,777100
8790,5154.1,1332350,7790,2392.6,555250,1000,2761.5,777100
9480,3851.4,1332350,8460,786.7,555250,1020,3064.7,777100
10220,4590.3,1332350,9090,1419.6,555250,1130,3170.7,777100
11160,3602.3,1332350,9660,1057.4,555250,1500,2544.9,777100
12070,3978.7,1332350,10250,886.3,555250,1820,3092.4,777100
13010,4631.4,1332350,10800,709,555250,2210,3922.4,777100
13890,6393.2,1332350,11340,2695.3,555250,2550,3697.9,777100
14880,17768.1,1332350,11910,9812,555250,2970,7956.1,777100
15950,40398.1,1332350,12500,15003.6,555250,3450,25394.5,777100
16940,40431.9,1332350,13060,14866,555250,3880,25565.9,777100
17900,44356,1332350,13590,19549.9,555250,4310,24806.1,777100
19300,36977.3,1332350,14260,19915.7,555250,5040,17061.6,777100
20670,36616.8,1332350,14870,19783.3,555250,5800,16833.5,777100
22030,37209.4,1332350,15530,17657.5,555250,6500,19551.9,777100
23360,31087.6,1332350,16160,14695.3,555250,7200,16392.3,777100
25710,21519.7,1332350,17270,10861.1,555250,8440,10658.6,777100
28090,18344.6,1332350,18370,6942.3,555250,9720,11402.3,777100
30380,18108.5,1332350,19520,7075.8,555250,10860,11032.7,777100
32770,17938.9,1332350,20620,8641.3,555250,12150,9297.6,777100
34770,17661.7,1332350,21650,7915.6,555250,13120,9746.1,777100
36760,18104.6,1332350,22690,8655.9,555250,14070,9448.7,777100
38770,18537.9,1332350,23730,8864.4,555250,15040,9673.5,777100
40760,25288.1,1332350,24750,12841.8,555250,16010,12446.3,777100
42940,34348.7,1332350,26010,18517.8,555250,16930,15830.9,777100
45060,35983.6,1332350,27280,19648.5,555250,17780,16335.1,777100
47170,37797.2,1332350,28510,21502.7,555250,18660,16294.5,777100
49320,40758.2,1332350,29770,23433.2,555250,19550,17325,777100
47890,39720,1332350,28810,22031.8,555250,19080,17688.2,777100
46350,37504,1332350,27840,18835.4,555250,18510,18668.6,777100
45010,36564.4,1332350,26870,16721.1,555250,18140,19843.3,777100
42630,38355.1,1332350,23860,19022.5,555250,18770,19332.6,777100
42190,38518.4,1332350,23900,22325.5,555250,18290,16192.9,777100
41710,45184.1,1332350,23880,28129.9,555250,17830,17054.2,777100
41270,44740.1,1332350,23870,29137.6,555250,17400,15602.5,777100
40870,54111.3,1332350,23900,34429.5,555250,16970,19681.8,777100
40280,58930.7,1332350,23810,37033.1,555250,16470,21897.6,777100
39720,48043.9,1332350,23730,30331.2,555250,15990,17712.7,777100
39090,55343.1,1332350,23670,35228.5,555250,15420,20114.6,777100
38580,55348.4,1332350,23620,35164.5,555250,14960,20183.9,777100
36590,55329.3,1332350,22410,34987.5,555250,14180,20341.8,777100
34670,45672.9,1332350,21270,28581.9,555250,13400,17091,777100
32770,50403.1,1332350,20090,30213.9,555250,12680,20189.2,777100
30820,59931.3,1332350,18960,35674.4,555250,11860,24256.9,777100
29010,73034.5,1332350,17830,44237.3,555250,11180,28797.2,777100
27240,70266.4,1332350,16740,41533.8,555250,10500,28732.6,777100
25460,57714.8,1332350,15610,33595.6,555250,9850,24119.2,777100
23630,45544.9,1332350,14530,26396.2,555250,9100,19148.7,777100
21860,39552,1332350,13450,21645.2,555250,8410,17906.8,777100
20120,22755.6,1332350,12370,11491.1,555250,7750,11264.5,777100
18350,19128.1,1332350,11290,10603.3,555250,7060,8524.8,777100
16530,15178.8,1332350,10240,8929.1,555250,6290,6249.7,777100
15630,10725.5,1332350,9630,6072.6,555250,6000,4652.9,777100
14760,7082.7,1332350,9060,3853.3,555250,5700,3229.4,777100
13880,2738.2,1332350,8460,437.6,555250,5420,2300.6,777100
13020,2145.5,1332350,7870,236,555250,5150,1909.5,777100
12110,9621.4,1332350,7290,6090,555250,4820,3531.4,777100
11140,9399.6,1332350,6670,5734.2,555250,4470,3665.4,777100
10220,24718.7,1332350,6070,15375,555250,4150,9343.7,777100
9300,32030.7,1332350,5460,19914.2,555250,3840,12116.5,777100
8380,27636.2,1332350,4880,17179.9,555250,3500,10456.3,777100
7440,13806.5,1332350,4280,6559.1,555250,3160,7247.4,777100
6490,7688.1,1332350,3680,2813.9,555250,2810,4874.2,777100
5540,9293,1332350,3090,3854.1,555250,2450,5438.9,777100
5240,9232.5,1332350,2910,3152.6,555250,2330,6079.9,777100
4930,6750.7,1332350,2750,2191.1,555250,2180,4559.6,777100
4570,8827.7,1332350,2540,3740.4,555250,2030,5087.3,777100
4200,12303.5,1332350,2350,6195.8,555250,1850,6107.7,777100
3780,16798,1332350,2160,9116.7,555250,1620,7681.3,777100
3400,9857.5,1332350,1930,4708.1,555250,1470,5149.4,777100
3040,20359.8,1332350,1730,10391.9,555250,1310,9967.9,777100
2580,24279.9,1332350,1500,12313.3,555250,1080,11966.6,777100
2170,20055.9,1332350,1270,10087,555250,900,9968.9,777100
1750,16315,1332350,1030,8372.7,555250,720,7942.3,777100
1290,12781.2,1332350,800,6475.7,555250,490,6305.5,777100
930,30470.9,1332350,560,16837.2,555250,370,13633.7,777100
2290,41365.9,1332350,1950,23868.7,555250,340,17497.2,777100
3690,39256.5,1332350,3360,23286.7,555250,330,15969.8,777100
5090,56597.8,1332350,4760,33942.6,555250,330,22655.2,777100
6490,38045,1332350,6170,23476.6,555250,320,14568.4,777100
7890,26397.9,1332350,7590,17200.7,555250,300,9197.2,777100
9300,34141.3,1332350,8990,22330.1,555250,310,11811.2,777100
10720,43426.1,1332350,10410,28389.8,555250,310,15036.3,777100
12110,38283,1332350,11810,25691.9,555250,300,12591.1,777100
13620,27718.8,1332350,13320,19277.6,555250,300,8441.2,777100
15120,21052.9,1332350,14850,15810.7,555250,270,5242.2,777100
16660,12202,1332350,16370,10054,555250,290,2148,777100
18170,13503.9,1332350,17870,10945.3,555250,300,2558.6,777100
17480,31163.3,1332350,17120,19213,555250,360,11950.3,777100
16920,31943.7,1332350,16410,21711.1,555250,510,10232.6,777100
16320,19269.4,1332350,15690,14850,555250,630,4419.4,777100
15750,12784.3,1332350,14950,9421.2,555250,800,3363.1,777100
15290,12846.6,1332350,14440,9529.3,555250,850,3317.3,777100
14920,9125.1,1332350,13950,6560.3,555250,970,2564.8,777100
14510,7801.5,1332350,13420,5846.4,555250,1090,1955.1,777100
14110,6160.2,1332350,12920,4167.2,555250,1190,1993,777100
14630,14182.2,1332350,13330,10552.5,555250,1300,3629.7,777100
15180,20004.5,1332350,13760,14440.1,555250,1420,5564.4,777100
15750,15415.5,1332350,14170,11580.5,555250,1580,3835,777100
16320,6977.8,1332350,14610,3973.8,555250,1710,3004,777100
18740,16918,1332350,16380,11998.9,555250,2360,4919.1,777100
21170,24703.1,1332350,18140,19062.8,555250,3030,5640.3,777100
23600,24727.7,1332350,19900,18488.9,555250,3700,6238.8,777100
26070,14782.3,1332350,21700,12506.6,555250,4370,2275.7,777100
28560,10975.2,1332350,23420,7879.9,555250,5140,3095.3,777100
31050,15671.2,1332350,25160,11426.5,555250,5890,4244.7,777100
33460,16889.9,1332350,26860,12801.7,555250,6600,4088.2,777100
36000,65630.2,1332350,28580,44391.2,555250,7420,21239,777100
36860,75314.8,1332350,28410,41574.6,555250,8450,33740.2,777100
37560,70355.9,1332350,28170,29668.5,555250,9390,40687.4,777100
38340,44074.7,1332350,28000,18546.9,555250,10340,25527.8,777100
39160,35643.6,1332350,27830,15457,555250,11330,20186.6,777100
38660,40651.1,1332350,26870,15448.1,555250,11790,25203,777100
38240,35290.3,1332350,25970,11173.2,555250,12270,24117.1,777100
37870,18114,1332350,25050,3406,555250,12820,14708,777100
37370,13304.1,1332350,24110,3588.1,555250,13260,9716,777100
37030,7406.9,1332350,23530,1802.2,555250,13500,5604.7,777100
36770,7674.5,1332350,22980,980.8,555250,13790,6693.7,777100
36450,7554.1,1332350,22390,1540.5,555250,14060,6013.6,777100
36170,7012.2,1332350,21830,1481.7,555250,14340,5530.5,777100
37660,9327.3,1332350,23070,893.1,555250,14590,8434.2,777100
39190,9034.4,1332350,24290,1242.6,555250,14900,7791.8,777100
40650,8455.2,1332350,25530,1514.4,555250,15120,6940.8,777100
42180,8084.3,1332350,26760,2779.8,555250,15420,5304.5,777100
40540,8770.2,1332350,25310,4750.2,555250,15230,4020,777100
38950,7803.8,1332350,23860,4762.5,555250,15090,3041.3,777100
37400,15766,1332350,22440,8531.4,555250,14960,7234.6,777100
35420,36323.1,1332350,19820,16623.1,555250,15600,19700,777100
40960,60017,1332350,23880,29724.1,555250,17080,30292.9,777100
46520,104570.4,1332350,27930,55984.4,555250,18590,48586,777100
52060,231581.6,1332350,31990,129313,555250,20070,102268.6,777100
57540,308613.2,1332350,36050,170754,555250,21490,137859.2,777100
63910,289767.6,1332350,40630,157185.4,555250,23280,132582.2,777100
70320,261765.8,1332350,45250,142297.5,555250,25070,119468.3,777100
76660,237664.6,1332350,49860,126024.7,555250,26800,111639.9,777100
83030,181601.5,1332350,54470,89378.3,555250,28560,92223.2,777100
80980,155883,1332350,52530,75008.7,555250,28450,80874.3,777100
79000,162069.6,1332350,50590,86547.2,555250,28410,75522.4,777100
77010,168396.1,1332350,48640,88257.4,555250,28370,80138.7,777100
74960,176217.2,1332350,46710,90230.4,555250,28250,85986.8,777100
72550,164609.2,1332350,44400,77689.8,555250,28150,86919.4,777100
70160,93448.5,1332350,42090,38916.1,555250,28070,54532.4,777100
67690,121112.7,1332350,39790,30701.3,555250,27900,90411.4,777100
65290,168026.8,1332350,37450,62469,555250,27840,105557.8,777100
65220,206116.8,1332350,36770,88344.2,555250,28450,117772.6,777100
65140,267865.5,1332350,36020,129526.6,555250,29120,138338.9,777100
65010,249746.8,1332350,35320,119951.5,555250,29690,129795.3,777100
64950,197875,1332350,34590,89174,555250,30360,108701,777100
62520,160540.2,1332350,32440,76836.1,555250,30080,83704.1,777100
60090,130183.7,1332350,30320,62908.6,555250,29770,67275.1,777100
57650,125790,1332350,28180,61564.6,555250,29470,64225.4,777100
55150,160495.2,1332350,26040,80559,555250,29110,79936.2,777100
54250,220317.2,1332350,24620,108157.5,555250,29630,112159.7,777100
53320,310530.8,1332350,23210,159562.4,555250,30110,150968.4,777100
52330,327139.9,1332350,21770,166342.5,555250,30560,160797.4,777100
51410,255717.4,1332350,20350,123233.3,555250,31060,132484.1,777100
49950,157838,1332350,19100,69758.1,555250,30850,88079.9,777100
48480,134974.4,1332350,17860,64475.8,555250,30620,70498.6,777100
47080,116529.9,1332350,16620,55216.5,555250,30460,61313.4,777100
45540,93682.8,1332350,15360,42526.3,555250,30180,51156.5,777100
46970,66813,1332350,18640,30160.9,555250,28330,36652.1,777100
48350,82742.3,1332350,21900,42126.4,555250,26450,40615.9,777100
49760,111737.1,1332350,25180,62266.2,555250,24580,49470.9,777100
51170,137639.3,1332350,28450,78906.5,555250,22720,58732.8,777100
52720,108806.8,1332350,31670,64625.3,555250,21050,44181.5,777100
54380,96263.3,1332350,34920,59829.3,555250,19460,36434,777100
56010,53020.6,1332350,38170,37275.5,555250,17840,15745.1,777100
57560,51085.2,1332350,41430,38008.3,555250,16130,13076.9,777100
59490,38428.6,1332350,44850,32759.4,555250,14640,5669.2,777100
61450,40599.4,1332350,48280,35086.9,555250,13170,5512.5,777100
63320,33998.7,1332350,51720,30651.9,555250,11600,3346.8,777100
65230,27362.6,1332350,55120,24654.1,555250,10110,2708.5,777100
65220,27476,1332350,54220,24719.9,555250,11000,2756.1,777100
65310,32782.5,1332350,53300,28995.7,555250,12010,3786.8,777100
65230,39154.4,1332350,52370,35000,555250,12860,4154.4,777100
65180,47257.1,1332350,51440,40921.7,555250,13740,6335.4,777100
65590,74279.4,1332350,50490,56085.3,555250,15100,18194.1,777100
65990,82143.3,1332350,49550,58756.5,555250,16440,23386.8,777100
66400,88171.4,1332350,48580,60834.5,555250,17820,27336.9,777100
66750,80498.8,1332350,47640,57263.2,555250,19110,23235.6,777100
67770,96084.7,1332350,47420,65712.2,555250,20350,30372.5,777100
68800,103408.3,1332350,47220,69340.7,555250,21580,34067.6,777100
69820,107435,1332350,47020,69216.3,555250,22800,38218.7,777100
70810,99927.5,1332350,46800,64363,555250,24010,35564.5,777100
73840,109337.8,1332350,48940,72028.7,555250,24900,37309.1,777100
76820,141296,1332350,51050,91423.5,555250,25770,49872.5,777100
79840,146705.5,1332350,53180,95275.8,555250,26660,51429.7,777100
82880,166243.2,1332350,55290,106333.1,555250,27590,59910.1,777100
86860,209548.2,1332350,58090,123873.9,555250,28770,85674.3,777100
90870,192800.8,1332350,60900,116114.6,555250,29970,76686.2,777100
94850,158908.7,1332350,63680,105333.9,555250,31170,53574.8,777100
98830,129646.3,1332350,66480,88184.2,555250,32350,41462.1,777100
101350,127918.9,1332350,67860,87322.5,555250,33490,40596.4,777100
103820,159876.3,1332350,69220,106182,555250,34600,53694.3,777100
106390,145557.2,1332350,70600,99524.5,555250,35790,46032.7,777100
108890,153344.5,1332350,71940,102974.3,555250,36950,50370.2,777100
111020,188213.7,1332350,73910,122579.7,555250,37110,65634,777100
113150,187704.3,1332350,75880,122641,555250,37270,65063.3,777100
115300,199339,1332350,77840,130821.5,555250,37460,68517.5,777100
117470,129373.1,1332350,79820,89376.2,555250,37650,39996.9,777100
120390,108177.6,1332350,82750,78034.1,555250,37640,30143.5,777100
123420,244413.1,1332350,85700,160090.9,555250,37720,84322.2,777100
126430,185324.2,1332350,88630,126478.2,555250,37800,58846,777100
129460,171117.1,1332350,91550,119728.2,555250,37910,51388.9,777100
131050,141034.8,1332350,93380,103759.1,555250,37670,37275.7,777100
132570,71241.5,1332350,95200,62380.2,555250,37370,8861.3,777100
134180,111672.4,1332350,97030,88719.6,555250,37150,22952.8,777100
135740,167516.4,1332350,98840,123053.9,555250,36900,44462.5,777100
135540,141024.3,1332350,99140,108959,555250,36400,32065.3,777100
135430,147574.1,1332350,99440,113579.8,555250,35990,33994.3,777100
135260,146333.2,1332350,99730,113192.2,555250,35530,33141,777100
135080,103434.2,1332350,100020,87522.6,555250,35060,15911.6,777100
134330,81908.2,1332350,100450,74155.3,555250,33880,7752.9,777100
133580,73417.6,1332350,100870,68176.2,555250,32710,5241.4,777100
132830,57985,1332350,101290,54805.5,555250,31540,3179.5,777100
132060,47107.7,1332350,101710,44944.5,555250,30350,2163.2,777100
131590,40672.5,1332350,101980,38803.7,555250,29610,1868.8,777100
131110,35753.4,1332350,102260,34091.2,555250,28850,1662.2,777100
130550,41031.5,1332350,102520,39201.5,555250,28030,1830,777100
130090,53436.7,1332350,102800,51491.7,555250,27290,1945,777100
129420,63576.6,1332350,102290,60879.8,555250,27130,2696.8,777100
128770,81761.1,1332350,101820,76240.2,555250,26950,5520.9,777100
128070,83899.8,1332350,101360,77776.7,555250,26710,6123.1,777100
89550,73065.6,1332350,77300,66713.3,555250,12250,6352.3,777100
88090,65370.2,1332350,76600,59997.2,555250,11490,5373,777100
86670,68625.5,1332350,75910,62644.7,555250,10760,5980.8,777100
85210,61362.4,1332350,75200,55459.4,555250,10010,5903,777100
83750,74798.4,1332350,74480,64803.2,555250,9270,9995.2,777100
83460,80168,1332350,74900,68011.4,555250,8560,12156.6,777100
83140,68094.7,1332350,75320,58707.9,555250,7820,9386.8,777100
82860,44561.7,1332350,75700,36569.9,555250,7160,7991.8,777100
82550,50798.2,1332350,76100,43370.3,555250,6450,7427.9,777100
79580,50624.6,1332350,73300,43546.2,555250,6280,7078.4,777100
76660,34538.2,1332350,70530,27337.7,555250,6130,7200.5,777100
73720,30807.1,1332350,67720,22001.9,555250,6000,8805.2,777100
70750,31705.6,1332350,64930,21338.3,555250,5820,10367.3,777100
67700,35797.6,1332350,62040,24251.3,555250,5660,11546.3,777100
64620,33881.5,1332350,59140,21138.5,555250,5480,12743,777100
61520,35180.7,1332350,56230,21939.3,555250,5290,13241.4,777100
58480,36885.8,1332350,53340,23546.5,555250,5140,13339.3,777100
54090,33123,1332350,49220,19631.7,555250,4870,13491.3,777100
49620,32638.4,1332350,45080,19367.4,555250,4540,13271,777100
45230,41673,1332350,40980,26247.2,555250,4250,15425.8,777100
40830,69024.2,1332350,36860,41555.8,555250,3970,27468.4,777100
39490,123797.6,1332350,34420,72817.8,555250,5070,50979.8,777100
38180,173701.9,1332350,31990,99621.2,555250,6190,74080.7,777100
36900,211014.1,1332350,29530,120120.9,555250,7370,90893.2,777100
35560,227767.5,1332350,27080,130065.6,555250,8480,97701.9,777100
34340,227318.4,1332350,24670,126718.6,555250,9670,100599.8,777100
32960,217878.6,1332350,22210,119388.8,555250,10750,98489.8,777100
31660,144385.8,1332350,19750,72331.3,555250,11910,72054.5,777100
30320,99120.1,1332350,17330,43602.6,555250,12990,55517.5,777100
29160,87756.3,1332350,14880,33340.2,555250,14280,54416.1,777100
28040,87619.5,1332350,12480,31396.1,555250,15560,56223.4,777100
27010,84845.5,1332350,10070,28117.8,555250,16940,56727.7,777100
25880,104355.8,1332350,7670,37927,555250,18210,66428.8,777100
28430,110723.4,1332350,10090,45683.7,555250,18340,65039.7,777100
31090,104864.9,1332350,12560,45917,555250,18530,58947.9,777100
33650,99798.5,1332350,14980,44396.9,555250,18670,55401.6,777100
36250,92561.6,1332350,17440,40065.9,555250,18810,52495.7,777100
39140,89751.6,1332350,20210,40966.1,555250,18930,48785.5,777100
42070,82676.5,1332350,23050,39900.4,555250,19020,42776.1,777100
45000,78317.1,1332350,25860,40318.2,555250,19140,37998.9,777100
47930,66018,1332350,28690,34291.7,555250,19240,31726.3,777100
51350,64653.1,1332350,31710,34804.4,555250,19640,29848.7,777100
54750,70272.7,1332350,34710,38461.4,555250,20040,31811.3,777100
58090,57850.5,1332350,37700,32389.1,555250,20390,25461.4,777100
61540,43193.7,1332350,40730,25046.8,555250,20810,18146.9,777100
62180,38203.4,1332350,39850,18148.9,555250,22330,20054.5,777100
62840,48659.8,1332350,38990,21287,555250,23850,27372.8,777100
63460,72539.8,1332350,38080,31382.3,555250,25380,41157.5,777100
64050,89604.5,1332350,37220,40729.1,555250,26830,48875.4,777100
64440,114652.5,1332350,35990,50998,555250,28450,63654.5,777100
64700,122910.5,1332350,34780,51174.6,555250,29920,71735.9,777100
64940,156199.5,1332350,33550,71939.6,555250,31390,84259.9,777100
65190,164347.1,1332350,32320,71818,555250,32870,92529.1,777100
65920,149787.9,1332350,31500,65079.2,555250,34420,84708.7,777100
66600,132541,1332350,30650,57104.8,555250,35950,75436.2,777100
67330,129948.9,1332350,29820,57593.6,555250,37510,72355.3,777100
68010,174465.8,1332350,28980,81956.7,555250,39030,92509.1,777100
71490,219906.3,1332350,32970,110321.8,555250,38520,109584.5,777100
74910,229950.1,1332350,36950,119617.2,555250,37960,110332.9,777100
78280,202241.4,1332350,40920,104914.8,555250,37360,97326.6,777100
81710,182175.5,1332350,44870,95189.1,555250,36840,86986.4,777100
84670,167881.3,1332350,48330,88871.4,555250,36340,79009.9,777100
87630,156678.3,1332350,51790,84565.4,555250,35840,72112.9,777100
90540,147630.5,1332350,55240,81480.4,555250,35300,66150.1,777100
93530,146554.6,1332350,58730,80645.6,555250,34800,65909,777100
96340,131177.2,1332350,62240,74075,555250,34100,57102.2,777100
99180,121393.1,1332350,65770,69519.5,555250,33410,51873.6,777100
102050,134841.9,1332350,69300,81058.8,555250,32750,53783.1,777100
104970,112667.4,1332350,72840,69240.5,555250,32130,43426.9,777100
99620,117760.2,1332350,69050,71518.2,555250,30570,46242,777100
94300,137953.8,1332350,65250,84260.2,555250,29050,53693.6,777100
88940,157780.3,1332350,61480,93956,555250,27460,63824.3,777100
83630,148991,1332350,57660,89465.7,555250,25970,59525.3,777100
78070,170236,1332350,53850,101086.7,555250,24220,69149.3,777100
72490,162912.2,1332350,49980,98642.9,555250,22510,64269.3,777100
66940,128483.7,1332350,46130,78049.7,555250,20810,50434,777100
61270,111282.2,1332350,42280,67367,555250,18990,43915.2,777100
55690,143417.6,1332350,38490,85806.1,555250,17200,57611.5,777100
50130,138999.5,1332350,34710,84573.7,555250,15420,54425.8,777100
44390,122885.2,1332350,30890,75668.5,555250,13500,47216.7,777100
38760,198967.5,1332350,27100,120242.4,555250,11660,78725.1,777100
36840,199782.9,1332350,26040,120844.3,555250,10800,78938.6,777100
34950,211092.9,1332350,25010,128343.6,555250,9940,82749.3,777100
33080,245918.2,1332350,23960,148709.2,555250,9120,97209,777100
31110,273245.1,1332350,22900,164459.8,555250,8210,108785.3,777100
29530,211410.1,1332350,21960,128773.4,555250,7570,82636.7,777100
27950,177339.8,1332350,21000,108495.9,555250,6950,68843.9,777100
26380,128778,1332350,20060,79617.2,555250,6320,49160.8,777100
24750,100078.4,1332350,19100,63037,555250,5650,37041.4,777100
23620,98297.3,1332350,18440,61947.1,555250,5180,36350.2,777100
22470,98510.6,1332350,17790,62129.3,555250,4680,36381.3,777100
21380,91976.7,1332350,17140,58465.5,555250,4240,33511.2,777100
20230,110106.4,1332350,16490,69087.5,555250,3740,41018.9,777100
21460,105349.9,1332350,15940,65754.3,555250,5520,39595.6,777100
22640,87014.1,1332350,15340,54505.9,555250,7300,32508.2,777100
23790,79158,1332350,14790,48881.2,555250,9000,30276.8,777100
41610,66295.8,1332350,32090,47236.2,555250,9520,19059.6,777100
41640,56973.8,1332350,30610,41429.4,555250,11030,15544.4,777100
41660,53544.8,1332350,29140,38476.1,555250,12520,15068.7,777100
41630,43470.8,1332350,27630,31266.6,555250,14000,12204.2,777100
41590,33132.7,1332350,26140,23851.5,555250,15450,9281.2,777100
41190,24413.1,1332350,24320,16379.3,555250,16870,8033.8,777100
40740,18239.8,1332350,22470,11152.5,555250,18270,7087.3,777100
40290,16929.8,1332350,20650,8590.8,555250,19640,8339,777100
39860,18831.8,1332350,18810,7102,555250,21050,11729.8,777100
41650,26949.5,1332350,18330,9237.6,555250,23320,17711.9,777100
43330,36305.2,1332350,17850,12710.6,555250,25480,23594.6,777100
45100,39460.5,1332350,17350,12033.1,555250,27750,27427.4,777100
46740,42025.2,1332350,16870,11297.6,555250,29870,30727.6,777100
49160,51307.3,1332350,16630,14513.3,555250,32530,36794,777100
51640,56337.7,1332350,16440,15846.3,555250,35200,40491.4,777100
54140,64533.3,1332350,16210,19070.8,555250,37930,45462.5,777100
56600,62467.2,1332350,15990,16992.9,555250,40610,45474.3,777100
59310,63014.1,1332350,15780,16015.1,555250,43530,46999,777100
62040,72632.2,1332350,15560,17190.5,555250,46480,55441.7,777100
64760,98486.2,1332350,15350,27550.4,555250,49410,70935.8,777100
67470,119967.8,1332350,15130,39601.5,555250,52340,80366.3,777100
70290,116433.7,1332350,15720,35349.5,555250,54570,81084.2,777100
73100,87207.4,1332350,16310,16879.1,555250,56790,70328.3,777100
75900,93997,1332350,16900,19436.1,555250,59000,74560.9,777100
78670,101787.3,1332350,17490,19745.1,555250,61180,82042.2,777100
81310,110897.5,1332350,18730,23602.8,555250,62580,87294.7,777100
83860,133818.1,1332350,19950,30034.9,555250,63910,103783.2,777100
86480,205983.1,1332350,21160,67092.8,555250,65320,138890.3,777100
89140,189199,1332350,22400,59034,555250,66740,130165,777100
91520,151942.1,1332350,24660,36607.9,555250,66860,115334.2,777100
94050,147715.7,1332350,26950,35095.4,555250,67100,112620.3,777100
96500,127421.3,1332350,29200,28302.4,555250,67300,99118.9,777100
98990,116916.5,1332350,31490,27443.1,555250,67500,89473.4,777100
94060,149814.7,1332350,28270,42825,555250,65790,106989.7,777100
89140,172744.7,1332350,25030,47888,555250,64110,124856.7,777100
84210,175159.2,1332350,21810,45227.4,555250,62400,129931.8,777100
79270,238028.5,1332350,18580,79672.6,555250,60690,158355.9,777100
74550,282216.4,1332350,16510,104241.8,555250,58040,177974.6,777100
69820,242230.1,1332350,14410,80940.3,555250,55410,161289.8,777100
65100,252914.8,1332350,12330,76670.5,555250,52770,176244.3,777100
60370,250928.5,1332350,10250,74136,555250,50120,176792.5,777100
56510,197196.8,1332350,9120,45061.9,555250,47390,152134.9,777100
52580,138867.4,1332350,7960,27509,555250,44620,111358.4,777100
48700,69974.9,1332350,6830,6852,555250,41870,63122.9,777100
44870,52024.6,1332350,5670,1636.8,555250,39200,50387.8,777100
46350,39729.6,1332350,6240,782.5,555250,40110,38947.1,777100
47900,50244.3,1332350,6790,2948.4,555250,41110,47295.9,777100
49420,62430.3,1332350,7340,9793.6,555250,42080,52636.7,777100
50890,58648.8,1332350,7860,9071,555250,43030,49577.8,777100
53330,62231.8,1332350,8350,14121.5,555250,44980,48110.3,777100
55770,65840.5,1332350,8790,17183.2,555250,46980,48657.3,777100
58230,61294.5,1332350,9260,14527.1,555250,48970,46767.4,777100
60680,68624.9,1332350,9710,12531.5,555250,50970,56093.4,777100
62440,88677.6,1332350,10410,18315,555250,52030,70362.6,777100
64340,102585.9,1332350,11100,27359.8,555250,53240,75226.1,777100
66070,113645.2,1332350,11800,32227.9,555250,54270,81417.3,777100
67870,118702.7,1332350,12450,33177.7,555250,55420,85525,777100
65290,129772.6,1332350,11870,42696.5,555250,53420,87076.1,777100
62710,122141.4,1332350,11270,40583.6,555250,51440,81557.8,777100
60140,124808.5,1332350,10650,43966.9,555250,49490,80841.6,777100
57530,124944.2,1332350,10040,42929.5,555250,47490,82014.7,777100
54190,117069.3,1332350,9350,42128.3,555250,44840,74941,777100
50930,92636.5,1332350,8690,32042.7,555250,42240,60593.8,777100
47550,68952.4,1332350,7980,17964.6,555250,39570,50987.8,777100
44220,57954.9,1332350,7300,11618.4,555250,36920,46336.5,777100
40970,58162.2,1332350,6680,11434.8,555250,34290,46727.4,777100
37650,52809.2,1332350,6080,10172.1,555250,31570,42637.1,777100
34360,50230,1332350,5470,9456.7,555250,28890,40773.3,777100
31010,45831.3,1332350,4850,8501.7,555250,26160,37329.6,777100
29270,39504.6,1332350,4560,7025.3,555250,24710,32479.3,777100
27340,34879.3,1332350,4210,6433.8,555250,23130,28445.5,777100
25440,33783.9,1332350,3890,7182.9,555250,21550,26601,777100
23630,34439.4,1332350,3570,8875.7,555250,20060,25563.7,777100
21670,30097.9,1332350,3290,5002.6,555250,18380,25095.3,777100
19650,24649.9,1332350,2960,6259.5,555250,16690,18390.4,777100
17680,21916.9,1332350,2690,6172.9,555250,14990,15744,777100
15630,21006.7,1332350,2380,6059.7,555250,13250,14947,777100
13950,18169.7,1332350,2120,4425.3,555250,11830,13744.4,777100
12260,13356.4,1332350,1850,2302.4,555250,10410,11054,777100
10630,9527,1332350,1570,1668.6,555250,9060,7858.4,777100
8960,13964.4,1332350,1320,4492.9,555250,7640,9471.5,777100
9610,11730.2,1332350,1390,3956.3,555250,8220,7773.9,777100
10270,8640.3,1332350,1480,1822.1,555250,8790,6818.2,777100
10920,11765.5,1332350,1560,3661.2,555250,9360,8104.3,777100
11610,15647.8,1332350,1630,5900.7,555250,9980,9747.1,777100
11900,13584.6,1332350,1790,4650.5,555250,10110,8934.1,777100
12150,10047.4,1332350,1950,2360.2,555250,10200,7687.2,777100
12460,8397.5,1332350,2120,1421.4,555250,10340,6976.1,777100
12760,18253.8,1332350,2280,8076.4,555250,10480,10177.4,777100
12360,15244.4,1332350,2240,6774.4,555250,10120,8470,777100
11920,11808.7,1332350,2200,4982.6,555250,9720,6826.1,777100
11510,11289.4,1332350,2180,4990.3,555250,9330,6299.1,777100
11120,16370.9,1332350,2120,7999.2,555250,9000,8371.7,777100
10550,15275.1,1332350,2040,7333.7,555250,8510,7941.4,777100
10020,18348.2,1332350,1960,9088.7,555250,8060,9259.5,777100
9480,13525.9,1332350,1900,6304.9,555250,7580,7221,777100
23090,10055.9,1332350,6870,2259.7,555250,16220,7796.2,777100
22400,10946.4,1332350,6720,2331.5,555250,15680,8614.9,777100
21600,9677.8,1332350,6540,1255.5,555250,15060,8422.3,777100
20900,21895.2,1332350,6360,2158.9,555250,14540,19736.3,777100
20160,29043.8,1332350,6200,1301,555250,13960,27742.8,777100
19480,16302.8,1332350,5960,805.9,555250,13520,15496.9,777100
18840,21698.6,1332350,5710,2650.4,555250,13130,19048.2,777100
18170,26186.5,1332350,5450,6065.1,555250,12720,20121.4,777100
17530,30737.4,1332350,5220,6692.3,555250,12310,24045.1,777100
17370,25394.8,1332350,5010,5230.7,555250,12360,20164.1,777100
17160,17781.9,1332350,4830,2981.7,555250,12330,14800.2,777100
17020,14716.6,1332350,4650,2567.4,555250,12370,12149.2,777100
16860,20924.5,1332350,4430,6419.3,555250,12430,14505.2,777100
16730,45853.6,1332350,4290,19388.2,555250,12440,26465.4,777100
16630,45580.4,1332350,4170,18039,555250,12460,27541.4,777100
16580,36986.6,1332350,4050,10421.3,555250,12530,26565.3,777100
16470,35609,1332350,3890,8498.3,555250,12580,27110.7,777100
16440,30340.6,1332350,3780,4113.6,555250,12660,26227,777100
16390,25754.5,1332350,3650,3189.9,555250,12740,22564.6,777100
16300,23158.3,1332350,3520,2238.3,555250,12780,20920,777100
16270,21247.2,1332350,3410,1232.7,555250,12860,20014.5,777100
17870,26058.5,1332350,4270,1980,555250,13600,24078.5,777100
19320,29913.7,1332350,5040,3084.3,555250,14280,26829.4,777100
20860,35363.2,1332350,5860,3345.5,555250,15000,32017.7,777100
22430,35757.7,1332350,6690,3652.3,555250,15740,32105.4,777100
24100,36781.8,1332350,7550,3667.7,555250,16550,33114.1,777100
25710,43092.7,1332350,8420,5150.1,555250,17290,37942.6,777100
27260,48840.9,1332350,9280,5192.8,555250,17980,43648.1,777100
28960,50443.1,1332350,10180,5099.1,555250,18780,45344,777100
30460,48955.7,1332350,10860,4894.6,555250,19600,44061.1,777100
32000,48220,1332350,11550,4626.3,555250,20450,43593.7,777100
33450,43478.2,1332350,12230,3418.1,555250,21220,40060.1,777100
34950,38544.8,1332350,12900,2490.5,555250,22050,36054.3,777100
37150,30416.3,1332350,14980,1902.2,555250,22170,28514.1,777100
39290,28797.6,1332350,16990,2104.5,555250,22300,26693.1,777100
41470,51381.5,1332350,19040,13151,555250,22430,38230.5,777100
43730,172368.1,1332350,21100,75466.8,555250,22630,96901.3,777100
46410,164168.6,1332350,23260,66861.2,555250,23150,97307.4,777100
49070,126189.2,1332350,25410,35780.3,555250,23660,90408.9,777100
51700,127343.2,1332350,27580,47647.9,555250,24120,79695.3,777100
54380,148023,1332350,29760,76605.6,555250,24620,71417.4,777100
58150,129025,1332350,31880,74280,555250,26270,54745,777100
62010,143914,1332350,34010,81588.4,555250,28000,62325.6,777100
65800,267967.9,1332350,36120,155863.9,555250,29680,112104,777100
69550,195724.2,1332350,38230,112842.7,555250,31320,82881.5,777100
85720,204738.7,1332350,48010,124611.9,555250,37710,80126.8,777100
101840,175288.5,1332350,57770,107534.9,555250,44070,67753.6,777100
117980,118994.2,1332350,67540,70531.7,555250,50440,48462.5,777100
134090,103592,1332350,77300,61986.9,555250,56790,41605.1,777100
138540,110610.5,1332350,75800,63374,555250,62740,47236.5,777100
142930,134352.1,1332350,74280,75877.8,555250,68650,58474.3,777100
147440,105908.9,1332350,72790,56091.6,555250,74650,49817.3,777100
151820,75580,1332350,71290,37487.7,555250,80530,38092.3,777100
157140,46900.6,1332350,78150,17916.9,555250,78990,28983.7,777100
162500,39534.2,1332350,85060,9574.6,555250,77440,29959.6,777100
167900,49087.7,1332350,91910,17108,555250,75990,31979.7,777100
173250,52062.6,1332350,98810,21347.3,555250,74440,30715.3,777100
161240,58685.5,1332350,91260,25881.7,555250,69980,32803.8,777100
149330,33714.7,1332350,83720,8510.1,555250,65610,25204.6,777100
137390,31385.6,1332350,76160,8476.4,555250,61230,22909.2,777100
125420,27008.5,1332350,68610,6681.2,555250,56810,20327.3,777100
122930,25694.1,1332350,67940,4923.8,555250,54990,20770.3,777100
120390,22709.6,1332350,67270,2549.2,555250,53120,20160.4,777100
117950,19671.5,1332350,66640,1466,555250,51310,18205.5,777100
115410,19147.6,1332350,65990,1775.9,555250,49420,17371.7,777100
116270,22059.3,1332350,67000,3720.3,555250,49270,18339,777100
117120,19582.3,1332350,68060,4071.3,555250,49060,15511,777100
117860,19688.2,1332350,69090,6382.2,555250,48770,13306,777100
118700,14869.8,1332350,70130,3616.3,555250,48570,11253.5,777100
120610,12395.4,1332350,72270,2773.8,555250,48340,9621.6,777100
122480,9749.7,1332350,74410,1607.5,555250,48070,8142.2,777100
124350,6726.2,1332350,76530,176.4,555250,47820,6549.8,777100
126290,5855,1332350,78680,147.2,555250,47610,5707.8,777100
129960,4992.4,1332350,82370,246.9,555250,47590,4745.5,777100
133670,4415,1332350,86030,171.2,555250,47640,4243.8,777100
137370,4067.6,1332350,89680,605.6,555250,47690,3462,777100
141030,6393.9,1332350,93360,3183.5,555250,47670,3210.4,777100
147150,6511.7,1332350,99110,3530.8,555250,48040,2980.9,777100
153290,6999.5,1332350,104850,4601.2,555250,48440,2398.3,777100
159430,23139.6,1332350,110620,19552.3,555250,48810,3587.3,777100
165550,53062.1,1332350,116350,47258.3,555250,49200,5803.8,777100
170930,113012.6,1332350,116850,89676.5,555250,54080,23336.1,777100
176260,158017.7,1332350,117310,113877.5,555250,58950,44140.2,777100
181650,197197.4,1332350,117820,131490.8,555250,63830,65706.6,777100
186930,208035,1332350,118320,134547.4,555250,68610,73487.6,777100
180930,159664.9,1332350,107030,95251.2,555250,73900,64413.7,777100
174870,156555.6,1332350,95750,83399.1,555250,79120,73156.5,777100
168790,195017.6,1332350,84460,95170.4,555250,84330,99847.2,777100
162800,313157.1,1332350,73160,151889.9,555250,89640,161267.2,777100
165680,160441.4,1332350,73080,50768.5,555250,92600,109672.9,777100
168610,124092.7,1332350,72970,25894.5,555250,95640,98198.2,777100
171530,227290.8,1332350,72900,82679.4,555250,98630,144611.4,777100
174420,305493.4,1332350,72810,129190.9,555250,101610,176302.5,777100
173880,304953,1332350,74500,102603.9,555250,99380,202349.1,777100
173400,343903.7,1332350,76210,138386.6,555250,97190,205517.1,777100
172950,391481.7,1332350,77930,172205.9,555250,95020,219275.8,777100
448410,306846.7,1332350,206630,130325,555250,241780,176521.7,777100
468220,332624.7,1332350,220080,149228.6,555250,248140,183396.1,777100
488020,408663.2,1332350,233580,205637.4,555250,254440,203025.8,777100
507760,455011.5,1332350,247030,248105.3,555250,260730,206906.2,777100
527550,504295.2,1332350,260510,275855.1,555250,267040,228440.1,777100
556650,543793.1,1332350,282260,297694.3,555250,274390,246098.8,777100
585750,746203.6,1332350,304000,422106.2,555250,281750,324097.4,777100
614830,789226.7,1332350,325730,452195.2,555250,289100,337031.5,777100
643910,675421,1332350,347480,394726.9,555250,296430,280694.1,777100
655430,688187.5,1332350,357430,404790.7,555250,298000,283396.8,777100
666950,805406.9,1332350,367380,471460.2,555250,299570,333946.7,777100
678470,853871.8,1332350,377340,505241.5,555250,301130,348630.3,777100
689920,861322.3,1332350,387270,509829.3,555250,302650,351493,777100
697200,876238.4,1332350,393470,521889.2,555250,303730,354349.2,777100
704500,851795.3,1332350,399670,508914.2,555250,304830,342881.1,777100
711750,836871.3,1332350,405850,506651.5,555250,305900,330219.8,777100
719040,810767.7,1332350,412050,491356.7,555250,306990,319411,777100
721390,817478.1,1332350,413110,489009.8,555250,308280,328468.3,777100
723710,791215,1332350,414140,475861.5,555250,309570,315353.5,777100
726040,756501.1,1332350,415200,464841.8,555250,310840,291659.3,777100
728370,758346.1,1332350,416240,468842.4,555250,312130,289503.7,777100
709470,720140.3,1332350,408160,453488.6,555250,301310,266651.7,777100
690700,727671.4,1332350,400120,463974.3,555250,290580,263697.1,777100
671800,715114.8,1332350,392040,459741.6,555250,279760,255373.2,777100
652850,703309.8,1332350,383940,454277,555250,268910,249032.8,777100
630480,721748,1332350,374460,466696.6,555250,256020,255051.4,777100
608190,709436.6,1332350,365020,458682.1,555250,243170,250754.5,777100
585890,685017.8,1332350,355560,448474.3,555250,230330,236543.5,777100
563440,681694.2,1332350,346110,447127.9,555250,217330,234566.3,777100
540340,653581.7,1332350,336940,436126.6,555250,203400,217455.1,777100
517300,647841.2,1332350,327770,433391.3,555250,189530,214449.9,777100
494210,641161.3,1332350,318590,431131,555250,175620,210030.3,777100
471090,604808.9,1332350,309420,411143.1,555250,161670,193665.8,777100
460420,573048.5,1332350,305060,393656.1,555250,155360,179392.4,777100
449660,536088.8,1332350,300720,374636.9,555250,148940,161451.9,777100
439050,536698.9,1332350,296390,375420.6,555250,142660,161278.3,777100
428320,533748.7,1332350,292050,371753.8,555250,136270,161994.9,777100
415090,568038,1332350,286900,392881.4,555250,128190,175156.6,777100
401980,558311.7,1332350,281770,386951.6,555250,120210,171360.1,777100
388770,520790.6,1332350,276600,368485.7,555250,112170,152304.9,777100
375610,491641.8,1332350,271500,352291.2,555250,104110,139350.6,777100
363360,473723.7,1332350,267690,345567,555250,95670,128156.7,777100
351140,440742.9,1332350,263890,328505.8,555250,87250,112237.1,777100
338900,415805.7,1332350,260080,316071.4,555250,78820,99734.3,777100
326580,399159.1,1332350,256270,308016.5,555250,70310,91142.6,777100
315490,411121.6,1332350,247950,313873.5,555250,67540,97248.1,777100
304480,425407.1,1332350,239670,320800,555250,64810,104607.1,777100
293310,398217,1332350,231350,302027.3,555250,61960,96189.7,777100
282210,300708.5,1332350,223050,241912.7,555250,59160,58795.8,777100
271780,252831.9,1332350,215370,209834.4,555250,56410,42997.5,777100
261430,224181.7,1332350,207720,191793.3,555250,53710,32388.4,777100
251040,211335.6,1332350,200080,181160.1,555250,50960,30175.5,777100
240720,203233.9,1332350,192430,175244.9,555250,48290,27989,777100
230480,164012.8,1332350,184680,145363.7,555250,45800,18649.1,777100
220250,137547.7,1332350,176980,121292.6,555250,43270,16255.1,777100
210000,124268.5,1332350,169250,108409.6,555250,40750,15858.9,777100
199730,118913.4,1332350,161530,104166.1,555250,38200,14747.3,777100
191780,108251.9,1332350,154510,91693.4,555250,37270,16558.5,777100
183790,93902.3,1332350,147470,77391.2,555250,36320,16511.1,777100
175770,83213.6,1332350,140460,70922.6,555250,35310,12291,777100
167790,78504.1,1332350,133430,65781.7,555250,34360,12722.4,777100
159110,64089.1,1332350,126070,50842.7,555250,33040,13246.4,777100
150400,59060.5,1332350,118710,43880.4,555250,31690,15180.1,777100
141650,60691.3,1332350,111330,45035.3,555250,30320,15656,777100
132990,57103,1332350,103940,38253.2,555250,29050,18849.8,777100
124470,50847.3,1332350,96380,34181.3,555250,28090,16666,777100
115930,51095.3,1332350,88850,33531.1,555250,27080,17564.2,777100
107370,52029.1,1332350,81270,34856,555250,26100,17173.1,777100
98870,60483.8,1332350,73720,39675.5,555250,25150,20808.3,777100
96420,63506.5,1332350,71040,40260.1,555250,25380,23246.4,777100
94010,73938,1332350,68400,44980.2,555250,25610,28957.8,777100
91540,74501.8,1332350,65770,45461.3,555250,25770,29040.5,777100
89160,83900.7,1332350,63110,48499.5,555250,26050,35401.2,777100
84570,91140.4,1332350,58550,52444.6,555250,26020,38695.8,777100
80000,82059.3,1332350,53970,44658.5,555250,26030,37400.8,777100
75470,64404.4,1332350,49420,32903.4,555250,26050,31501,777100
70920,45543.8,1332350,44850,21049.5,555250,26070,24494.3,777100
69520,42336.8,1332350,43300,20188.6,555250,26220,22148.2,777100
68200,35205.5,1332350,41750,17342.5,555250,26450,17863,777100
66780,16511.6,1332350,40210,6447,555250,26570,10064.6,777100
65430,12013.3,1332350,38660,2765.3,555250,26770,9248,777100
68160,8094.3,1332350,38270,990.7,555250,29890,7103.6,777100
71030,8520.6,1332350,37940,801.1,555250,33090,7719.5,777100
73820,9803.5,1332350,37580,1571.2,555250,36240,8232.3,777100
76630,12109.3,1332350,37220,561.7,555250,39410,11547.6,777100
81090,19393.4,1332350,38240,1703.7,555250,42850,17689.7,777100
85630,29122.2,1332350,39270,7414.3,555250,46360,21707.9,777100
90140,49979.2,1332350,40290,19586.1,555250,49850,30393.1,777100
94590,61238.1,1332350,41320,24742.7,555250,53270,36495.4,777100
100390,93026.6,1332350,43360,40500.3,555250,57030,52526.3,777100
106100,129247,1332350,45350,58393.3,555250,60750,70853.7,777100
111840,133151.2,1332350,47390,59055.4,555250,64450,74095.8,777100
117590,169343.7,1332350,49430,78111.6,555250,68160,91232.1,777100
134750,189183.7,1332350,61870,91168.3,555250,72880,98015.4,777100
151870,235297.3,1332350,74340,114275.3,555250,77530,121022,777100
168980,315369.5,1332350,86790,164005.2,555250,82190,151364.3,777100
235340,331634.9,1332350,142750,190093.7,555250,92590,141541.2,777100
254170,314137.4,1332350,156250,186426.4,555250,97920,127711,777100
273050,319611.3,1332350,169720,194826.6,555250,103330,124784.7,777100
291800,317046.1,1332350,183200,196231.7,555250,108600,120814.4,777100
310660,303144.2,1332350,196660,189181.5,555250,114000,113962.7,777100
326720,329290.1,1332350,207850,207889.2,555250,118870,121400.9,777100
342830,366162.7,1332350,219040,230625,555250,123790,135537.7,777100
358950,419769.8,1332350,230200,265147.7,555250,128750,154622.1,777100
375030,434304.2,1332350,241360,275949.3,555250,133670,158354.9,777100
368560,433216.3,1332350,235520,275005.3,555250,133040,158211,777100
362090,461723.4,1332350,229640,290005.4,555250,132450,171718,777100
355610,493682.8,1332350,223760,305708.2,555250,131850,187974.6,777100
349150,472534.5,1332350,217910,291904.2,555250,131240,180630.3,777100
345240,490487.6,1332350,212830,299764.2,555250,132410,190723.4,777100
341340,423946.5,1332350,207780,261267.8,555250,133560,162678.7,777100
337460,460912.7,1332350,202730,281679.7,555250,134730,179233,777100
333530,467571.1,1332350,197680,282712.1,555250,135850,184859,777100
328680,467887.1,1332350,192500,283590.7,555250,136180,184296.4,777100
323870,449430.3,1332350,187350,273447.9,555250,136520,175982.4,777100
319010,445316.7,1332350,182170,267538.9,555250,136840,177777.8,777100
314090,474417.4,1332350,177000,283026.1,555250,137090,191391.3,777100
314810,506413.8,1332350,180240,300565.3,555250,134570,205848.5,777100
315450,490943.6,1332350,183500,294952.3,555250,131950,195991.3,777100
316080,483621.2,1332350,186750,297368.1,555250,129330,186253.1,777100
316680,441086.4,1332350,190000,273787.9,555250,126680,167298.5,777100
314570,366580.7,1332350,191810,233502.8,555250,122760,133077.9,777100
312440,332550.7,1332350,193620,214066.2,555250,118820,118484.5,777100
310340,393507.9,1332350,195410,250990.7,555250,114930,142517.2,777100
308190,421702.9,1332350,197240,269525,555250,110950,152177.9,777100
309210,432850.3,1332350,201620,280128.4,555250,107590,152721.9,777100
310250,445398.7,1332350,206010,291554.5,555250,104240,153844.2,777100
311220,418075.1,1332350,210410,281782.5,555250,100810,136292.6,777100
312350,355736.2,1332350,214840,250732.2,555250,97510,105004,777100
310410,330393.8,1332350,212870,236226.6,555250,97540,94167.2,777100
308490,307105.4,1332350,210910,220985.7,555250,97580,86119.7,777100
306610,336914,1332350,208940,232632,555250,97670,104282,777100
304710,407093.2,1332350,206990,274037.9,555250,97720,133055.3,777100
307410,419702.6,1332350,207980,279498.6,555250,99430,140204,777100
310080,382946.2,1332350,208990,259100.1,555250,101090,123846.1,777100
312800,327263.8,1332350,210000,225854.9,555250,102800,101408.9,777100
315480,371076.7,1332350,210970,248274,555250,104510,122802.7,777100
319660,415808.2,1332350,214750,276602.1,555250,104910,139206.1,777100
323830,408077.9,1332350,218510,273004.5,555250,105320,135073.4,777100
327980,417144.7,1332350,222280,279065,555250,105700,138079.7,777100
332190,419010.4,1332350,226050,279126.3,555250,106140,139884.1,777100
341100,526214.8,1332350,229680,342362.2,555250,111420,183852.6,777100
350080,580269.4,1332350,233310,374575.5,555250,116770,205693.9,777100
358970,554867,1332350,236920,358546.2,555250,122050,196320.8,777100
367910,477241.3,1332350,240570,315014.2,555250,127340,162227.1,777100
374860,490661.6,1332350,241520,323655,555250,133340,167006.6,777100
381750,478704.7,1332350,242520,315867.9,555250,139230,162836.8,777100
388670,495022.3,1332350,243490,322055.5,555250,145180,172966.8,777100
395560,493104.6,1332350,244480,316738.9,555250,151080,176365.7,777100
401440,464517.9,1332350,246230,298797.4,555250,155210,165720.5,777100
407360,456434.5,1332350,248000,293610.7,555250,159360,162823.8,777100
413250,415193,1332350,249760,271916.5,555250,163490,143276.5,777100
419000,408744.1,1332350,251500,264600.8,555250,167500,144143.3,777100
425070,442103.3,1332350,256610,280949,555250,168460,161154.3,777100
431110,443208.7,1332350,261750,284365.5,555250,169360,158843.2,777100
437160,407212.4,1332350,266840,268217.8,555250,170320,138994.6,777100
443160,434875.2,1332350,271930,286612.8,555250,171230,148262.4,777100
450120,463737.9,1332350,276180,305583.9,555250,173940,158154,777100
457010,453810.8,1332350,280410,299612.1,555250,176600,154198.7,777100
463920,469569.4,1332350,284660,309195.8,555250,179260,160373.6,777100
470890,474233.3,1332350,288870,308496.7,555250,182020,165736.6,777100
477420,432890.2,1332350,293900,293959.6,555250,183520,138930.6,777100
483820,449466.8,1332350,298910,303280.5,555250,184910,146186.3,777100
490270,490445.8,1332350,303920,325332.2,555250,186350,165113.6,777100
496710,505693.3,1332350,308920,333686.5,555250,187790,172006.8,777100
495980,480228.1,1332350,311560,320382.8,555250,184420,159845.3,777100
495220,486139.1,1332350,314210,325011.8,555250,181010,161127.3,777100
494400,480477.9,1332350,316840,327389,555250,177560,153088.9,777100
493630,427416.3,1332350,319490,298737.2,555250,174140,128679.1,777100
493090,382493.2,1332350,322090,276233.8,555250,171000,106259.4,777100
492590,390609.8,1332350,324680,281738.2,555250,167910,108871.6,777100
492070,414158.2,1332350,327300,299205.6,555250,164770,114952.6,777100
491560,410076.7,1332350,329890,304343.2,555250,161670,105733.5,777100
492260,447512.8,1332350,334190,328384.9,555250,158070,119127.9,777100
492970,488934.4,1332350,338480,356121.2,555250,154490,132813.2,777100
493720,487556.6,1332350,342770,358378.2,555250,150950,129178.4,777100
494450,475055,1332350,347070,355838.4,555250,147380,119216.6,777100
502370,453259.4,1332350,350120,344840.3,555250,152250,108419.1,777100
510230,438434.2,1332350,353180,337376.7,555250,157050,101057.5,777100
518240,414036.5,1332350,356270,323253.1,555250,161970,90783.4,777100
526160,429996.9,1332350,359330,333600.1,555250,166830,96396.8,777100
532380,420662.5,1332350,361510,323338.7,555250,170870,97323.8,777100
538660,428476.2,1332350,363680,330152.1,555250,174980,98324.1,777100
544910,407653.7,1332350,365840,309619.3,555250,179070,98034.4,777100
551190,311193.1,1332350,368000,257517.7,555250,183190,53675.4,777100
557870,347558.2,1332350,370460,278200.9,555250,187410,69357.3,777100
564540,324954.6,1332350,372890,262174.4,555250,191650,62780.2,777100
571280,337748.4,1332350,375360,271868,555250,195920,65880.4,777100
577920,353699.5,1332350,377770,276968.8,555250,200150,76730.7,777100
582790,352639.1,1332350,378440,266989.2,555250,204350,85649.9,777100
587650,385281.7,1332350,379080,287333,555250,208570,97948.7,777100
592510,398554.3,1332350,379700,301431.1,555250,212810,97123.2,777100
536130,447966.9,1332350,358700,331409.4,555250,177430,116557.5,777100
540160,467690.6,1332350,358890,335678.3,555250,181270,132012.3,777100
544230,438449.2,1332350,359070,320089.3,555250,185160,118359.9,777100
548320,407095.8,1332350,359230,301514.8,555250,189090,105581,777100
552450,410839.6,1332350,359420,300923.7,555250,193030,109915.9,777100
556610,470940.6,1332350,360290,326315.6,555250,196320,144625,777100
560750,485734.5,1332350,361170,329710,555250,199580,156024.5,777100
565030,511277.4,1332350,362040,342109.6,555250,202990,169167.8,777100
569270,521762.3,1332350,362910,349464,555250,206360,172298.3,777100
565770,506282.6,1332350,359550,338846.9,555250,206220,167435.7,777100
562270,494274.1,1332350,356200,329591.7,555250,206070,164682.4,777100
558710,482521.9,1332350,352830,319288.2,555250,205880,163233.7,777100
555180,462279.1,1332350,349450,309791.2,555250,205730,152487.9,777100
551430,437649.8,1332350,346280,296430.1,555250,205150,141219.7,777100
547470,431572.1,1332350,343090,289155.4,555250,204380,142416.7,777100
543550,386605.6,1332350,339880,260266.4,555250,203670,126339.2,777100
539680,289387.1,1332350,336700,204715.5,555250,202980,84671.6,777100
534430,273336.5,1332350,332260,195277.1,555250,202170,78059.4,777100
529140,276902.4,1332350,327870,194808,555250,201270,82094.4,777100
523850,310739.8,1332350,323420,213939.9,555250,200430,96799.9,777100
518550,330644.3,1332350,319000,225158.9,555250,199550,105485.4,777100
512820,408765.6,1332350,314610,269703.4,555250,198210,139062.2,777100
507040,450236.4,1332350,310220,291229.3,555250,196820,159007.1,777100
501310,444243,1332350,305810,288293.9,555250,195500,155949.1,777100
495470,441338,1332350,301420,284134.6,555250,194050,157203.4,777100
490490,499183,1332350,297770,314933.2,555250,192720,184249.8,777100
485530,471538.7,1332350,294110,300765.1,555250,191420,170773.6,777100
480470,464769.7,1332350,290420,294171.6,555250,190050,170598.1,777100
475380,436222,1332350,286770,280099.9,555250,188610,156122.1,777100
467570,432540.3,1332350,281440,280186.8,555250,186130,152353.5,777100
459650,415359.4,1332350,276080,269101.4,555250,183570,146258,777100
451820,431755.5,1332350,270730,277992.1,555250,181090,153763.4,777100
443920,450371.2,1332350,265390,289824.2,555250,178530,160547,777100
444850,462560.9,1332350,264680,300463.5,555250,180170,162097.4,777100
445730,459740.7,1332350,263970,299357.9,555250,181760,160382.8,777100
446600,449193.2,1332350,263250,291304.9,555250,183350,157888.3,777100
447540,484373.5,1332350,262520,309618.6,555250,185020,174754.9,777100
453040,521586.4,1332350,262760,327517.2,555250,190280,194069.2,777100
458430,559111.6,1332350,262970,342942.7,555250,195460,216168.9,777100
463910,578088.7,1332350,263190,347345.9,555250,200720,230742.8,777100
469360,562253.2,1332350,263410,338178.9,555250,205950,224074.3,777100
471550,575849.2,1332350,261090,340214.9,555250,210460,235634.3,777100
473720,541019,1332350,258810,314660.1,555250,214910,226358.9,777100
475950,537841.5,1332350,256540,316467.8,555250,219410,221373.7,777100
478160,529151.3,1332350,254230,303193.4,555250,223930,225957.9,777100
476900,568893.5,1332350,248610,324050.7,555250,228290,244842.8,777100
475540,606062.4,1332350,242900,336784.2,555250,232640,269278.2,777100
474260,595875.1,1332350,237270,323574.1,555250,236990,272301,777100
472920,603371.3,1332350,231610,314521.1,555250,241310,288850.2,777100
474670,564288,1332350,229000,292737.5,555250,245670,271550.5,777100
476320,561053.9,1332350,226420,283396.6,555250,249900,277657.3,777100
478060,500207.8,1332350,223840,233933.6,555250,254220,266274.2,777100
479690,565563.5,1332350,221220,271652.9,555250,258470,293910.6,777100
480800,645836.5,1332350,217660,316641.2,555250,263140,329195.3,777100
481900,564846.9,1332350,214080,265344.9,555250,267820,299502,777100
482990,604147.8,1332350,210520,288004.4,555250,272470,316143.4,777100
484100,615463.5,1332350,206920,292736.5,555250,277180,322727,777100
480950,676547,1332350,205560,331401.7,555250,275390,345145.3,777100
477790,728918.6,1332350,204200,363343.1,555250,273590,365575.5,777100
474670,748479.1,1332350,202840,384386.1,555250,271830,364093,777100
471560,758776.8,1332350,201460,390325,555250,270100,368451.8,777100
464460,715607,1332350,197240,356616.5,555250,267220,358990.5,777100
457330,701664.4,1332350,193000,344780.1,555250,264330,356884.3,777100
450270,747254.5,1332350,188740,367453.3,555250,261530,379801.2,777100
443210,687780.8,1332350,184530,326973.4,555250,258680,360807.4,777100
445240,687551.2,1332350,190340,328231.3,555250,254900,359319.9,777100
447190,693324.7,1332350,196210,330806.7,555250,250980,362518,777100
449260,647781.3,1332350,202040,304044,555250,247220,343737.3,777100
451270,679698.1,1332350,207910,342903.9,555250,243360,336794.2,777100
476510,759141.5,1332350,223550,386979.9,555250,252960,372161.6,777100
501750,797158.2,1332350,239150,411405.5,555250,262600,385752.7,777100
526950,795635.4,1332350,254790,413714,555250,272160,381921.4,777100
552130,773146.1,1332350,270400,399599.3,555250,281730,373546.8,777100
573970,787771.3,1332350,283590,403891.2,555250,290380,383880.1,777100
595730,782947,1332350,296770,413856.2,555250,298960,369090.8,777100
617500,828535.6,1332350,309970,438723.2,555250,307530,389812.4,777100
639320,825568.5,1332350,323130,439159.2,555250,316190,386409.3,777100
661860,832094.3,1332350,338660,444801.8,555250,323200,387292.5,777100
684310,803125,1332350,354150,434183.3,555250,330160,368941.7,777100
706980,815413.5,1332350,369710,441162.9,555250,337270,374250.6,777100
729480,837849,1332350,385200,453108,555250,344280,384741,777100
730990,851794.7,1332350,379330,454002.8,555250,351660,397791.9,777100
732420,808392,1332350,373450,422576.9,555250,358970,385815.1,777100
733860,794523.6,1332350,367570,405667.7,555250,366290,388855.9,777100
735260,774573.8,1332350,361690,401823,555250,373570,372750.8,777100
739600,790598,1332350,356770,402867.1,555250,382830,387730.9,777100
743910,807448.8,1332350,351850,413312.5,555250,392060,394136.3,777100
748330,833728.7,1332350,346940,425141.3,555250,401390,408587.4,777100
752640,862994,1332350,342030,437466.6,555250,410610,425527.4,777100
757250,861551.8,1332350,338080,420132.4,555250,419170,441419.4,777100
761800,911210.2,1332350,334150,442301.7,555250,427650,468908.5,777100
766460,893895.2,1332350,330210,430155.4,555250,436250,463739.8,777100
770980,894574.1,1332350,326270,421026.1,555250,444710,473548,777100
758190,894034,1332350,319440,418086.8,555250,438750,475947.2,777100
745410,851595.9,1332350,312660,391435.2,555250,432750,460160.7,777100
732550,815397.8,1332350,305830,369357.6,555250,426720,446040.2,777100
814320,808883.9,1332350,361780,379438.9,555250,452540,429445,777100
805020,811507.4,1332350,355190,375873.4,555250,449830,435634,777100
795690,804318.8,1332350,348610,372345,555250,447080,431973.8,777100
786460,800196.5,1332350,342030,379316.3,555250,444430,420880.2,777100
777020,813615.4,1332350,335460,386437.7,555250,441560,427177.7,777100
766090,793042.3,1332350,328030,358965,555250,438060,434077.3,777100
755000,792987.9,1332350,320620,358682.4,555250,434380,434305.5,777100
743990,768792.1,1332350,313210,348505,555250,430780,420287.1,777100
732970,785560.3,1332350,305780,356959.6,555250,427190,428600.7,777100
711020,787451.3,1332350,297140,363392.5,555250,413880,424058.8,777100
688990,767576.7,1332350,288480,352768.5,555250,400510,414808.2,777100
667040,787573,1332350,279850,362631.6,555250,387190,424941.4,777100
645010,781684,1332350,271160,364434.6,555250,373850,417249.4,777100
624840,731242,1332350,264740,343403.1,555250,360100,387838.9,777100
604590,683005.9,1332350,258260,323111.4,555250,346330,359894.5,777100
584490,617513.4,1332350,251820,285608.7,555250,332670,331904.7,777100
564220,632998.2,1332350,245360,299489.6,555250,318860,333508.6,777100
544380,643680.3,1332350,238900,309048.5,555250,305480,334631.8,777100
524570,610266.5,1332350,232410,289436.4,555250,292160,320830.1,777100
504690,582751.2,1332350,225920,279710.5,555250,278770,303040.7,777100
484870,679348,1332350,219470,345442.5,555250,265400,333905.5,777100
473230,746072.6,1332350,216190,380307.9,555250,257040,365764.7,777100
461560,735336.3,1332350,212870,380538,555250,248690,354798.3,777100
449980,684584.2,1332350,209580,358525.5,555250,240400,326058.7,777100
438390,600366.4,1332350,206310,309184.1,555250,232080,291182.3,777100
426660,602081.9,1332350,202290,309742.8,555250,224370,292339.1,777100
414960,549818.2,1332350,198270,289073.7,555250,216690,260744.5,777100
403260,534562,1332350,194230,284262.1,555250,209030,250299.9,777100
391540,508710.1,1332350,190220,268758.3,555250,201320,239951.8,777100
381680,489253.8,1332350,187560,254337.2,555250,194120,234916.6,777100
371750,453124.9,1332350,184890,238866.3,555250,186860,214258.6,777100
361770,449291.9,1332350,182250,242823.1,555250,179520,206468.8,777100
351840,461762.7,1332350,179590,249082,555250,172250,212680.7,777100
348270,472199.4,1332350,179230,256352.6,555250,169040,215846.8,777100
344530,433774.5,1332350,178900,235586.9,555250,165630,198187.6,777100
340870,404102.5,1332350,178540,215778.9,555250,162330,188323.6,777100
337200,410365.8,1332350,178220,218131.4,555250,158980,192234.4,777100
332630,448474.6,1332350,176960,239410.6,555250,155670,209064,777100
328120,471604.1,1332350,175730,242896.3,555250,152390,228707.8,777100
323550,456908.8,1332350,174490,239833,555250,149060,217075.8,777100
318990,457791.4,1332350,173230,244687.3,555250,145760,213104.1,777100
316910,482504.3,1332350,173680,259506.6,555250,143230,222997.7,777100
314710,455018.8,1332350,174110,246886.7,555250,140600,208132.1,777100
312570,435366.1,1332350,174540,237113.7,555250,138030,198252.4,777100
310500,372570,1332350,175000,203894.8,555250,135500,168675.2,777100
306160,363161.8,1332350,173590,200558.2,555250,132570,162603.6,777100
301770,341947.9,1332350,172210,189896.3,555250,129560,152051.6,777100
297340,317224.2,1332350,170870,177705.3,555250,126470,139518.9,777100
292910,329432.8,1332350,169490,185424,555250,123420,144008.8,777100
290500,334290.1,1332350,169950,188444.3,555250,120550,145845.8,777100
288070,296676.6,1332350,170390,172331.5,555250,117680,124345.1,777100
285670,290887,1332350,170850,169748.1,555250,114820,121138.9,777100
283110,278188.5,1332350,171310,165803.4,555250,111800,112385.1,777100
277920,251223.3,1332350,169850,150592.2,555250,108070,100631.1,777100
272560,241490.6,1332350,168380,144552.2,555250,104180,96938.4,777100
267400,270526.8,1332350,166950,160363,555250,100450,110163.8,777100
262090,286823,1332350,165460,169929.1,555250,96630,116893.9,777100
257080,286014.6,1332350,164110,173240.2,555250,92970,112774.4,777100
252060,290902.4,1332350,162750,176910.7,555250,89310,113991.7,777100
246990,340117.8,1332350,161400,211530.7,555250,85590,128587.1,777100
242000,355549.4,1332350,160070,223867.3,555250,81930,131682.1,777100
236890,376839.1,1332350,158740,238142.5,555250,78150,138696.6,777100
231830,411143,1332350,157400,258335.4,555250,74430,152807.6,777100
226740,389856,1332350,156090,247960.6,555250,70650,141895.4,777100
221630,362927.6,1332350,154750,231687.6,555250,66880,131240,777100
217310,368374.9,1332350,154300,235169.1,555250,63010,133205.8,777100
212990,384738.8,1332350,153870,248023.7,555250,59120,136715.1,777100
208640,399132.6,1332350,153450,261824,555250,55190,137308.6,777100
204270,419697.4,1332350,153010,274151.2,555250,51260,145546.2,777100
200910,416898.1,1332350,153480,275091.4,555250,47430,141806.7,777100
197650,402511.2,1332350,153960,267807.6,555250,43690,134703.6,777100
194470,359379.5,1332350,154460,247938.3,555250,40010,111441.2,777100
191030,335889.6,1332350,154920,233960.8,555250,36110,101928.8,777100
187170,280238.7,1332350,154450,205781.4,555250,32720,74457.3,777100
183380,224214.5,1332350,153960,174294.8,555250,29420,49919.7,777100
179470,192428.8,1332350,153500,157620.2,555250,25970,34808.6,777100
175660,169055.3,1332350,153000,147776,555250,22660,21279.3,777100
170490,139745.6,1332350,151180,129643.6,555250,19310,10102,777100
165430,126542.5,1332350,149360,120145.9,555250,16070,6396.6,777100
160290,112954,1332350,147560,107761.8,555250,12730,5192.2,777100
155190,95922.2,1332350,145750,90415.2,555250,9440,5507,777100
149620,86903,1332350,139470,81295.5,555250,10150,5607.5,777100
144130,86318,1332350,133210,81041,555250,10920,5277,777100
138630,79329.1,1332350,126940,73569.6,555250,11690,5759.5,777100
132990,65479,1332350,120620,59123.1,555250,12370,6355.9,777100
127630,67693.4,1332350,114470,61127.3,555250,13160,6566.1,777100
122180,77755.2,1332350,108340,69489.1,555250,13840,8266.1,777100
116810,74524.8,1332350,102150,62402.3,555250,14660,12122.5,777100
111430,61148.9,1332350,96030,46738.2,555250,15400,14410.7,777100
107340,57784.7,1332350,91110,39370.9,555250,16230,18413.8,777100
103300,61182.9,1332350,86150,38363.3,555250,17150,22819.6,777100
99340,67143.4,1332350,81260,41587.1,555250,18080,25556.3,777100
95270,73835.4,1332350,76340,43011.7,555250,18930,30823.7,777100
97890,77114.5,1332350,74530,39049.6,555250,23360,38064.9,777100
100610,86022.5,1332350,72740,38406.6,555250,27870,47615.9,777100
103280,96396.8,1332350,70940,38057.9,555250,32340,58338.9,777100
169470,93220.8,1332350,113130,39744.4,555250,56340,53476.4,777100
169040,101311.3,1332350,108560,41397.4,555250,60480,59913.9,777100
168540,99242,1332350,103970,40352.9,555250,64570,58889.1,777100
168080,104113.7,1332350,99410,40894.4,555250,68670,63219.3,777100
167500,113138.1,1332350,94830,42576.3,555250,72670,70561.8,777100
168870,118327.5,1332350,92190,39980.7,555250,76680,78346.8,777100
170250,128904.4,1332350,89530,43246.3,555250,80720,85658.1,777100
171630,145071.8,1332350,86890,49156.5,555250,84740,95915.3,777100
172970,156304.9,1332350,84250,51451.1,555250,88720,104853.8,777100
171190,162910.1,1332350,81400,55363.4,555250,89790,107546.7,777100
169400,171081.6,1332350,78580,60695,555250,90820,110386.6,777100
167630,181433.3,1332350,75740,62433.1,555250,91890,119000.2,777100
165820,178971.8,1332350,72890,56981,555250,92930,121990.8,777100
163860,170591.3,1332350,69950,52156.7,555250,93910,118434.6,777100
161850,174756.2,1332350,66960,53958.8,555250,94890,120797.4,777100
159810,182838.3,1332350,64010,55597.4,555250,95800,127240.9,777100
157790,186639.2,1332350,61020,56020.2,555250,96770,130619,777100
155980,197552.7,1332350,57940,59049.3,555250,98040,138503.4,777100
154310,205117.9,1332350,54880,60621.9,555250,99430,144496,777100
152510,207555.9,1332350,51790,58704.9,555250,100720,148851,777100
150680,215670.3,1332350,48700,59748.9,555250,101980,155921.4,777100
149580,216009.9,1332350,47310,58867.9,555250,102270,157142,777100
148390,209102.9,1332350,45870,54878.6,555250,102520,154224.3,777100
147180,197654.1,1332350,44470,49668.4,555250,102710,147985.7,777100
145960,195966.9,1332350,43030,47125.6,555250,102930,148841.3,777100
145170,195649.1,1332350,42290,46622.1,555250,102880,149027,777100
144390,197615.5,1332350,41550,48005.8,555250,102840,149609.7,777100
143580,202458.5,1332350,40770,50878.1,555250,102810,151580.4,777100
142820,206369.4,1332350,40020,54490.5,555250,102800,151878.9,777100
143570,210096.4,1332350,40180,58023.2,555250,103390,152073.2,777100
144230,213487.6,1332350,40300,58832.5,555250,103930,154655.1,777100
144990,211017.3,1332350,40480,58396.1,555250,104510,152621.2,777100
145600,194697.3,1332350,40620,54304.5,555250,104980,140392.8,777100
143900,169147.9,1332350,43080,48092.9,555250,100820,121055,777100
142190,135719.5,1332350,45590,38297.9,555250,96600,97421.6,777100
140430,123530.4,1332350,48040,38740.9,555250,92390,84789.5,777100
138740,109830.4,1332350,50510,36137,555250,88230,73693.4,777100
132620,87163.4,1332350,51320,30688.2,555250,81300,56475.2,777100
126460,71815.7,1332350,52100,23247,555250,74360,48568.7,777100
120330,58164,1332350,52900,16807.6,555250,67430,41356.4,777100
114130,46794.2,1332350,53680,11904.9,555250,60450,34889.3,777100
110060,46875.4,1332350,53170,14022.3,555250,56890,32853.1,777100
105980,46743.3,1332350,52690,14400.5,555250,53290,32342.8,777100
101820,44302.3,1332350,52190,14931.8,555250,49630,29370.5,777100
97780,40953.9,1332350,51720,14059.8,555250,46060,26894.1,777100
103850,43353.3,1332350,54340,13581.4,555250,49510,29771.9,777100
109940,52347.4,1332350,57000,18345.6,555250,52940,34001.8,777100
115970,69845.1,1332350,59620,28217.3,555250,56350,41627.8,777100
122080,68491.6,1332350,62280,26678.7,555250,59800,41812.9,777100
127210,74840.4,1332350,64300,29783.4,555250,62910,45057,777100
132370,87820.8,1332350,66340,35479.4,555250,66030,52341.4,777100
137520,105436.9,1332350,68370,43699.5,555250,69150,61737.4,777100
142630,114636.2,1332350,70360,50489.1,555250,72270,64147.1,777100
148660,122504,1332350,73070,53597.7,555250,75590,68906.3,777100
154600,135200.9,1332350,75740,59629.8,555250,78860,75571.1,777100
160660,141997.3,1332350,78450,64509,555250,82210,77488.3,777100
166610,150002.4,1332350,81120,68584.7,555250,85490,81417.7,777100
171380,149847.5,1332350,83450,70049.4,555250,87930,79798.1,777100
176190,159641.1,1332350,85780,76532.7,555250,90410,83108.4,777100
180910,156350.5,1332350,88120,74570.5,555250,92790,81780,777100
185640,155659,1332350,90450,75916.3,555250,95190,79742.7,777100
190910,170267.2,1332350,93300,84921.3,555250,97610,85345.9,777100
196200,179013.7,1332350,96140,89844.2,555250,100060,89169.5,777100
201420,188880.4,1332350,99030,97058.6,555250,102390,91821.8,777100
206610,204541.7,1332350,101860,108495,555250,104750,96046.7,777100
212210,227588.7,1332350,105110,123204,555250,107100,104384.7,777100
217710,234246,1332350,108330,129294.5,555250,109380,104951.5,777100
223250,251375.8,1332350,111570,138863.4,555250,111680,112512.4,777100
228830,251507.5,1332350,114780,141602.3,555250,114050,109905.2,777100
238650,268017.5,1332350,122840,154913.8,555250,115810,113103.7,777100
248540,298753.2,1332350,130870,174078.4,555250,117670,124674.8,777100
258450,303801.4,1332350,138930,181208.3,555250,119520,122593.1,777100
268380,326742.4,1332350,146980,197922,555250,121400,128820.4,777100
277900,319200.9,1332350,155550,196293.4,555250,122350,122907.5,777100
287490,322831.3,1332350,164160,199951.2,555250,123330,122880.1,777100
297000,336566.3,1332350,172760,211791.7,555250,124240,124774.6,777100
306610,353439.1,1332350,181350,223861.7,555250,125260,129577.4,777100
318860,363218.5,1332350,192090,236093.3,555250,126770,127125.2,777100
330990,376980.2,1332350,202800,246722.2,555250,128190,130258,777100
343250,410742.4,1332350,213550,270097.6,555250,129700,140644.8,777100
355390,431565.6,1332350,224260,286480.5,555250,131130,145085.1,777100
375520,456255.3,1332350,235010,301724.5,555250,140510,154530.8,777100
395710,451884.5,1332350,245760,297652,555250,149950,154232.5,777100
415860,429693.4,1332350,256490,283539.8,555250,159370,146153.6,777100
436010,445940.7,1332350,267250,290713.7,555250,168760,155227,777100
453810,474101.8,1332350,275150,301103.3,555250,178660,172998.5,777100
471540,502084.9,1332350,283030,312752.5,555250,188510,189332.4,777100
489290,535617.4,1332350,290900,327239.1,555250,198390,208378.3,777100
507110,555251.2,1332350,298800,335138.7,555250,208310,220112.5,777100
526660,627349.8,1332350,308450,372861.4,555250,218210,254488.4,777100
546330,657425.1,1332350,318090,384859.9,555250,228240,272565.2,777100
565900,682185.3,1332350,327720,394900.4,555250,238180,287284.9,777100
585510,694596.4,1332350,337370,399191.3,555250,248140,295405.1,777100
589670,706969.4,1332350,337490,402606,555250,252180,304363.4,777100
593960,725392.5,1332350,337640,408315.4,555250,256320,317077.1,777100
598120,747227.2,1332350,337810,416584.3,555250,260310,330642.9,777100
630750,750264.3,1332350,356670,420846.8,555250,274080,329417.5,777100
631960,747849.4,1332350,355400,416987.3,555250,276560,330862.1,777100
633070,774008.3,1332350,354110,430533.3,555250,278960,343475,777100
634230,779096.1,1332350,352820,432277,555250,281410,346819.1,777100
635460,773540.6,1332350,351510,430788.3,555250,283950,342752.3,777100
633110,769831.3,1332350,347230,426032.1,555250,285880,343799.2,777100
630780,758428.7,1332350,342900,417646.2,555250,287880,340782.5,777100
628510,761981.6,1332350,338610,415033.2,555250,289900,346948.4,777100
626260,757087,1332350,334320,411948.6,555250,291940,345138.4,777100
610050,758402.1,1332350,322810,409429.4,555250,287240,348972.7,777100
593830,748473.8,1332350,311300,400414.3,555250,282530,348059.5,777100
577630,737151.1,1332350,299790,391178.9,555250,277840,345972.2,777100
561420,685949.4,1332350,288300,360679.6,555250,273120,325269.8,777100
546380,626346.9,1332350,277740,324318.3,555250,268640,302028.6,777100
531290,564702.5,1332350,267180,287652.1,555250,264110,277050.4,777100
516200,501121.9,1332350,256650,254458,555250,259550,246663.9,777100
501140,447926.5,1332350,246070,228630.4,555250,255070,219296.1,777100
487670,408360.9,1332350,237140,204338,555250,250530,204022.9,777100
474200,405440.5,1332350,228160,199615.1,555250,246040,205825.4,777100
460700,341860.8,1332350,219230,159909,555250,241470,181951.8,777100
447200,321570.7,1332350,210280,149661.2,555250,236920,171909.5,777100
433350,272125.2,1332350,201160,121564.8,555250,232190,150560.4,777100
419420,265069.3,1332350,192040,114377.8,555250,227380,150691.5,777100
405520,276401.6,1332350,182900,121599.6,555250,222620,154802,777100
391610,274398.8,1332350,173740,119803.3,555250,217870,154595.5,777100
378560,247546.9,1332350,165350,101751.5,555250,213210,145795.4,777100
365480,238468.4,1332350,156930,94228.6,555250,208550,144239.8,777100
352410,217966.9,1332350,148530,79443.5,555250,203880,138523.4,777100
339340,209474.9,1332350,140130,70556.5,555250,199210,138918.4,777100
326810,220227.6,1332350,131260,75270.9,555250,195550,144956.7,777100
314300,232058,1332350,122390,83588,555250,191910,148470,777100
301790,280098.7,1332350,113490,109489.8,555250,188300,170608.9,777100
289270,265172.9,1332350,104650,102012.9,555250,184620,163160,777100
278660,178566.5,1332350,100290,57224.7,555250,178370,121341.8,777100
268040,131187.7,1332350,95970,29210.9,555250,172070,101976.8,777100
257370,113240.8,1332350,91590,19037.3,555250,165780,94203.5,777100
246690,97688.8,1332350,87220,14150.2,555250,159470,83538.6,777100
233370,88712.6,1332350,82450,15273,555250,150920,73439.6,777100
220070,73233.8,1332350,77660,11229.5,555250,142410,62004.3,777100
206740,53869.9,1332350,72880,4504.5,555250,133860,49365.4,777100
193480,47626.3,1332350,68120,3655.8,555250,125360,43970.5,777100
184560,46186.7,1332350,65080,3439.4,555250,119480,42747.3,777100
175540,62017.2,1332350,62040,13053,555250,113500,48964.2,777100
166590,52411,1332350,58990,7354,555250,107600,45057,777100
157700,48384.3,1332350,55970,4768.8,555250,101730,43615.5,777100
158140,51933.4,1332350,53950,5089.6,555250,104190,46843.8,777100
158670,60941.5,1332350,51950,7040.2,555250,106720,53901.3,777100
159160,72621.1,1332350,49940,9705.3,555250,109220,62915.8,777100
159710,81428.9,1332350,47950,9320.8,555250,111760,72108.1,777100
160200,86618.2,1332350,45860,12355.4,555250,114340,74262.8,777100
160740,99388.5,1332350,43790,19836.2,555250,116950,79552.3,777100
161380,109707.3,1332350,41700,24928.7,555250,119680,84778.6,777100
161870,104260.4,1332350,39640,20540.3,555250,122230,83720.1,777100
163010,107218.1,1332350,37680,19078.7,555250,125330,88139.4,777100
164120,126066.4,1332350,35710,24667,555250,128410,101399.4,777100
165200,138683.9,1332350,33750,28218.4,555250,131450,110465.5,777100
166370,150781.7,1332350,31810,30066.2,555250,134560,120715.5,777100
172370,192006,1332350,34560,45965.1,555250,137810,146040.9,777100
178390,226011.5,1332350,37340,64298.7,555250,141050,161712.8,777100
184400,270169.2,1332350,40090,85178.1,555250,144310,184991.1,777100
190370,267834.1,1332350,42860,82711.4,555250,147510,185122.7,777100
196840,287214,1332350,45710,90565.7,555250,151130,196648.3,777100
203210,321838,1332350,48560,107487.1,555250,154650,214350.9,777100
209730,308935.3,1332350,51460,106792.7,555250,158270,202142.6,777100
216140,267828.9,1332350,54280,82196.4,555250,161860,185632.5,777100
222610,291838.4,1332350,57150,98905.1,555250,165460,192933.3,777100
228890,300448.4,1332350,59930,107372.8,555250,168960,193075.6,777100
235310,295976.2,1332350,62760,110755.1,555250,172550,185221.1,777100
241720,277839.4,1332350,65570,99327.9,555250,176150,178511.5,777100
242090,251673.6,1332350,69450,84111.1,555250,172640,167562.5,777100
242340,230414.5,1332350,73380,74297.4,555250,168960,156117.1,777100
242720,217805.1,1332350,77260,68559.6,555250,165460,149245.5,777100
243030,204134.2,1332350,81160,62342.6,555250,161870,141791.6,777100
239210,174092.2,1332350,82320,48834.8,555250,156890,125257.4,777100
235410,157236,1332350,83480,40576.6,555250,151930,116659.4,777100
231630,148339.8,1332350,84650,32964.8,555250,146980,115375,777100
227860,133527.8,1332350,85770,25996.1,555250,142090,107531.7,777100
223920,133890.6,1332350,86600,29868.5,555250,137320,104022.1,777100
219980,103084.6,1332350,87380,12770.7,555250,132600,90313.9,777100
216060,97592.8,1332350,88150,8661.2,555250,127910,88931.6,777100
212110,87865.9,1332350,88940,6272.6,555250,123170,81593.3,777100
211320,113725.4,1332350,90500,27921.2,555250,120820,85804.2,777100
210570,122777.6,1332350,91990,37657.9,555250,118580,85119.7,777100
209810,143348,1332350,93490,53610.4,555250,116320,89737.6,777100
208980,158570.6,1332350,94980,61242.9,555250,114000,97327.7,777100
209420,165211.7,1332350,95850,64953.7,555250,113570,100258,777100
209750,160533.3,1332350,96680,64220.7,555250,113070,96312.6,777100
210210,164795.8,1332350,97520,66151.2,555250,112690,98644.6,777100
210570,216913.3,1332350,98320,92663.5,555250,112250,124249.8,777100
210860,274568.9,1332350,100340,131625.8,555250,110520,142943.1,777100
210970,282701.2,1332350,102290,140641.4,555250,108680,142059.8,777100
211290,275144,1332350,104290,140956.9,555250,107000,134187.1,777100
211500,338474.4,1332350,106290,181179.5,555250,105210,157294.9,777100
204080,310767.7,1332350,102250,168574.7,555250,101830,142193,777100
196600,275986.8,1332350,98230,149448.3,555250,98370,126538.5,777100
189130,259972.6,1332350,94200,140969.2,555250,94930,119003.4,777100
268110,284702.3,1332350,135330,157370.8,555250,132780,127331.5,777100
257770,307194.4,1332350,135370,177585,555250,122400,129609.4,777100
247490,229112.9,1332350,135440,135834.2,555250,112050,93278.7,777100
237100,229214.2,1332350,135470,140843.6,555250,101630,88370.6,777100
226880,217543.9,1332350,135540,140132.7,555250,91340,77411.2,777100
212380,179632.2,1332350,130310,122659,555250,82070,56973.2,777100
197800,133865.2,1332350,125090,96290.2,555250,72710,37575,777100
183330,200918.3,1332350,119840,131072.6,555250,63490,69845.7,777100
168840,366049.7,1332350,114620,213160.8,555250,54220,152888.9,777100
172520,353398.8,1332350,116360,199594.7,555250,56160,153804.1,777100
176150,290910.4,1332350,118060,171675.2,555250,58090,119235.2,777100
179850,239349.4,1332350,119780,143996.4,555250,60070,95353,777100
183580,213948.3,1332350,121520,128140.2,555250,62060,85808.1,777100
188930,256206.4,1332350,123990,153888.3,555250,64940,102318.1,777100
194340,215194.9,1332350,126450,133347.8,555250,67890,81847.1,777100
199810,206516.7,1332350,128910,111830.1,555250,70900,94686.6,777100
205150,248850.6,1332350,131390,137745.8,555250,73760,111104.8,777100
212530,253187.6,1332350,135980,141345.4,555250,76550,111842.2,777100
219950,242451.6,1332350,140590,138531.6,555250,79360,103920,777100
227340,265696.6,1332350,145160,151928.4,555250,82180,113768.2,777100
234700,300820,1332350,149780,181589.1,555250,84920,119230.9,777100
238250,358684.7,1332350,152340,213907.4,555250,85910,144777.3,777100
241790,425796.8,1332350,154900,249745.7,555250,86890,176051.1,777100
245220,435384.3,1332350,157460,257621.8,555250,87760,177762.5,777100
248760,390980.9,1332350,160010,229242.3,555250,88750,161738.6,777100
251870,310425.8,1332350,161670,173939.6,555250,90200,136486.2,777100
255070,265700,1332350,163370,148716.8,555250,91700,116983.2,777100
258200,212636.9,1332350,165020,124540.8,555250,93180,88096.1,777100
261320,187818.4,1332350,166700,114282.3,555250,94620,73536.1,777100
270450,176689.2,1332350,173980,108787.6,555250,96470,67901.6,777100
279530,197247.4,1332350,181270,121322.8,555250,98260,75924.6,777100
288580,224623.8,1332350,188530,138901.4,555250,100050,85722.4,777100
297690,241723.4,1332350,195820,152686.2,555250,101870,89037.2,777100
308110,237815.3,1332350,202010,154674.7,555250,106100,83140.6,777100
318620,232664.8,1332350,208210,154620.9,555250,110410,78043.9,777100
329090,270087,1332350,214410,177939.3,555250,114680,92147.7,777100
339520,331782.7,1332350,220580,218372.9,555250,118940,113409.8,777100
343810,367695.1,1332350,221450,234841.3,555250,122360,132853.8,777100
348160,394809.6,1332350,222300,250160.6,555250,125860,144649,777100
352430,427514.4,1332350,223130,274069.2,555250,129300,153445.2,777100
356720,433208,1332350,223990,276606.5,555250,132730,156601.5,777100
359540,504879.5,1332350,224760,319201,555250,134780,185678.5,777100
362270,547733.1,1332350,225500,337508.1,555250,136770,210225,777100
365090,583991.1,1332350,226250,354608,555250,138840,229383.1,777100
367800,602370.5,1332350,227020,365162.5,555250,140780,237208,777100
372110,573299.8,1332350,230100,349180,555250,142010,224119.8,777100
376490,588149.8,1332350,233180,353458.4,555250,143310,234691.4,777100
380790,589209.2,1332350,236270,354410,555250,144520,234799.2,777100
385120,613202.5,1332350,239340,361203.8,555250,145780,251998.7,777100
390990,610622,1332350,243280,364539.5,555250,147710,246082.5,777100
396810,617813.6,1332350,247180,370907.5,555250,149630,246906.1,777100
402610,609843,1332350,251100,369976.3,555250,151510,239866.7,777100
408480,604746.6,1332350,255030,366612.2,555250,153450,238134.4,777100
412920,609255.6,1332350,257500,371838.9,555250,155420,237416.7,777100
417500,619738,1332350,260030,380097.5,555250,157470,239640.5,777100
421990,646313.3,1332350,262490,389239.4,555250,159500,257073.9,777100
426430,623066.9,1332350,264970,375452.7,555250,161460,247614.2,777100
420670,614773.5,1332350,263650,371084.2,555250,157020,243689.3,777100
414980,597080.7,1332350,262360,365057.6,555250,152620,232023.1,777100
409190,569624.6,1332350,261040,354974.7,555250,148150,214649.9,777100
403510,575191.3,1332350,259720,359977.5,555250,143790,215213.8,777100
396340,548389.8,1332350,257270,343399.7,555250,139070,204990.1,777100
389280,514684.4,1332350,254840,326399.5,555250,134440,188284.9,777100
382170,475536.1,1332350,252400,303637.9,555250,129770,171898.2,777100
375010,447692.2,1332350,249960,292886.8,555250,125050,154805.4,777100
367980,409803.7,1332350,247440,270988.6,555250,120540,138815.1,777100
360800,380303.9,1332350,244910,260340.6,555250,115890,119963.3,777100
353710,386867.3,1332350,242390,263749.6,555250,111320,123117.7,777100
346660,384902.1,1332350,239890,267837.3,555250,106770,117064.8,777100
336920,379521.5,1332350,236780,266925.9,555250,100140,112595.6,777100
327200,414834.3,1332350,233650,289866.7,555250,93550,124967.6,777100
317420,408951.8,1332350,230540,286658.9,555250,86880,122292.9,777100
307720,365372.9,1332350,227400,263458.1,555250,80320,101914.8,777100
296340,365441.5,1332350,222500,266456,555250,73840,98985.5,777100
285080,372499.7,1332350,217610,272408.9,555250,67470,100090.8,777100
273640,310267,1332350,212710,237477.4,555250,60930,72789.6,777100
262380,276941.8,1332350,207810,219571.5,555250,54570,57370.3,777100
252050,212798,1332350,204020,184925.4,555250,48030,27872.6,777100
241810,177668.2,1332350,200280,164568.3,555250,41530,13099.9,777100
231480,159262.7,1332350,196480,151004.2,555250,35000,8258.5,777100
221230,149195.7,1332350,192730,142623.9,555250,28500,6571.8,777100
218150,157306.3,1332350,191080,151564.2,555250,27070,5742.1,777100
215070,150614.7,1332350,189440,146229.1,555250,25630,4385.6,777100
211900,157918.4,1332350,187780,152671,555250,24120,5247.4,777100
208910,172349.1,1332350,186140,165439,555250,22770,6910.1,777100
205320,150256.5,1332350,183930,146555.3,555250,21390,3701.2,777100
201720,156801.4,1332350,181720,152277.3,555250,20000,4524.1,777100
198170,158705.6,1332350,179520,154089.5,555250,18650,4616.1,777100
194560,149421,1332350,177310,145046.2,555250,17250,4374.8,777100
191090,149233.6,1332350,175120,144132.4,555250,15970,5101.2,777100
187530,160798.9,1332350,172880,154102.4,555250,14650,6696.5,777100
184060,165083.6,1332350,170660,157514,555250,13400,7569.6,777100
180450,154817,1332350,168460,148586.5,555250,11990,6230.5,777100
176950,160871,1332350,165050,153199.2,555250,11900,7671.8,777100
173400,185979.5,1332350,161600,168956.4,555250,11800,17023.1,777100
169780,200051.3,1332350,158170,175667.1,555250,11610,24384.2,777100
162640,228029.2,1332350,149610,189018.3,555250,13030,39010.9,777100
161100,233290.2,1332350,148040,191617.7,555250,13060,41672.5,777100
159630,240659.8,1332350,146490,194933.1,555250,13140,45726.7,777100
158110,216362,1332350,144930,179659.8,555250,13180,36702.2,777100
156580,211990.4,1332350,143390,176470.8,555250,13190,35519.6,777100
154980,195282.1,1332350,141790,166364.6,555250,13190,28917.5,777100
153480,198362.7,1332350,140210,167367.8,555250,13270,30994.9,777100
151930,201186.1,1332350,138620,168595.1,555250,13310,32591,777100
150360,178588.1,1332350,137000,154930.7,555250,13360,23657.4,777100
146000,163382,1332350,132760,144515.5,555250,13240,18866.5,777100
141640,143523.4,1332350,128540,129450.8,555250,13100,14072.6,777100
137320,112927.7,1332350,124300,105200.7,555250,13020,7727,777100
132930,115793.6,1332350,120070,107310.6,555250,12860,8483,777100
129190,112822.6,1332350,116350,103976.8,555250,12840,8845.8,777100
125340,98673.8,1332350,112620,91234.9,555250,12720,7438.9,777100
121530,90849.9,1332350,108910,83794.3,555250,12620,7055.6,777100
117750,97263.7,1332350,105220,87107.7,555250,12530,10156,777100
115070,77723.7,1332350,102560,69802.8,555250,12510,7920.9,777100
112310,57057.7,1332350,99920,52188.4,555250,12390,4869.3,777100
109560,53298.1,1332350,97290,48877.7,555250,12270,4420.4,777100
106820,70017.5,1332350,94650,63484.3,555250,12170,6533.2,777100
103550,77609.4,1332350,91850,71149.2,555250,11700,6460.2,777100
100340,80241.9,1332350,89030,74069.5,555250,11310,6172.4,777100
97140,65056.4,1332350,86240,60670.1,555250,10900,4386.3,777100
93820,55818.1,1332350,83410,51870.2,555250,10410,3947.9,777100
90290,47398.5,1332350,80150,44146.2,555250,10140,3252.3,777100
86680,43125.1,1332350,76890,39565.9,555250,9790,3559.2,777100
83040,35236.4,1332350,73590,32283.8,555250,9450,2952.6,777100
79350,37755.2,1332350,70310,34956.2,555250,9040,2799,777100
76680,36433.7,1332350,67790,33379.8,555250,8890,3053.9,777100
73930,32695,1332350,65240,29546.5,555250,8690,3148.5,777100
71200,25590.1,1332350,62710,22969.3,555250,8490,2620.8,777100
68450,21229.2,1332350,60160,18659.8,555250,8290,2569.4,777100
65960,15622.6,1332350,58180,13968.9,555250,7780,1653.7,777100
63560,17234.7,1332350,56220,15427,555250,7340,1807.7,777100
61070,24293.9,1332350,54220,21794,555250,6850,2499.9,777100
58590,22931.9,1332350,52260,20391.1,555250,6330,2540.8,777100
54970,14353.9,1332350,49270,12351.4,555250,5700,2002.5,777100
51410,10710.6,1332350,46280,9357.2,555250,5130,1353.4,777100
47830,11336.5,1332350,43290,10431,555250,4540,905.5,777100
44250,8564.1,1332350,40280,8084,555250,3970,480.1,777100
41180,5621.7,1332350,37310,5448.6,555250,3870,173.1,777100
38080,7000.8,1332350,34350,6830.1,555250,3730,170.7,777100
34940,5669.1,1332350,31350,5491.7,555250,3590,177.4,777100
31820,5172,1332350,28380,4820.6,555250,3440,351.4,777100
32010,2110.2,1332350,26970,1955.6,555250,5040,154.6,777100
32190,1720.7,1332350,25540,973.4,555250,6650,747.3,777100
32380,1709.2,1332350,24150,836.8,555250,8230,872.4,777100
32510,2948.8,1332350,22690,862.8,555250,9820,2086,777100
32600,3929.9,1332350,21130,1328.5,555250,11470,2601.4,777100
32790,3061.4,1332350,19540,1092.6,555250,13250,1968.8,777100
32820,5138.1,1332350,17960,2631.1,555250,14860,2507,777100
32980,7898.3,1332350,16390,4415.4,555250,16590,3482.9,777100
33480,11481.1,1332350,15090,4155.3,555250,18390,7325.8,777100
33940,15836.3,1332350,13810,5853.8,555250,20130,9982.5,777100
34400,17332.9,1332350,12520,5378,555250,21880,11954.9,777100
34890,22148.2,1332350,11240,5748.7,555250,23650,16399.5,777100
34230,20897.1,1332350,11010,4785.3,555250,23220,16111.8,777100
33710,28697.6,1332350,10760,8494.3,555250,22950,20203.3,777100
33110,30119.3,1332350,10520,9636.8,555250,22590,20482.5,777100
32500,28850.4,1332350,10240,9506.6,555250,22260,19343.8,777100
31840,27431.5,1332350,9980,6918.9,555250,21860,20512.6,777100
31080,26797.5,1332350,9740,8307.9,555250,21340,18489.6,777100
30350,25634.1,1332350,9430,4669.6,555250,20920,20964.5,777100
29690,35910.2,1332350,9170,9300,555250,20520,26610.2,777100
29300,29935.3,1332350,9240,7808.4,555250,20060,22126.9,777100
28870,39998,1332350,9310,14064.6,555250,19560,25933.4,777100
28470,46448.5,1332350,9400,16298.7,555250,19070,30149.8,777100
28050,42015.2,1332350,9460,14233.2,555250,18590,27782,777100
27420,44397.3,1332350,9920,15573.9,555250,17500,28823.4,777100
26710,36957.7,1332350,10320,12861.4,555250,16390,24096.3,777100
26010,41817.4,1332350,10740,15261.1,555250,15270,26556.3,777100
25310,36010.1,1332350,11150,11649.8,555250,14160,24360.3,777100
24820,35852.9,1332350,11620,11610.3,555250,13200,24242.6,777100
24240,37781.6,1332350,12020,12847,555250,12220,24934.6,777100
23690,34504.4,1332350,12470,14270.6,555250,11220,20233.8,777100
23080,39284.7,1332350,12880,15211.2,555250,10200,24073.5,777100
22840,34421.9,1332350,13380,13954.6,555250,9460,20467.3,777100
22460,30914.3,1332350,13850,12376.3,555250,8610,18538,777100
22120,28305.1,1332350,14330,13106.2,555250,7790,15198.9,777100
21820,24946.6,1332350,14820,12057.3,555250,7000,12889.3,777100
21920,31711.6,1332350,14700,17188.9,555250,7220,14522.7,777100
22100,34756.1,1332350,14590,19366.7,555250,7510,15389.4,777100
22280,27363.8,1332350,14500,14215,555250,7780,13148.8,777100
22420,19559.6,1332350,14370,9956.9,555250,8050,9602.7,777100
22750,18560.9,1332350,14290,8893.5,555250,8460,9667.4,777100
23020,13285.5,1332350,14210,5420.6,555250,8810,7864.9,777100
23370,10699.3,1332350,14110,3650.8,555250,9260,7048.5,777100
23740,9064.4,1332350,14020,2767.5,555250,9720,6296.9,777100
24330,11560.8,1332350,14090,4947.4,555250,10240,6613.4,777100
24870,12208.3,1332350,14150,5132.5,555250,10720,7075.8,777100
25450,18752,1332350,14230,9882.7,555250,11220,8869.3,777100
26010,23955.3,1332350,14300,13889.4,555250,11710,10065.9,777100
27380,19476.1,1332350,15180,10326.7,555250,12200,9149.4,777100
28720,15489.4,1332350,16000,7198,555250,12720,8291.4,777100
30130,21005.9,1332350,16880,9274.4,555250,13250,11731.5,777100
19430,31811.3,1332350,7710,12254.2,555250,11720,19557.1,777100
19610,29580.5,1332350,7500,10325.7,555250,12110,19254.8,777100
19800,29466.4,1332350,7320,9214.6,555250,12480,20251.8,777100
19920,31307.7,1332350,7160,10467.5,555250,12760,20840.2,777100
20080,29773.8,1332350,6940,10509.4,555250,13140,19264.4,777100
20470,28683,1332350,6890,10866.8,555250,13580,17816.2,777100
20780,27599.2,1332350,6820,10199.1,555250,13960,17400.1,777100
21190,28752.7,1332350,6790,10231.3,555250,14400,18521.4,777100
21510,25029.1,1332350,6730,7336.3,555250,14780,17692.8,777100
25160,24857.9,1332350,8480,6810.9,555250,16680,18047,777100
28890,24598.5,1332350,10260,6229.3,555250,18630,18369.2,777100
32590,26037.9,1332350,12040,6398.8,555250,20550,19639.1,777100
36240,29884,1332350,13810,6558.3,555250,22430,23325.7,777100
40340,31844,1332350,15730,7363,555250,24610,24481,777100
44360,32243.7,1332350,17640,10735.4,555250,26720,21508.3,777100
48370,48939.4,1332350,19550,18743,555250,28820,30196.4,777100
52420,60579.2,1332350,21470,21029.3,555250,30950,39549.9,777100
56380,64643.7,1332350,23410,20701.7,555250,32970,43942,777100
60410,65523.9,1332350,25360,18921.5,555250,35050,46602.4,777100
64410,65654.8,1332350,27310,18096.7,555250,37100,47558.1,777100
68410,70807.1,1332350,29280,20149.4,555250,39130,50657.7,777100
75560,82082.3,1332350,33730,25262.2,555250,41830,56820.1,777100
82860,90640.2,1332350,38220,28694.5,555250,44640,61945.7,777100
89990,101651.4,1332350,42680,35268.9,555250,47310,66382.5,777100
97260,114545.3,1332350,47190,42844.3,555250,50070,71701,777100
105830,115684.2,1332350,52970,44841,555250,52860,70843.2,777100
114480,132850.5,1332350,58720,54909.7,555250,55760,77940.8,777100
123080,154175.7,1332350,64520,66134.8,555250,58560,88040.9,777100
131690,157250,1332350,70300,64656.8,555250,61390,92593.2,777100
138960,169770.8,1332350,74330,71714.9,555250,64630,98055.9,777100
146270,195217.5,1332350,78390,84901.5,555250,67880,110316,777100
153660,201966.6,1332350,82430,86965.1,555250,71230,115001.5,777100
160990,199817.8,1332350,86490,88494.9,555250,74500,111322.9,777100
159360,189950.4,1332350,86700,90352.3,555250,72660,99598.1,777100
157820,184931.7,1332350,86950,94257.8,555250,70870,90673.9,777100
156240,175597.2,1332350,87180,96053.4,555250,69060,79543.8,777100
154650,195179.2,1332350,87420,112317.2,555250,67230,82862,777100
151380,167927.8,1332350,88040,100652.6,555250,63340,67275.2,777100
148090,126530.8,1332350,88660,79106.2,555250,59430,47424.6,777100
144820,101027.7,1332350,89300,68104.4,555250,55520,32923.3,777100
141470,98164.3,1332350,89910,67224.7,555250,51560,30939.6,777100
135440,83437.5,1332350,87150,58526,555250,48290,24911.5,777100
129310,69196.1,1332350,84340,49436.1,555250,44970,19760,777100
123310,64166.3,1332350,81620,46592,555250,41690,17574.3,777100
117150,70738.6,1332350,78810,50332.9,555250,38340,20405.7,777100
116580,77101.7,1332350,75290,49619.5,555250,41290,27482.2,777100
115930,79530.7,1332350,71750,47921,555250,44180,31609.7,777100
115330,86243.3,1332350,68220,49628.1,555250,47110,36615.2,777100
114690,82839.2,1332350,64690,47516.6,555250,50000,35322.6,777100
115500,74611.4,1332350,62640,39837.9,555250,52860,34773.5,777100
116280,86117.3,1332350,60560,41854.4,555250,55720,44262.9,777100
117000,78522.5,1332350,58460,35864,555250,58540,42658.5,777100
117840,69242.6,1332350,56400,29568.6,555250,61440,39674,777100
121110,59630.2,1332350,56300,22605.4,555250,64810,37024.8,777100
124520,61465.3,1332350,56210,23722.9,555250,68310,37742.4,777100
127880,56409.8,1332350,56110,19054.6,555250,71770,37355.2,777100
131190,52816.9,1332350,55980,16483.1,555250,75210,36333.8,777100
136220,49795.5,1332350,59920,12232.2,555250,76300,37563.3,777100
141230,39929.3,1332350,63910,7526.8,555250,77320,32402.5,777100
146270,37634.3,1332350,67890,6727.8,555250,78380,30906.5,777100
151280,37458.4,1332350,71850,9020.7,555250,79430,28437.7,777100
164960,40260.5,1332350,84710,13075.8,555250,80250,27184.7,777100
178630,65435.2,1332350,97540,31145.1,555250,81090,34290.1,777100
192290,65379.5,1332350,110390,36835.6,555250,81900,28543.9,777100
206000,55422.1,1332350,123270,26942.4,555250,82730,28479.7,777100
207310,52432.6,1332350,124400,24316,555250,82910,28116.6,777100
208720,60028.7,1332350,125560,31014.7,555250,83160,29014,777100
210070,67004.7,1332350,126700,38680.8,555250,83370,28323.9,777100
211470,53197.4,1332350,127850,29364.6,555250,83620,23832.8,777100
212060,24565.8,1332350,131000,7595.6,555250,81060,16970.2,777100
212620,21889.1,1332350,134180,5458.4,555250,78440,16430.7,777100
213190,23271.5,1332350,137310,6388.6,555250,75880,16882.9,777100
213830,24910,1332350,140470,5837.9,555250,73360,19072.1,777100
209910,42223.9,1332350,139410,24267.7,555250,70500,17956.2,777100
206000,34959.3,1332350,138360,20999.8,555250,67640,13959.5,777100
202080,25886.6,1332350,137280,18272.6,555250,64800,7614,777100
198220,23512.5,1332350,136240,15682.4,555250,61980,7830.1,777100
194670,22267.8,1332350,135610,14869,555250,59060,7398.8,777100
191040,23078.7,1332350,134930,14449.9,555250,56110,8628.8,777100
187470,21749.5,1332350,134270,11943.7,555250,53200,9805.8,777100
183920,33538.3,1332350,133620,23237.7,555250,50300,10300.6,777100
178680,69315.6,1332350,130470,57508.5,555250,48210,11807.1,777100
173480,106874.6,1332350,127320,85307.7,555250,46160,21566.9,777100
168210,160041.8,1332350,124150,114440.8,555250,44060,45601,777100
162940,225036.7,1332350,120980,148700.9,555250,41960,76335.8,777100
160970,184974.6,1332350,120310,121600.1,555250,40660,63374.5,777100
159080,326755,1332350,119620,198703.3,555250,39460,128051.7,777100
157090,347467.3,1332350,118930,189052.6,555250,38160,158414.7,777100
155110,305580.8,1332350,118250,149704.5,555250,36860,155876.3,777100
154090,431223.2,1332350,118470,219408.5,555250,35620,211814.7,777100
153120,596480,1332350,118710,305628.6,555250,34410,290851.4,777100
152110,675371.5,1332350,118930,346644.8,555250,33180,328726.7,777100
151090,699018.7,1332350,119140,362956.5,555250,31950,336062.2,777100
152460,779846.9,1332350,120570,417640.9,555250,31890,362206,777100
153670,786724.1,1332350,122000,421716.5,555250,31670,365007.6,777100
155030,761435.2,1332350,123440,405018.2,555250,31590,356417,777100
404280,688716.1,1332350,262230,392362.5,555250,142050,296353.6,777100
401030,690328.1,1332350,260030,400455.3,555250,141000,289872.8,777100
397770,674852.2,1332350,257840,397484.6,555250,139930,277367.6,777100
394480,638000.7,1332350,255630,391491.4,555250,138850,246509.3,777100
391250,637872.1,1332350,253430,394434.5,555250,137820,243437.6,777100
388170,635150.4,1332350,251100,393969.4,555250,137070,241181,777100
385130,615467.2,1332350,248770,381750.9,555250,136360,233716.3,777100
382060,607251.5,1332350,246450,372528.6,555250,135610,234722.9,777100
378950,591609.7,1332350,244120,365681.8,555250,134830,225927.9,777100
360890,599559.2,1332350,232340,373765.6,555250,128550,225793.6,777100
342640,601838,1332350,220550,371430.4,555250,122090,230407.6,777100
324470,615357.3,1332350,208760,378145.2,555250,115710,237212.1,777100
306350,580037.8,1332350,197010,356822.6,555250,109340,223215.2,777100
288740,546253.3,1332350,185720,331423.4,555250,103020,214829.9,777100
271280,471119,1332350,174470,284675.3,555250,96810,186443.7,777100
253590,369189.8,1332350,163160,226264.5,555250,90430,142925.3,777100
236100,304543.7,1332350,151920,187051.9,555250,84180,117491.8,777100
218320,278256.8,1332350,140410,174475.9,555250,77910,103780.9,777100
200650,266836.9,1332350,128870,167823.3,555250,71780,99013.6,777100
182890,234366.9,1332350,117340,148801,555250,65550,85565.9,777100
165170,233144.9,1332350,105820,147341.9,555250,59350,85803,777100
153940,230224.1,1332350,98540,144042.5,555250,55400,86181.6,777100
142760,218730.2,1332350,91280,136932.7,555250,51480,81797.5,777100
131490,189261.5,1332350,83990,117002.2,555250,47500,72259.3,777100
120290,198724.3,1332350,76700,121690.4,555250,43590,77033.9,777100
109650,153864.4,1332350,69820,95415.6,555250,39830,58448.8,777100
98940,127855.7,1332350,62900,79837.3,555250,36040,48018.4,777100
88230,128115.5,1332350,56010,78195.3,555250,32220,49920.2,777100
77600,135581.3,1332350,49130,78838.1,555250,28470,56743.2,777100
66980,123427.3,1332350,42300,67451.9,555250,24680,55975.4,777100
56410,107936.9,1332350,35470,57788.2,555250,20940,50148.7,777100
45730,92873.4,1332350,28640,48487.8,555250,17090,44385.6,777100
35150,65502.9,1332350,21840,34372.5,555250,13310,31130.4,777100
32310,50981.9,1332350,20190,26342.1,555250,12120,24639.8,777100
29470,50035.8,1332350,18500,25864.3,555250,10970,24171.5,777100
26580,44728.2,1332350,16860,21505,555250,9720,23223.2,777100
23710,41869.4,1332350,15160,20079.4,555250,8550,21790,777100
21470,44330.3,1332350,13640,22471.5,555250,7830,21858.8,777100
19130,33875.7,1332350,12080,18130.7,555250,7050,15745,777100
16850,24853.3,1332350,10530,12873.7,555250,6320,11979.6,777100
14570,19133.9,1332350,8970,8975.8,555250,5600,10158.1,777100
12100,20363.2,1332350,7340,9102,555250,4760,11261.2,777100
9550,23230.6,1332350,5700,10680.8,555250,3850,12549.8,777100
7130,21553,1332350,4070,9040.6,555250,3060,12512.4,777100
4660,14737.5,1332350,2440,5558.2,555250,2220,9179.3,777100
4640,13589.7,1332350,2310,3848.4,555250,2330,9741.3,777100
4710,16443.8,1332350,2220,3731.8,555250,2490,12712,777100
4800,12265.9,1332350,2090,1147.5,555250,2710,11118.4,777100
4810,9028.6,1332350,1960,566.4,555250,2850,8462.2,777100
5500,11047.5,1332350,2000,1018.4,555250,3500,10029.1,777100
6210,9874.9,1332350,2060,1088.5,555250,4150,8786.4,777100
6900,10540.3,1332350,2090,895.3,555250,4810,9645,777100
7620,12373.5,1332350,2130,1152.1,555250,5490,11221.4,777100
8000,13350.7,1332350,2200,1277.5,555250,5800,12073.2,777100
8330,13709.6,1332350,2230,1741.9,555250,6100,11967.7,777100
8740,15355.4,1332350,2280,2358.8,555250,6460,12996.6,777100
9090,17295.1,1332350,2310,1888.1,555250,6780,15407,777100
10230,18286.9,1332350,2520,2108.1,555250,7710,16178.8,777100
11370,14870.4,1332350,2700,1805.9,555250,8670,13064.5,777100
12450,12397.6,1332350,2890,1536.3,555250,9560,10861.3,777100
13550,11032.6,1332350,3070,1320.8,555250,10480,9711.8,777100
14990,9454.2,1332350,4090,1385.3,555250,10900,8068.9,777100
16450,8799.3,1332350,5110,1209.6,555250,11340,7589.7,777100
18020,9150.6,1332350,6160,1145.3,555250,11860,8005.3,777100
19450,9681.8,1332350,7190,1243.5,555250,12260,8438.3,777100
20520,9674.5,1332350,8160,812.5,555250,12360,8862,777100
21550,12099.1,1332350,9130,3407.5,555250,12420,8691.6,777100
22700,10565.2,1332350,10120,2039.1,555250,12580,8526.1,777100
23760,11646.6,1332350,11110,2680.4,555250,12650,8966.2,777100
25750,11238.5,1332350,12560,3099.8,555250,13190,8138.7,777100
27760,8442.5,1332350,14020,1768.7,555250,13740,6673.8,777100
29770,8381.7,1332350,15460,1411.3,555250,14310,6970.4,777100
31770,10246.7,1332350,16920,1807.3,555250,14850,8439.4,777100
33030,10434,1332350,17650,2105.3,555250,15380,8328.7,777100
34310,11947.8,1332350,18360,2557.2,555250,15950,9390.6,777100
35630,15470.2,1332350,19110,4630.1,555250,16520,10840.1,777100
36860,19391.8,1332350,19850,7701.9,555250,17010,11689.9,777100
39460,24981.9,1332350,21420,11504.8,555250,18040,13477.1,777100
42130,27804.8,1332350,23020,13735.9,555250,19110,14068.9,777100
44730,27872.4,1332350,24590,14382.1,555250,20140,13490.3,777100
47380,32665.2,1332350,26170,17882.6,555250,21210,14782.6,777100
48890,34680.3,1332350,26670,19440.3,555250,22220,15240,777100
50360,39059,1332350,27120,22477.5,555250,23240,16581.5,777100
51940,44714.9,1332350,27620,26115,555250,24320,18599.9,777100
53450,46938.5,1332350,28080,27309.4,555250,25370,19629.1,777100
55820,52387.5,1332350,29290,30530.2,555250,26530,21857.3,777100
58180,55208,1332350,30490,31636.7,555250,27690,23571.3,777100
60630,66072.1,1332350,31690,36744.1,555250,28940,29328,777100
62990,72171,1332350,32890,39340.1,555250,30100,32830.9,777100
65020,90376.1,1332350,33710,47432,555250,31310,42944.1,777100
66940,108404.2,1332350,34530,55733.6,555250,32410,52670.6,777100
68960,126072.4,1332350,35350,64058.1,555250,33610,62014.3,777100
70900,125732.2,1332350,36180,62333.6,555250,34720,63398.6,777100
72960,138858.5,1332350,37740,71341.6,555250,35220,67516.9,777100
74950,165070.5,1332350,39310,86930.6,555250,35640,78139.9,777100
76960,161428.8,1332350,40860,84316.8,555250,36100,77112,777100
38290,171737.8,1332350,14490,82671.5,555250,23800,89066.3,777100
39440,168905.9,1332350,14690,79032.6,555250,24750,89873.3,777100
40570,172682.9,1332350,14870,75084.9,555250,25700,97598,777100
41620,197809.1,1332350,15050,85912.8,555250,26570,111896.3,777100
42790,225245.1,1332350,15220,98775.6,555250,27570,126469.5,777100
43640,250582.8,1332350,15130,107243,555250,28510,143339.8,777100
44640,259189.5,1332350,15080,107387.8,555250,29560,151801.7,777100
45480,273625.2,1332350,14980,120515.2,555250,30500,153110,777100
46430,287605.5,1332350,14910,131840.1,555250,31520,155765.4,777100
48550,251618.7,1332350,16050,116088,555250,32500,135530.7,777100
50580,250379.6,1332350,17220,119358.4,555250,33360,131021.2,777100
52630,246894.2,1332350,18350,120495.5,555250,34280,126398.7,777100
54730,221593.6,1332350,19500,107560.9,555250,35230,114032.7,777100
57550,165214.7,1332350,20930,70529.6,555250,36620,94685.1,777100
60430,187908.2,1332350,22340,77628.7,555250,38090,110279.5,777100
63310,189187.7,1332350,23770,74488.7,555250,39540,114699,777100
66180,216947.9,1332350,25190,86150.2,555250,40990,130797.7,777100
68200,238682.1,1332350,26300,98160.4,555250,41900,140521.7,777100
70200,260273.5,1332350,27400,111889.3,555250,42800,148384.2,777100
72220,257062.1,1332350,28500,110792.7,555250,43720,146269.4,777100
74260,232511.1,1332350,29600,100039,555250,44660,132472.1,777100
78710,226497.9,1332350,33240,103875.1,555250,45470,122622.8,777100
83280,221401.6,1332350,36860,103966,555250,46420,117435.6,777100
87790,218104.5,1332350,40500,105967.5,555250,47290,112137,777100
92280,205321.2,1332350,44120,102247.2,555250,48160,103074,777100
100350,187056.5,1332350,49950,94766.4,555250,50400,92290.1,777100
108310,193128.4,1332350,55770,96871,555250,52540,96257.4,777100
116420,203568.2,1332350,61600,102068.9,555250,54820,101499.3,777100
124420,201839.3,1332350,67430,102287.8,555250,56990,99551.5,777100
126900,200456,1332350,70080,104064.7,555250,56820,96391.3,777100
129350,173562.1,1332350,72700,89732.9,555250,56650,83829.2,777100
131760,159247.5,1332350,75340,83820.1,555250,56420,75427.4,777100
134260,141215.4,1332350,77980,74064.1,555250,56280,67151.3,777100
135110,109742.7,1332350,81340,60419.5,555250,53770,49323.2,777100
135860,99315.1,1332350,84740,58881,555250,51120,40434.1,777100
136710,89575.7,1332350,88120,56646.7,555250,48590,32929,777100
137590,98806.9,1332350,91550,63132.4,555250,46040,35674.5,777100
140900,136582.5,1332350,94950,86479.8,555250,45950,50102.7,777100
144120,156138.1,1332350,98360,99664.7,555250,45760,56473.4,777100
147430,194990.2,1332350,101800,123430.6,555250,45630,71559.6,777100
150690,217281.3,1332350,105200,138251.1,555250,45490,79030.2,777100
153040,223856.6,1332350,107950,142942.8,555250,45090,80913.8,777100
155400,231451.9,1332350,110740,148009.5,555250,44660,83442.4,777100
157700,225638.6,1332350,113500,147093.6,555250,44200,78545,777100
160030,211144.1,1332350,116260,140673.9,555250,43770,70470.2,777100
165030,213870.7,1332350,117560,142533.3,555250,47470,71337.4,777100
170010,210356.2,1332350,118890,139035.4,555250,51120,71320.8,777100
174880,210485.5,1332350,120180,135810,555250,54700,74675.5,777100
179930,223782.5,1332350,121500,137130.8,555250,58430,86651.7,777100
183400,271295.1,1332350,121710,159502.1,555250,61690,111793,777100
186780,291627.5,1332350,121910,168118.4,555250,64870,123509.1,777100
190220,292295.2,1332350,122140,169910,555250,68080,122385.2,777100
193620,284230.6,1332350,122360,167260.6,555250,71260,116970,777100
195660,293252.9,1332350,120940,173040.1,555250,74720,120212.8,777100
197610,323028.7,1332350,119510,189574.2,555250,78100,133454.5,777100
199690,321633.8,1332350,118110,186319.2,555250,81580,135314.6,777100
201620,294054.7,1332350,116690,169815.5,555250,84930,124239.2,777100
206430,282852.6,1332350,118900,160656.1,555250,87530,122196.5,777100
211180,245968.9,1332350,121060,142529.1,555250,90120,103439.8,777100
215960,194161.1,1332350,123250,111647.3,555250,92710,82513.8,777100
220670,210829.9,1332350,125420,118375.4,555250,95250,92454.5,777100
226550,230022.1,1332350,128450,129009.3,555250,98100,101012.8,777100
232460,238338.6,1332350,131530,133538.8,555250,100930,104799.8,777100
238290,240270.5,1332350,134560,136898.1,555250,103730,103372.4,777100
244170,235252.4,1332350,137620,136495.7,555250,106550,98756.7,777100
252700,222338.7,1332350,142890,125147.8,555250,109810,97190.9,777100
261120,181266.7,1332350,148130,103441.8,555250,112990,77824.9,777100
269690,175086.8,1332350,153400,96251.1,555250,116290,78835.7,777100
278220,188633.1,1332350,158660,104404.1,555250,119560,84229,777100
277790,197620.6,1332350,159150,110865,555250,118640,86755.6,777100
277450,186189.8,1332350,159640,103459,555250,117810,82730.8,777100
276990,173905.2,1332350,160120,98099.3,555250,116870,75805.9,777100
276670,161308.6,1332350,160610,87853.2,555250,116060,73455.4,777100
274690,134318,1332350,160080,71426.2,555250,114610,62891.8,777100
272870,117451.1,1332350,159550,62560,555250,113320,54891.1,777100
270970,102991.5,1332350,159010,56662.6,555250,111960,46328.9,777100
269160,92725.2,1332350,158470,54238,555250,110690,38487.2,777100
267830,91296.1,1332350,158340,53403.5,555250,109490,37892.6,777100
266540,74826,1332350,158230,47827.1,555250,108310,26998.9,777100
265210,76242,1332350,158080,45955.9,555250,107130,30286.1,777100
263950,67980.6,1332350,157950,38977.2,555250,106000,29003.4,777100
258740,42772.2,1332350,154920,20865.4,555250,103820,21906.8,777100
253530,42843.2,1332350,151890,20521.4,555250,101640,22321.8,777100
248410,39475.4,1332350,148910,17565.5,555250,99500,21909.9,777100
243170,40495.7,1332350,145870,21865.5,555250,97300,18630.2,777100
235340,47412.7,1332350,140160,33931.1,555250,95180,13481.6,777100
227580,53520.6,1332350,134470,38383.2,555250,93110,15137.4,777100
219700,71013.8,1332350,128770,52606,555250,90930,18407.8,777100
211930,82887.5,1332350,123050,58916.7,555250,88880,23970.8,777100
206880,98821.6,1332350,119570,67837.2,555250,87310,30984.4,777100
201900,101778.2,1332350,116110,70252.3,555250,85790,31525.9,777100
196880,102753.7,1332350,112650,67614,555250,84230,35139.7,777100
191860,95237.5,1332350,109170,64849.6,555250,82690,30387.9,777100
190770,97687.1,1332350,108750,65036,555250,82020,32651.1,777100
189630,110769,1332350,108340,71240.2,555250,81290,39528.8,777100
188390,111507.8,1332350,107910,70329,555250,80480,41178.8,777100
249800,104013,1332350,131040,61686.6,555250,118760,42326.4,777100
247690,86653.8,1332350,129450,49659.1,555250,118240,36994.7,777100
245540,61799.2,1332350,127860,35530.6,555250,117680,26268.6,777100
243440,55642.6,1332350,126220,29990.9,555250,117220,25651.7,777100
241300,62879.6,1332350,124620,34173.2,555250,116680,28706.4,777100
238940,89989.7,1332350,122230,50599.6,555250,116710,39390.1,777100
236550,116092.3,1332350,119880,65082.8,555250,116670,51009.5,777100
234190,135210.6,1332350,117490,77532.1,555250,116700,57678.5,777100
231790,151246.6,1332350,115130,87735.9,555250,116660,63510.7,777100
230340,154581.3,1332350,114160,91981.8,555250,116180,62599.5,777100
228910,154100.1,1332350,113210,89240.4,555250,115700,64859.7,777100
227430,132444,1332350,112230,74034.2,555250,115200,58409.8,777100
225950,143997,1332350,111240,81511.7,555250,114710,62485.3,777100
223960,172794.6,1332350,110040,98465.1,555250,113920,74329.5,777100
222030,178211.6,1332350,108850,101197.6,555250,113180,77014,777100
220130,153527.4,1332350,107610,87043.5,555250,112520,66483.9,777100
218140,145121,1332350,106410,80145.7,555250,111730,64975.3,777100
215910,128918.6,1332350,105530,68657.7,555250,110380,60260.9,777100
213740,126819.7,1332350,104640,65409.6,555250,109100,61410.1,777100
211510,134723.5,1332350,103760,72293.8,555250,107750,62429.7,777100
209290,125033,1332350,102880,67607.8,555250,106410,57425.2,777100
205110,112253.1,1332350,100640,58310.9,555250,104470,53942.2,777100
200890,104480.6,1332350,98390,54392.4,555250,102500,50088.2,777100
196670,91140.3,1332350,96170,46951.9,555250,100500,44188.4,777100
192470,82113.1,1332350,93900,42572.8,555250,98570,39540.3,777100
188100,86252.8,1332350,91250,44786.2,555250,96850,41466.6,777100
183810,83809.9,1332350,88580,41866.7,555250,95230,41943.2,777100
179540,83533.7,1332350,85950,41215.6,555250,93590,42318.1,777100
175160,86233,1332350,83290,41973.7,555250,91870,44259.3,777100
171180,91211.2,1332350,80850,43621.4,555250,90330,47589.8,777100
167000,85587.8,1332350,78350,42340.7,555250,88650,43247.1,777100
162950,75760.5,1332350,75930,37852.3,555250,87020,37908.2,777100
158920,75608.5,1332350,73490,38071.7,555250,85430,37536.8,777100
154870,64246.7,1332350,70840,33481.8,555250,84030,30764.9,777100
150860,57645.4,1332350,68170,29778.1,555250,82690,27867.3,777100
146820,57122.3,1332350,65540,27507.9,555250,81280,29614.4,777100
142820,53046.7,1332350,62890,24333.3,555250,79930,28713.4,777100
139990,57062.8,1332350,60160,25200.2,555250,79830,31862.6,777100
137250,63817.7,1332350,57460,26722.9,555250,79790,37094.8,777100
134430,68073.6,1332350,54740,25986.9,555250,79690,42086.7,777100
131580,73223.7,1332350,52020,27663.3,555250,79560,45560.4,777100
128750,78721.3,1332350,49250,30148.3,555250,79500,48573,777100
125850,79497.5,1332350,46450,30664.1,555250,79400,48833.4,777100
122970,80558.9,1332350,43720,32274.1,555250,79250,48284.8,777100
120100,74140.6,1332350,40950,27558,555250,79150,46582.6,777100
117350,64338.6,1332350,39440,23030.9,555250,77910,41307.7,777100
114670,54372.5,1332350,37940,18596.4,555250,76730,35776.1,777100
111990,51437.9,1332350,36460,16082.5,555250,75530,35355.4,777100
109230,38676.6,1332350,34920,8651.2,555250,74310,30025.4,777100
105760,39313.4,1332350,32470,7426.1,555250,73290,31887.3,777100
102280,37302.7,1332350,30010,5387.3,555250,72270,31915.4,777100
98700,43828.4,1332350,27520,7011.3,555250,71180,36817.1,777100
95220,43583.5,1332350,25060,7048.3,555250,70160,36535.2,777100
92260,38695.7,1332350,22870,5015.4,555250,69390,33680.3,777100
89260,42751.6,1332350,20670,5665.8,555250,68590,37085.8,777100
86290,44723.8,1332350,18500,5855.3,555250,67790,38868.5,777100
83210,46317.6,1332350,16280,5790.4,555250,66930,40527.2,777100
81350,46072.6,1332350,15890,5735.8,555250,65460,40336.8,777100
79490,42540.9,1332350,15500,5445.9,555250,63990,37095,777100
77450,36082,1332350,15080,5015.5,555250,62370,31066.5,777100
75560,38116.9,1332350,14670,5217.2,555250,60890,32899.7,777100
73590,35801.7,1332350,14180,4494.7,555250,59410,31307,777100
71690,36516.2,1332350,13690,4280.5,555250,58000,32235.7,777100
69610,33333.7,1332350,13180,3986,555250,56430,29347.7,777100
67580,32463.9,1332350,12690,4085.4,555250,54890,28378.5,777100
65400,34777.6,1332350,11850,4575.6,555250,53550,30202,777100
63260,32493.7,1332350,11010,3905.3,555250,52250,28588.4,777100
61070,32400.9,1332350,10130,3820.4,555250,50940,28580.5,777100
58910,33150.9,1332350,9300,4146.5,555250,49610,29004.4,777100
57220,31915.5,1332350,8960,4182.5,555250,48260,27733,777100
55550,34070,1332350,8570,5272.7,555250,46980,28797.3,777100
53870,34665.8,1332350,8250,5944.3,555250,45620,28721.5,777100
52250,30991.9,1332350,7890,5139.5,555250,44360,25852.4,777100
50350,33801.2,1332350,7490,7126.6,555250,42860,26674.6,777100
48380,32549.9,1332350,7080,7113.1,555250,41300,25436.8,777100
46550,31921,1332350,6720,7070.3,555250,39830,24850.7,777100
44620,35594.3,1332350,6340,9414.2,555250,38280,26180.1,777100
42740,36668.4,1332350,6210,9893.8,555250,36530,26774.6,777100
40810,31788.3,1332350,6140,7623.4,555250,34670,24164.9,777100
38980,29013.9,1332350,6050,5514.3,555250,32930,23499.6,777100
37060,27515.8,1332350,5950,4792,555250,31110,22723.8,777100
36930,26182.2,1332350,6620,4111.4,555250,30310,22070.8,777100
36710,26141.8,1332350,7240,3592.1,555250,29470,22549.7,777100
36510,27454.6,1332350,7880,4347.1,555250,28630,23107.5,777100
36310,28242.7,1332350,8540,5387,555250,27770,22855.7,777100
36360,26054.9,1332350,9440,4663,555250,26920,21391.9,777100
36360,21294.6,1332350,10330,3112.4,555250,26030,18182.2,777100
36420,14358.4,1332350,11230,1624.2,555250,25190,12734.2,777100
36460,11304.2,1332350,12130,909.9,555250,24330,10394.3,777100
37930,9546,1332350,14130,997,555250,23800,8549,777100
39580,9162.3,1332350,16130,983.7,555250,23450,8178.6,777100
41020,9801.9,1332350,18130,996.3,555250,22890,8805.6,777100
42530,14297.8,1332350,20090,3275.5,555250,22440,11022.3,777100
47980,13739.4,1332350,26380,5465.9,555250,21600,8273.5,777100
53340,11783.3,1332350,32670,4459.2,555250,20670,7324.1,777100
58720,10729.8,1332350,38990,5460.9,555250,19730,5268.9,777100
35800,11860.8,1332350,29050,7743.3,555250,6750,4117.5,777100
40410,11148.1,1332350,33980,8377.4,555250,6430,2770.7,777100
44950,10593.3,1332350,38880,8567.6,555250,6070,2025.7,777100
49590,11933.7,1332350,43810,10182.2,555250,5780,1751.5,777100
54190,16724.4,1332350,48730,14753.2,555250,5460,1971.2,777100
59180,24373.7,1332350,54080,22436.9,555250,5100,1936.8,777100
64310,34355.2,1332350,59480,32131.8,555250,4830,2223.4,777100
69370,35870.9,1332350,64840,33557.7,555250,4530,2313.2,777100
74460,39451.9,1332350,70230,36944.2,555250,4230,2507.7,777100
78820,47789.9,1332350,73570,44330.8,555250,5250,3459.1,777100
83170,50969.9,1332350,76880,46796.6,555250,6290,4173.3,777100
87490,56364.7,1332350,80220,53343.4,555250,7270,3021.3,777100
91870,65115.4,1332350,83560,62360.6,555250,8310,2754.8,777100
97860,67728.9,1332350,88420,65284.1,555250,9440,2444.8,777100
103820,72753.4,1332350,93310,69831.6,555250,10510,2921.8,777100
109750,75229.2,1332350,98200,72187.9,555250,11550,3041.3,777100
115740,76132.3,1332350,103060,73361.3,555250,12680,2771,777100
121420,76589.9,1332350,107550,73781.8,555250,13870,2808.1,777100
127010,72887.3,1332350,112040,70061.4,555250,14970,2825.9,777100
132700,61710.4,1332350,116530,58785.1,555250,16170,2925.3,777100
138380,55379.6,1332350,121040,52206.7,555250,17340,3172.9,777100
138680,48767.7,1332350,120210,45615,555250,18470,3152.7,777100
139000,44105.7,1332350,119390,40367.4,555250,19610,3738.3,777100
139350,40722.1,1332350,118550,36435.9,555250,20800,4286.2,777100
139600,32907.4,1332350,117720,28436.6,555250,21880,4470.8,777100
142290,33357.2,1332350,118990,28533.8,555250,23300,4823.4,777100
144910,41402.8,1332350,120280,35800.8,555250,24630,5602,777100
147570,48067,1332350,121560,41298,555250,26010,6769,777100
150250,55510.3,1332350,122860,46755.8,555250,27390,8754.5,777100
151730,58830.8,1332350,122690,47445.5,555250,29040,11385.3,777100
153230,53927.3,1332350,122570,41243.1,555250,30660,12684.2,777100
154790,54991.7,1332350,122410,41416,555250,32380,13575.7,777100
156250,58012.4,1332350,122250,42842.8,555250,34000,15169.6,777100
159280,64961.1,1332350,125280,49657.9,555250,34000,15303.2,777100
162330,76349.4,1332350,128330,60623.4,555250,34000,15726,777100
165340,84814.1,1332350,131340,69491.4,555250,34000,15322.7,777100
168340,85350.5,1332350,134370,71665.1,555250,33970,13685.4,777100
162660,84679,1332350,129910,73396.6,555250,32750,11282.4,777100
156910,97197.6,1332350,125440,85304.6,555250,31470,11893,777100
151160,90084.1,1332350,120950,80091.1,555250,30210,9993,777100
145500,80659.4,1332350,116500,71813.5,555250,29000,8845.9,777100
146670,71954.9,1332350,118050,61862.4,555250,28620,10092.5,777100
147870,67783.4,1332350,119650,57880.9,555250,28220,9902.5,777100
149120,87905.8,1332350,121250,77583.4,555250,27870,10322.4,777100
150350,103601.6,1332350,122830,91465.6,555250,27520,12136,777100
151960,95937,1332350,122830,83161.5,555250,29130,12775.5,777100
153660,83311,1332350,122810,69127.1,555250,30850,14183.9,777100
155340,74483.9,1332350,122810,61375.9,555250,32530,13108,777100
157010,108772.4,1332350,122820,90187.8,555250,34190,18584.6,777100
159680,97523.9,1332350,123660,82697.7,555250,36020,14826.2,777100
162280,105162,1332350,124480,90531.7,555250,37800,14630.3,777100
164940,94521.9,1332350,125320,81932.9,555250,39620,12589,777100
167620,76641.9,1332350,126170,68919.8,555250,41450,7722.1,777100
167540,54731.6,1332350,124470,48390.2,555250,43070,6341.4,777100
167550,48262.9,1332350,122820,41691,555250,44730,6571.9,777100
167530,61661.9,1332350,121170,55128.9,555250,46360,6533,777100
167480,73282.9,1332350,119500,63507,555250,47980,9775.9,777100
164820,97744.1,1332350,117390,80861.8,555250,47430,16882.3,777100
162130,124211,1332350,115260,95787.2,555250,46870,28423.8,777100
159550,169662.1,1332350,113120,122273.3,555250,46430,47388.8,777100
156910,195312,1332350,111000,136009.4,555250,45910,59302.6,777100
155650,220765.8,1332350,109980,151215.5,555250,45670,69550.3,777100
154310,235785.8,1332350,108950,160293.6,555250,45360,75492.2,777100
153050,206576.3,1332350,107920,142899.8,555250,45130,63676.5,777100
151700,163013.4,1332350,106870,116781.7,555250,44830,46231.7,777100
148550,150176,1332350,103760,104241.1,555250,44790,45934.9,777100
145450,183562.8,1332350,100680,125229.4,555250,44770,58333.4,777100
142220,266596.5,1332350,97580,171847.1,555250,44640,94749.4,777100
139140,263659.2,1332350,94500,165386.9,555250,44640,98272.3,777100
136380,252823.2,1332350,92820,159587.3,555250,43560,93235.9,777100
133640,228733.8,1332350,91160,144074,555250,42480,84659.8,777100
130990,240196.7,1332350,89520,152656,555250,41470,87540.7,777100
128280,272027.7,1332350,87890,170104.9,555250,40390,101922.8,777100
126030,311594.1,1332350,86670,190060.7,555250,39360,121533.4,777100
123790,386768.8,1332350,85470,233378.2,555250,38320,153390.6,777100
121550,426808.2,1332350,84280,255919.5,555250,37270,170888.7,777100
119290,443537.5,1332350,83090,263332.4,555250,36200,180205.1,777100
117930,397492.9,1332350,82890,235769.1,555250,35040,161723.8,777100
116530,397275.4,1332350,82660,231943.9,555250,33870,165331.5,777100
115120,370460.9,1332350,82440,220184.1,555250,32680,150276.8,777100
113750,284396,1332350,82200,168243.2,555250,31550,116152.8,777100
112090,242013.8,1332350,79700,148339.8,555250,32390,93674,777100
110370,211908,1332350,77170,130995.2,555250,33200,80912.8,777100
108780,160235.7,1332350,74650,100411,555250,34130,59824.7,777100
107110,148751.8,1332350,72150,89666.6,555250,34960,59085.2,777100
104310,120663.6,1332350,68850,69924,555250,35460,50739.6,777100
101650,127221.2,1332350,65540,73078.1,555250,36110,54143.1,777100
98910,128542.3,1332350,62240,70257.1,555250,36670,58285.2,777100
96190,127632.5,1332350,58930,69135.6,555250,37260,58496.9,777100
95700,117869.4,1332350,57240,59478.7,555250,38460,58390.7,777100
95280,119910,1332350,55580,56733.7,555250,39700,63176.3,777100
94800,152616.7,1332350,53920,73712.1,555250,40880,78904.6,777100
94320,135546.2,1332350,52210,62857.3,555250,42110,72688.9,777100
95350,135994.4,1332350,51850,59567.4,555250,43500,76427,777100
96410,125137.2,1332350,51470,53919.9,555250,44940,71217.3,777100
97430,133950.4,1332350,51100,59799.4,555250,46330,74151,777100
164920,134171.2,1332350,77590,58774,555250,87330,75397.2,777100
164800,122367.7,1332350,77870,55378.9,555250,86930,66988.8,777100
164750,137790.4,1332350,78170,64616.6,555250,86580,73173.8,777100
164580,154885.5,1332350,78470,73959.4,555250,86110,80926.1,777100
164430,142882,1332350,78740,66138.3,555250,85690,76743.7,777100
164910,136552.2,1332350,79780,62794.8,555250,85130,73757.4,777100
165200,133725.2,1332350,80780,60390.7,555250,84420,73334.5,777100
165570,126904.9,1332350,81790,57866.3,555250,83780,69038.6,777100
165960,155500.4,1332350,82800,74313.1,555250,83160,81187.3,777100
166620,213272.6,1332350,85620,111175.6,555250,81000,102097,777100
167290,246776.2,1332350,88500,133587.6,555250,78790,113188.6,777100
167980,285720.1,1332350,91340,160516.2,555250,76640,125203.9,777100
168590,304075.5,1332350,94180,172913.2,555250,74410,131162.3,777100
167050,321961.2,1332350,94840,184658.8,555250,72210,137302.4,777100
165450,311522,1332350,95480,182123.5,555250,69970,129398.5,777100
163910,316294.2,1332350,96160,186776.8,555250,67750,129517.4,777100
162330,289702.6,1332350,96790,168327.8,555250,65540,121374.8,777100
162760,221768.2,1332350,99290,134065.6,555250,63470,87702.6,777100
163200,185284.6,1332350,101750,113711.8,555250,61450,71572.8,777100
163670,149287.9,1332350,104220,93362.7,555250,59450,55925.2,777100
164170,109979.2,1332350,106730,72031.1,555250,57440,37948.1,777100
162610,111529.2,1332350,106310,73529.5,555250,56300,37999.7,777100
161090,127799.3,1332350,105940,82369.9,555250,55150,45429.4,777100
159540,164242.4,1332350,105550,103410.3,555250,53990,60832.1,777100
157980,172289.7,1332350,105150,108309.9,555250,52830,63979.8,777100
153870,189601.3,1332350,102080,117664.7,555250,51790,71936.6,777100
149740,173224.1,1332350,99030,106431.3,555250,50710,66792.8,777100
145610,156839.8,1332350,95970,98110.7,555250,49640,58729.1,777100
141450,123678.5,1332350,92880,78142.2,555250,48570,45536.3,777100
137150,104092.9,1332350,90040,68563.4,555250,47110,35529.5,777100
132840,90049.2,1332350,87210,60773.2,555250,45630,29276,777100
128570,77987.9,1332350,84390,53410.6,555250,44180,24577.3,777100
124230,76980,1332350,81570,54005.3,555250,42660,22974.7,777100
125160,82226.5,1332350,81940,59222.7,555250,43220,23003.8,777100
126050,75762.6,1332350,82310,56512.2,555250,43740,19250.4,777100
126890,76456.7,1332350,82650,58009.4,555250,44240,18447.3,777100
127770,63876.4,1332350,83010,51106.8,555250,44760,12769.6,777100
128220,117412.2,1332350,82750,84409.8,555250,45470,33002.4,777100
128510,109634.4,1332350,82460,79578.2,555250,46050,30056.2,777100
128920,69929.4,1332350,82170,52735.5,555250,46750,17193.9,777100
129320,54626.3,1332350,81900,40880.9,555250,47420,13745.4,777100
129230,51477.4,1332350,80820,37663.7,555250,48410,13813.7,777100
129130,62994.9,1332350,79740,43288.2,555250,49390,19706.7,777100
128980,54265.1,1332350,78640,35653.4,555250,50340,18611.7,777100
128890,53138.8,1332350,77540,32813.6,555250,51350,20325.2,777100
128430,40509.3,1332350,75140,23292.5,555250,53290,17216.8,777100
128000,30974.9,1332350,72750,14547.6,555250,55250,16427.3,777100
127520,30267.4,1332350,70330,12598.5,555250,57190,17668.9,777100
127130,32520.6,1332350,67930,12490.4,555250,59200,20030.2,777100
127340,43694.5,1332350,65840,19137.9,555250,61500,24556.6,777100
127570,59909.5,1332350,63750,28078.6,555250,63820,31830.9,777100
127790,70245.2,1332350,61650,30127.7,555250,66140,40117.5,777100
128050,75434.4,1332350,59560,32513.8,555250,68490,42920.6,777100
129050,86367.7,1332350,57920,32251.3,555250,71130,54116.4,777100
130030,87647.9,1332350,56330,33098.4,555250,73700,54549.5,777100
131040,90906.9,1332350,54730,34400.4,555250,76310,56506.5,777100
131920,98398.1,1332350,53120,34078.1,555250,78800,64320,777100
130630,100051.4,1332350,51740,35223.8,555250,78890,64827.6,777100
129270,131587.7,1332350,50400,48502,555250,78870,83085.7,777100
127820,151549.7,1332350,49000,57921.9,555250,78820,93627.8,777100
126480,162301.2,1332350,47660,66541.1,555250,78820,95760.1,777100
124750,165666.2,1332350,45610,69725.7,555250,79140,95940.5,777100
123040,159328.7,1332350,43550,66456.6,555250,79490,92872.1,777100
121290,158968.4,1332350,41520,65499.2,555250,79770,93469.2,777100
119500,150555.2,1332350,39450,62327.6,555250,80050,88227.6,777100
116760,167362.9,1332350,37130,68404.8,555250,79630,98958.1,777100
113950,173554.2,1332350,34760,70384.6,555250,79190,103169.6,777100
111170,172203.5,1332350,32420,69896.9,555250,78750,102306.6,777100
108450,175931.6,1332350,30110,71466.3,555250,78340,104465.3,777100
107830,177991.3,1332350,31800,73294.9,555250,76030,104696.4,777100
107290,168555.4,1332350,33540,71137.9,555250,73750,97417.5,777100
106600,146582.3,1332350,35240,62491.9,555250,71360,84090.4,777100
106110,145087.2,1332350,36970,62507.7,555250,69140,82579.5,777100
105620,127158.9,1332350,39060,55620.9,555250,66560,71538,777100
105140,112988,1332350,41160,51700.9,555250,63980,61287.1,777100
104660,101864.3,1332350,43240,45992,555250,61420,55872.3,777100
104260,104381.2,1332350,45320,51439.9,555250,58940,52941.3,777100
103100,122918.5,1332350,47400,64244.4,555250,55700,58674.1,777100
101880,142142.9,1332350,49460,76139.7,555250,52420,66003.2,777100
100690,168790,1332350,51560,94418.8,555250,49130,74371.2,777100
99470,183936.8,1332350,53600,106226.6,555250,45870,77710.2,777100
97090,194969.8,1332350,53790,113610.8,555250,43300,81359,777100
94730,194074.8,1332350,53970,112834.4,555250,40760,81240.4,777100
92360,201098.4,1332350,54140,117423.1,555250,38220,83675.3,777100
89940,205428.3,1332350,54310,120982.3,555250,35630,84446,777100
89150,211243.5,1332350,55520,126826.7,555250,33630,84416.8,777100
88360,232579.1,1332350,56750,140953.3,555250,31610,91625.8,777100
87580,248500.3,1332350,57990,152819.1,555250,29590,95681.2,777100
86800,271571.3,1332350,59160,167148.2,555250,27640,104423.1,777100
85810,286981.2,1332350,60590,177175.6,555250,25220,109805.6,777100
84790,308217,1332350,62030,192018.7,555250,22760,116198.3,777100
83800,304781.9,1332350,63450,188578.6,555250,20350,116203.3,777100
82860,311558.2,1332350,64870,192388.6,555250,17990,119169.6,777100
84300,302780.3,1332350,66960,189029.1,555250,17340,113751.2,777100
85620,316101.6,1332350,69050,198020.4,555250,16570,118081.2,777100
87040,301318.1,1332350,71140,192842.4,555250,15900,108475.7,777100
93410,283302.1,1332350,66820,178291,555250,26590,105011.1,777100
92970,264126.2,1332350,65520,164633.5,555250,27450,99492.7,777100
92600,259839.7,1332350,64220,161051.5,555250,28380,98788.2,777100
92130,250598.7,1332350,62910,154431,555250,29220,96167.7,777100
91750,246271,1332350,61590,149703.8,555250,30160,96567.2,777100
91540,222113.2,1332350,60190,134446.9,555250,31350,87666.3,777100
91280,231950.4,1332350,58800,138492.3,555250,32480,93458.1,777100
91130,241002.8,1332350,57410,141723.3,555250,33720,99279.5,777100
90890,245703.2,1332350,56010,142583.3,555250,34880,103119.9,777100
94390,223094.2,1332350,57130,128619.5,555250,37260,94474.7,777100
97980,191341,1332350,58250,110338.4,555250,39730,81002.6,777100
101520,167311.2,1332350,59380,96133.6,555250,42140,71177.6,777100
104980,143685.2,1332350,60480,80501.1,555250,44500,63184.1,777100
110690,131223.8,1332350,63560,74381,555250,47130,56842.8,777100
116270,118774.7,1332350,66600,65239.4,555250,49670,53535.3,777100
121870,105079.7,1332350,69650,56562.9,555250,52220,48516.8,777100
127500,98133.2,1332350,72700,51759.8,555250,54800,46373.4,777100
132300,93807.9,1332350,74830,47752.1,555250,57470,46055.8,777100
137020,94267.6,1332350,76950,47813.3,555250,60070,46454.3,777100
141760,90804.2,1332350,79080,45493.4,555250,62680,45310.8,777100
146570,87166.3,1332350,81230,42941.1,555250,65340,44225.2,777100
155220,78070.4,1332350,87620,39048.5,555250,67600,39021.9,777100
163970,65285.3,1332350,94040,32154.8,555250,69930,33130.5,777100
172620,68507.6,1332350,100430,34330.4,555250,72190,34177.2,777100
181260,67797.5,1332350,106820,35048.1,555250,74440,32749.4,777100
188120,71529.5,1332350,111640,37945.9,555250,76480,33583.6,777100
194830,81489.1,1332350,116440,45441.3,555250,78390,36047.8,777100
201650,95688.2,1332350,121240,54780.2,555250,80410,40908,777100
208390,79126.1,1332350,126040,45341.4,555250,82350,33784.7,777100
213220,72191.3,1332350,129230,43569.5,555250,83990,28621.8,777100
218110,72667.4,1332350,132440,46643.7,555250,85670,26023.7,777100
223000,73791.3,1332350,135630,49805.4,555250,87370,23985.9,777100
227890,95901,1332350,138830,65994.1,555250,89060,29906.9,777100
227880,106205.6,1332350,139620,74052.3,555250,88260,32153.3,777100
227920,98633.1,1332350,140420,69393.1,555250,87500,29240,777100
227880,145396.9,1332350,141190,101498.9,555250,86690,43898,777100
227840,235841.7,1332350,141980,157297.9,555250,85860,78543.8,777100
228030,187736.9,1332350,142100,130594.7,555250,85930,57142.2,777100
228080,162357,1332350,142220,114165.7,555250,85860,48191.3,777100
228170,188484.8,1332350,142310,129615.6,555250,85860,58869.2,777100
228290,215526.7,1332350,142440,143476.5,555250,85850,72050.2,777100
232010,226522.4,1332350,144380,147472.3,555250,87630,79050.1,777100
235720,257854.2,1332350,146290,165015.5,555250,89430,92838.7,777100
239420,278963.4,1332350,148220,174520.4,555250,91200,104443,777100
243150,273969.7,1332350,150150,169340.3,555250,93000,104629.4,777100
245940,270291.9,1332350,149750,163821.6,555250,96190,106470.3,777100
248720,292132.9,1332350,149330,176790,555250,99390,115342.9,777100
251450,345922.1,1332350,148910,208148.9,555250,102540,137773.2,777100
254310,331955.7,1332350,148510,200648.3,555250,105800,131307.4,777100
258000,167295.5,1332350,149500,103768.1,555250,108500,63527.4,777100
261640,165398.1,1332350,150500,98505,555250,111140,66893.1,777100
265230,168121.6,1332350,151520,97482.8,555250,113710,70638.8,777100
268870,171317,1332350,152510,97178.7,555250,116360,74138.3,777100
273040,162495.9,1332350,153300,95413.8,555250,119740,67082.1,777100
277200,167028.5,1332350,154070,99116.7,555250,123130,67911.8,777100
281350,170982.6,1332350,154820,99850.8,555250,126530,71131.8,777100
285470,184922,1332350,155610,110079.3,555250,129860,74842.7,777100
288120,165316.6,1332350,157500,98470.1,555250,130620,66846.5,777100
290760,163258.9,1332350,159410,92966.7,555250,131350,70292.2,777100
293370,159551.6,1332350,161300,95356.7,555250,132070,64194.9,777100
296050,151053.5,1332350,163210,90362.3,555250,132840,60691.2,777100
298080,159183.7,1332350,164720,95625.8,555250,133360,63557.9,777100
300230,178108.8,1332350,166260,111302.7,555250,133970,66806.1,777100
302320,177687.8,1332350,167790,112452,555250,134530,65235.8,777100
304370,191786.4,1332350,169310,115902,555250,135060,75884.4,777100
307540,209057.3,1332350,172360,130237.4,555250,135180,78819.9,777100
310710,219028.5,1332350,175430,131771.8,555250,135280,87256.7,777100
313900,206812.7,1332350,178480,128782.8,555250,135420,78029.9,777100
317100,448738.2,1332350,181530,271686.3,555250,135570,177051.9,777100
313720,521401.5,1332350,182250,312880.3,555250,131470,208521.2,777100
310320,488495.7,1332350,182980,293188.2,555250,127340,195307.5,777100
306910,488085.5,1332350,183690,288278.6,555250,123220,199806.9,777100
303500,512626.9,1332350,184410,306378.6,555250,119090,206248.3,777100
306820,490437.8,1332350,191390,300234.8,555250,115430,190203,777100
310100,493585.5,1332350,198350,305211.4,555250,111750,188374.1,777100
313390,522756.4,1332350,205360,321929.2,555250,108030,200827.2,777100
316680,501957.2,1332350,212350,312194.4,555250,104330,189762.8,777100
311960,499382.3,1332350,211340,305386.6,555250,100620,193995.7,777100
307010,498230,1332350,210320,312110.6,555250,96690,186119.4,777100
302200,501244.5,1332350,209320,315888.9,555250,92880,185355.6,777100
297400,495898.9,1332350,208330,315123.4,555250,89070,180775.5,777100
289750,480154.2,1332350,200950,309345.5,555250,88800,170808.7,777100
282160,481236.1,1332350,193610,309593.4,555250,88550,171642.7,777100
274600,466386.3,1332350,186260,297248.3,555250,88340,169138,777100
267040,462836.5,1332350,178920,291229.1,555250,88120,171607.4,777100
261130,437351.5,1332350,174300,274462.1,555250,86830,162889.4,777100
255270,378247.8,1332350,169690,238532.3,555250,85580,139715.5,777100
249430,409526.8,1332350,165060,253384.8,555250,84370,156142,777100
243610,409316.6,1332350,160450,250649.8,555250,83160,158666.8,777100
238510,365018.9,1332350,155960,223092.7,555250,82550,141926.2,777100
233420,324917.3,1332350,151440,197051.7,555250,81980,127865.6,777100
228330,321119.1,1332350,146940,192893.2,555250,81390,128225.9,777100
223270,279144.8,1332350,142450,169180.6,555250,80820,109964.2,777100
216280,228902.5,1332350,134500,134259.9,555250,81780,94642.6,777100
209260,226759.4,1332350,126560,124692.2,555250,82700,102067.2,777100
202280,211072.3,1332350,118610,111420.9,555250,83670,99651.4,777100
197650,204246,1332350,112500,103766.1,555250,85150,100479.9,777100
195230,187003.3,1332350,108630,93811.3,555250,86600,93192,777100
192890,187094.5,1332350,104790,93288.7,555250,88100,93805.8,777100
190450,185251.9,1332350,100920,90365.5,555250,89530,94886.4,777100
188090,180510.8,1332350,97060,87791.8,555250,91030,92719,777100
183280,190623.4,1332350,90780,91844.4,555250,92500,98779,777100
178440,214539.7,1332350,84480,101145.5,555250,93960,113394.2,777100
173610,217920.7,1332350,78200,98997.1,555250,95410,118923.6,777100
168710,181751,1332350,71900,79133.6,555250,96810,102617.4,777100
164960,160185.7,1332350,68750,69172.9,555250,96210,91012.8,777100
161220,129811.9,1332350,65640,54477.9,555250,95580,75334,777100
157420,117384.3,1332350,62510,44382.5,555250,94910,73001.8,777100
153590,100499.2,1332350,59330,33230.1,555250,94260,67269.1,777100
150010,90324.9,1332350,56570,25717.6,555250,93440,64607.3,777100
146390,79538.1,1332350,53840,20355.5,555250,92550,59182.6,777100
142720,73647.8,1332350,51080,17073.8,555250,91640,56574,777100
139110,75965.6,1332350,48320,16084.4,555250,90790,59881.2,777100
138130,70178.1,1332350,48080,13361.1,555250,90050,56817,777100
137100,66568.9,1332350,47860,11328.9,555250,89240,55240,777100
136010,69254.5,1332350,47620,13224.2,555250,88390,56030.3,777100
134960,78446.1,1332350,47390,18174.6,555250,87570,60271.5,777100
133960,84966.7,1332350,47570,21559.6,555250,86390,63407.1,777100
132890,93320,1332350,47750,24829.4,555250,85140,68490.6,777100
131910,91920.9,1332350,47950,24253.3,555250,83960,67667.6,777100
130910,76827.5,1332350,48110,17116.7,555250,82800,59710.8,777100
129190,76406.1,1332350,48000,18548.4,555250,81190,57857.7,777100
127550,79576.5,1332350,47890,19806.3,555250,79660,59770.2,777100
125830,65275,1332350,47740,13835.3,555250,78090,51439.7,777100
124190,63756,1332350,47620,14936.5,555250,76570,48819.5,777100
123670,67530.1,1332350,48160,18235.8,555250,75510,49294.3,777100
123170,70297.8,1332350,48700,20461.7,555250,74470,49836.1,777100
122610,60836.5,1332350,49190,17478.9,555250,73420,43357.6,777100
122080,54529.4,1332350,49730,14059.7,555250,72350,40469.7,777100
122380,48630.4,1332350,51380,13088.8,555250,71000,35541.6,777100
122760,45763.6,1332350,53100,14345.7,555250,69660,31417.9,777100
123030,37988.2,1332350,54770,14414.7,555250,68260,23573.5,777100
123380,34489.4,1332350,56470,15498.6,555250,66910,18990.8,777100
121890,42516,1332350,56110,22298.2,555250,65780,20217.8,777100
120450,47058.6,1332350,55760,26169.4,555250,64690,20889.2,777100
119000,32394,1332350,55430,17449.1,555250,63570,14944.9,777100
117600,30073.4,1332350,55080,15577.3,555250,62520,14496.1,777100
117620,26154.2,1332350,55320,13752.1,555250,62300,12402.1,777100
117600,26018.5,1332350,55560,13848.8,555250,62040,12169.7,777100
117570,32829.6,1332350,55790,16292.4,555250,61780,16537.2,777100
117600,33320.4,1332350,56040,15495.3,555250,61560,17825.1,777100
124680,26965.6,1332350,58310,10949.8,555250,66370,16015.8,777100
131700,30102.8,1332350,60550,11844,555250,71150,18258.8,777100
138750,40057,1332350,62830,13261.4,555250,75920,26795.6,777100
145890,43095.3,1332350,65110,14089.4,555250,80780,29005.9,777100
151160,48756.5,1332350,65720,15749.1,555250,85440,33007.4,777100
156400,56616.7,1332350,66330,19196.9,555250,90070,37419.8,777100
161670,69086.5,1332350,66960,23446.7,555250,94710,45639.8,777100
166950,82405.5,1332350,67580,27236.7,555250,99370,55168.8,777100
172000,92669.3,1332350,68540,31935.9,555250,103460,60733.4,777100
176950,109637.5,1332350,69450,39289.3,555250,107500,70348.2,777100
181940,116541,1332350,70380,44222,555250,111560,72319,777100
186960,120317.9,1332350,71350,44285.9,555250,115610,76032,777100
185520,117538.4,1332350,70950,42148.6,555250,114570,75389.8,777100
184240,115975.5,1332350,70590,43514.8,555250,113650,72460.7,777100
182860,101545.4,1332350,70220,38816.8,555250,112640,62728.6,777100
181500,96285.6,1332350,69850,36017.3,555250,111650,60268.3,777100
180910,88528,1332350,69770,32495.5,555250,111140,56032.5,777100
180290,93086.7,1332350,69670,34356.5,555250,110620,58730.2,777100
179710,105461.8,1332350,69590,38700.4,555250,110120,66761.4,777100
179090,122073.5,1332350,69500,47481.9,555250,109590,74591.6,777100
177300,133562.4,1332350,68670,53133.3,555250,108630,80429.1,777100
175490,123716.5,1332350,67840,51929,555250,107650,71787.5,777100
173710,126721.6,1332350,67030,56796.7,555250,106680,69924.9,777100
171910,147257.2,1332350,66190,67031.2,555250,105720,80226,777100
170070,165385.5,1332350,66230,78354.7,555250,103840,87030.8,777100
168280,196096.2,1332350,66280,94105.4,555250,102000,101990.8,777100
166380,218393.5,1332350,66290,108031.3,555250,100090,110362.2,777100
164630,211803.5,1332350,66340,105923.8,555250,98290,105879.7,777100
161880,205885.4,1332350,65850,104036,555250,96030,101849.4,777100
159020,208021.7,1332350,65370,101924.9,555250,93650,106096.8,777100
156300,204874.3,1332350,64890,98505.9,555250,91410,106368.4,777100
153540,208137.7,1332350,64420,101514,555250,89120,106623.7,777100
152110,225951.6,1332350,65400,116805.4,555250,86710,109146.2,777100
150700,211908.5,1332350,66370,109301.3,555250,84330,102607.2,777100
149250,202683.7,1332350,67340,107409.2,555250,81910,95274.5,777100
147860,197862,1332350,68320,104906.1,555250,79540,92955.9,777100
148170,209517.2,1332350,70100,112799.1,555250,78070,96718.1,777100
148420,216556.9,1332350,71880,119631.1,555250,76540,96925.8,777100
148760,210027.6,1332350,73670,115552.2,555250,75090,94475.4,777100
149030,196725.9,1332350,75430,108215.1,555250,73600,88510.8,777100
144690,179739.5,1332350,72600,98581.1,555250,72090,81158.4,777100
140340,172805.4,1332350,69700,93818.9,555250,70640,78986.5,777100
136080,169260.1,1332350,66910,89542.2,555250,69170,79717.9,777100
131780,161823,1332350,64030,83876.3,555250,67750,77946.7,777100
128870,164502.1,1332350,62690,84478.7,555250,66180,80023.4,777100
125910,198231.9,1332350,61340,101885.3,555250,64570,96346.6,777100
123070,217460.1,1332350,60030,108921.5,555250,63040,108538.6,777100
120230,224684.5,1332350,58690,112254.6,555250,61540,112429.9,777100
127370,185833.6,1332350,65280,90536.4,555250,62090,95297.2,777100
134560,152426.2,1332350,71900,69177,555250,62660,83249.2,777100
141720,128205.4,1332350,78490,57251.9,555250,63230,70953.5,777100
180870,102536.9,1332350,102360,45563.7,555250,78510,56973.2,777100
188260,110418.4,1332350,108100,52981.7,555250,80160,57436.7,777100
195740,128856.6,1332350,113880,65112.1,555250,81860,63744.5,777100
203150,257860.6,1332350,119640,145612.9,555250,83510,112247.7,777100
210620,370922.7,1332350,125400,214677.3,555250,85220,156245.4,777100
217570,397280.8,1332350,130940,231662.6,555250,86630,165618.2,777100
224550,405868.3,1332350,136460,237649.8,555250,88090,168218.5,777100
231470,368794.8,1332350,141990,217425.2,555250,89480,151369.6,777100
238520,313737.2,1332350,147550,187135.8,555250,90970,126601.4,777100
242810,314238.7,1332350,151110,189991.3,555250,91700,124247.4,777100
247180,316470.2,1332350,154720,193104.1,555250,92460,123366.1,777100
251570,316931.2,1332350,158310,192079.2,555250,93260,124852,777100
255860,311189.5,1332350,161890,191003.1,555250,93970,120186.4,777100
258960,282234.7,1332350,164160,175908.7,555250,94800,106326,777100
262080,270699,1332350,166370,169647.3,555250,95710,101051.7,777100
265180,248836.4,1332350,168610,160970.9,555250,96570,87865.5,777100
268330,252336,1332350,170850,165606.4,555250,97480,86729.6,777100
271500,237281,1332350,172740,158851.2,555250,98760,78429.8,777100
274760,220423.4,1332350,174630,149185.3,555250,100130,71238.1,777100
277890,186708.4,1332350,176510,127986.8,555250,101380,58721.6,777100
281120,196458.7,1332350,178430,132714.4,555250,102690,63744.3,777100
278200,204195.4,1332350,176290,136781.1,555250,101910,67414.3,777100
275310,200434.5,1332350,174160,134037.7,555250,101150,66396.8,777100
272420,226113.5,1332350,172040,149474.1,555250,100380,76639.4,777100
269490,240162.9,1332350,169910,159009.9,555250,99580,81153,777100
267460,204633.5,1332350,168640,138091.8,555250,98820,66541.7,777100
265470,181852.4,1332350,167420,123734.5,555250,98050,58117.9,777100
263450,200650.3,1332350,166170,133406.1,555250,97280,67244.2,777100
261480,221880.8,1332350,164930,143374.3,555250,96550,78506.5,777100
258010,235753.6,1332350,161740,153170.3,555250,96270,82583.3,777100
254690,232816.9,1332350,158620,150218.2,555250,96070,82598.7,777100
251280,205659.3,1332350,155440,134138.5,555250,95840,71520.8,777100
247950,185336.3,1332350,152320,124710.8,555250,95630,60625.5,777100
250100,164046.2,1332350,152350,113928.7,555250,97750,50117.5,777100
252310,154813.4,1332350,152440,110010.5,555250,99870,44802.9,777100
254480,154092.3,1332350,152510,108069.6,555250,101970,46022.7,777100
256660,170906.5,1332350,152580,116476.1,555250,104080,54430.4,777100
259220,179201.8,1332350,150330,117056.3,555250,108890,62145.5,777100
261860,189838.3,1332350,148040,120433.1,555250,113820,69405.2,777100
264450,207316.9,1332350,145800,124318.4,555250,118650,82998.5,777100
267060,212391,1332350,143550,122462.7,555250,123510,89928.3,777100
268910,210995.7,1332350,141950,119996.1,555250,126960,90999.6,777100
270840,232242.3,1332350,140350,128702.7,555250,130490,103539.6,777100
272700,258361.4,1332350,138740,139774.4,555250,133960,118587,777100
274610,251269.2,1332350,137150,132672.5,555250,137460,118596.7,777100
275290,232151.7,1332350,134670,120029.1,555250,140620,112122.6,777100
276000,218962.2,1332350,132180,111902.5,555250,143820,107059.7,777100
276700,229065.6,1332350,129650,114477.7,555250,147050,114587.9,777100
277400,248799.8,1332350,127190,124135.7,555250,150210,124664.1,777100
279040,242919.2,1332350,125440,117375.6,555250,153600,125543.6,777100
280610,247821.4,1332350,123680,119639.9,555250,156930,128181.5,777100
282120,240051.8,1332350,121880,111989,555250,160240,128062.8,777100
283710,218861.6,1332350,120120,100184.7,555250,163590,118676.9,777100
285350,217554.9,1332350,118780,95564.9,555250,166570,121990,777100
287050,203933.6,1332350,117420,85419,555250,169630,118514.6,777100
288660,195489.6,1332350,116060,79841.1,555250,172600,115648.5,777100
290310,192437.5,1332350,114710,81024.1,555250,175600,111413.4,777100
282610,201157.2,1332350,108990,83452.2,555250,173620,117705,777100
274860,199240.6,1332350,103250,77254.2,555250,171610,121986.4,777100
267070,176824.5,1332350,97520,65639.1,555250,169550,111185.4,777100
259360,170390.1,1332350,91790,61426.2,555250,167570,108963.9,777100
251400,173863.1,1332350,86040,61627.5,555250,165360,112235.6,777100
243470,171131.8,1332350,80300,59161.6,555250,163170,111970.2,777100
235550,162965.4,1332350,74570,51327.3,555250,160980,111638.1,777100
227670,174098.3,1332350,68840,53930.4,555250,158830,120167.9,777100
219840,175645.3,1332350,63300,53684.4,555250,156540,121960.9,777100
211930,183689.3,1332350,57740,56174.6,555250,154190,127514.7,777100
204050,198020.1,1332350,52210,59552,555250,151840,138468.1,777100
196130,206748.2,1332350,46660,63809.9,555250,149470,142938.3,777100
187960,200947.3,1332350,43870,65927.1,555250,144090,135020.2,777100
179750,226721.2,1332350,41110,82471.3,555250,138640,144249.9,777100
171680,260837.1,1332350,38340,103398.4,555250,133340,157438.7,777100
163450,278634.3,1332350,35550,113867.7,555250,127900,164766.6,777100
155300,287759,1332350,33420,118877.6,555250,121880,168881.4,777100
147110,305581.5,1332350,31240,132580.2,555250,115870,173001.3,777100
138980,327439.2,1332350,29120,148856.6,555250,109860,178582.6,777100
130750,379165.5,1332350,26950,178932.4,555250,103800,200233.1,777100
122900,356976.9,1332350,25270,166837.5,555250,97630,190139.4,777100
115220,350558.7,1332350,23570,168124.8,555250,91650,182433.9,777100
107420,326628.7,1332350,21880,157641.3,555250,85540,168987.4,777100
99650,324746.9,1332350,20200,158043.6,555250,79450,166703.3,777100
93380,274411.6,1332350,19180,132067.7,555250,74200,142343.9,777100
87150,238635.3,1332350,18180,113030.7,555250,68970,125604.6,777100
80930,228613.6,1332350,17170,107961,555250,63760,120652.6,777100
74610,216819.6,1332350,16170,100468.2,555250,58440,116351.4,777100
69360,202364.3,1332350,15190,92810,555250,54170,109554.3,777100
64050,184712.5,1332350,14200,83422.5,555250,49850,101290,777100
58790,201105.2,1332350,13240,94295.8,555250,45550,106809.4,777100
53500,197931.6,1332350,12260,94045,555250,41240,103886.6,777100
48790,197480.5,1332350,11420,92984.4,555250,37370,104496.1,777100
44140,184678,1332350,10640,85220.7,555250,33500,99457.3,777100
39430,149669.6,1332350,9810,67232.6,555250,29620,82437,777100
34800,129168.8,1332350,8970,54831.4,555250,25830,74337.4,777100
34020,123647.3,1332350,8770,52220.2,555250,25250,71427.1,777100
33240,134457.9,1332350,8550,58940.5,555250,24690,75517.4,777100
32450,159916.9,1332350,8330,73767.3,555250,24120,86149.6,777100
40140,150292.1,1332350,14450,71449.3,555250,25690,78842.8,777100
39010,152885.7,1332350,13850,72429.3,555250,25160,80456.4,777100
37990,159386.7,1332350,13240,75519.7,555250,24750,83867,777100
36930,161970,1332350,12640,78082.2,555250,24290,83887.8,777100
35890,169212.7,1332350,12020,81479.8,555250,23870,87732.9,777100
34650,165072.1,1332350,11060,76629.8,555250,23590,88442.3,777100
33500,154204.1,1332350,10110,72568.6,555250,23390,81635.5,777100
32350,145066.6,1332350,9130,67184.4,555250,23220,77882.2,777100
31200,139535.8,1332350,8180,59306.6,555250,23020,80229.2,777100
30490,119896,1332350,7690,53516.5,555250,22800,66379.5,777100
29700,108235.7,1332350,7200,44735.5,555250,22500,63500.2,777100
28900,101014,1332350,6720,40732.3,555250,22180,60281.7,777100
28150,84550,1332350,6250,32153.6,555250,21900,52396.4,777100
27970,62716.7,1332350,6350,19613.1,555250,21620,43103.6,777100
27790,53989.5,1332350,6460,15663.2,555250,21330,38326.3,777100
27610,44102.7,1332350,6550,9616.2,555250,21060,34486.5,777100
27350,36016.9,1332350,6630,5599.9,555250,20720,30417,777100
26800,33396.3,1332350,6330,3925.8,555250,20470,29470.5,777100
26200,31918.3,1332350,6010,3305.4,555250,20190,28612.9,777100
25600,30708.3,1332350,5710,3158.3,555250,19890,27550,777100
25010,31407.1,1332350,5400,3621.3,555250,19610,27785.8,777100
24280,34213.7,1332350,5370,5106.4,555250,18910,29107.3,777100
23480,38213.9,1332350,5320,8870.3,555250,18160,29343.6,777100
22750,37272.8,1332350,5280,8456.5,555250,17470,28816.3,777100
21960,31537.9,1332350,5230,4228.4,555250,16730,27309.5,777100
20940,30366.8,1332350,5010,4456.1,555250,15930,25910.7,777100
19930,31329.4,1332350,4810,6219.6,555250,15120,25109.8,777100
18980,26453.9,1332350,4610,4883.3,555250,14370,21570.6,777100
17930,24559.2,1332350,4380,3703.4,555250,13550,20855.8,777100
16840,25204.7,1332350,3970,3232,555250,12870,21972.7,777100
15650,24802.4,1332350,3530,2311.6,555250,12120,22490.8,777100
14530,23839.5,1332350,3120,2082.4,555250,11410,21757.1,777100
13390,24617.8,1332350,2710,2998.1,555250,10680,21619.7,777100
12450,24257.1,1332350,2480,4398.4,555250,9970,19858.7,777100
11450,23725.4,1332350,2260,6051.6,555250,9190,17673.8,777100
10490,19219.1,1332350,2040,4922.1,555250,8450,14297,777100
9490,13523,1332350,1830,3056.7,555250,7660,10466.3,777100
8740,10127.7,1332350,1680,1236.7,555250,7060,8891,777100
8020,8202.6,1332350,1550,561.7,555250,6470,7640.9,777100
7220,7212.4,1332350,1380,614.5,555250,5840,6597.9,777100
6470,8141.8,1332350,1220,946.8,555250,5250,7195,777100
5860,7968.8,1332350,1100,1258.8,555250,4760,6710,777100
5170,9372.8,1332350,970,1576.3,555250,4200,7796.5,777100
4500,13092.1,1332350,850,3602.6,555250,3650,9489.5,777100
3890,18980.3,1332350,730,6951.6,555250,3160,12028.7,777100
4020,23285.5,1332350,720,9712.2,555250,3300,13573.3,777100
4220,23430.7,1332350,710,10069.3,555250,3510,13361.4,777100
4390,25198.5,1332350,720,10532.4,555250,3670,14666.1,777100
4540,28844.7,1332350,700,12144.4,555250,3840,16700.3,777100
4750,25091,1332350,680,10227.5,555250,4070,14863.5,777100
4990,20715,1332350,690,7477.2,555250,4300,13237.8,777100
5240,25180.6,1332350,700,8743.8,555250,4540,16436.8,777100
5450,20889.7,1332350,680,6172.1,555250,4770,14717.6,777100
5690,26759.2,1332350,680,9186.1,555250,5010,17573.1,777100
6010,26874,1332350,700,8778.6,555250,5310,18095.4,777100
6240,19470.6,1332350,710,6072.3,555250,5530,13398.3,777100
6570,14917.2,1332350,750,2844.9,555250,5820,12072.3,777100
6950,14359.4,1332350,890,3115.9,555250,6060,11243.5,777100
7260,14609.5,1332350,1030,3106.9,555250,6230,11502.6,777100
7620,21777.2,1332350,1170,7535.9,555250,6450,14241.3,777100
7950,21049.2,1332350,1310,6834.6,555250,6640,14214.6,777100
8060,18530.5,1332350,1460,6344.1,555250,6600,12186.4,777100
8240,17467.2,1332350,1610,4983.6,555250,6630,12483.6,777100
8380,15521.7,1332350,1750,4134.6,555250,6630,11387.1,777100
8520,12161.4,1332350,1900,2640.5,555250,6620,9520.9,777100
8500,10444.9,1332350,2010,1479.8,555250,6490,8965.1,777100
8480,12096.9,1332350,2100,2472,555250,6380,9624.9,777100
8440,13227,1332350,2220,3806.6,555250,6220,9420.4,777100
8400,15870.2,1332350,2320,4468.4,555250,6080,11401.8,777100
8290,15460.3,1332350,2380,4099.4,555250,5910,11360.9,777100
8200,16853.1,1332350,2440,4869.2,555250,5760,11983.9,777100
8060,9193.1,1332350,2470,1205.7,555250,5590,7987.4,777100
7940,9778,1332350,2510,1696.5,555250,5430,8081.5,777100
7920,14359,1332350,2570,2659.9,555250,5350,11699.1,777100
7940,11854.4,1332350,2640,1290,555250,5300,10564.4,777100
7940,16400,1332350,2710,3346.8,555250,5230,13053.2,777100
7930,15055.4,1332350,2770,2902.4,555250,5160,12153,777100
7990,17633.8,1332350,2830,3733.6,555250,5160,13900.2,777100
8130,20059.4,1332350,2900,6413.2,555250,5230,13646.2,777100
8300,19005.7,1332350,3000,7156.2,555250,5300,11849.5,777100
8470,15269.1,1332350,3100,4917.2,555250,5370,10351.9,777100
10260,12445.9,1332350,5130,4461.3,555250,5130,7984.6,777100
12080,16025.5,1332350,7200,8260.9,555250,4880,7764.6,777100
13840,14364,1332350,9270,9346,555250,4570,5018,777100
15650,14865.3,1332350,11330,10472.6,555250,4320,4392.7,777100
17390,16710,1332350,13380,12520.2,555250,4010,4189.8,777100
19230,37038.7,1332350,15440,25415.5,555250,3790,11623.2,777100
20970,52989.1,1332350,17520,35903.3,555250,3450,17085.8,777100
22790,61749.1,1332350,19570,42541.5,555250,3220,19207.6,777100
24810,94384.5,1332350,21750,63249.8,555250,3060,31134.7,777100
26880,111478.5,1332350,23940,73991.5,555250,2940,37487,777100
28960,123430,1332350,26130,82164.9,555250,2830,41265.1,777100
30990,159799.5,1332350,28310,104238.2,555250,2680,55561.3,777100
33740,186923,1332350,30330,120833.4,555250,3410,66089.6,777100
36490,202987.1,1332350,32350,130162.8,555250,4140,72824.3,777100
39340,207432,1332350,34390,132291.4,555250,4950,75140.6,777100
71790,158201.6,1332350,67900,116003.5,555250,3890,42198.1,777100
74580,138674.4,1332350,70040,106537,555250,4540,32137.4,777100
77490,125098.3,1332350,72240,98350.6,555250,5250,26747.7,777100
80250,119309.4,1332350,74370,95269,555250,5880,24040.4,777100
83110,114847.6,1332350,76570,91429.3,555250,6540,23418.3,777100
85860,107209,1332350,78670,85760.2,555250,7190,21448.8,777100
88620,105192.4,1332350,80730,83169.7,555250,7890,22022.7,777100
91470,104801.3,1332350,82850,82346.1,555250,8620,22455.2,777100
94210,101116.8,1332350,84960,78695.3,555250,9250,22421.5,777100
100400,103763.8,1332350,88810,81542.9,555250,11590,22220.9,777100
106540,93446.8,1332350,92700,77732.2,555250,13840,15714.6,777100
112790,83524.5,1332350,96580,72921.2,555250,16210,10603.3,777100
118950,81544,1332350,100470,71460.1,555250,18480,10083.9,777100
124520,74122.3,1332350,103540,66099,555250,20980,8023.3,777100
130050,79458.1,1332350,106650,70953.7,555250,23400,8504.4,777100
135550,86563,1332350,109710,76374.6,555250,25840,10188.4,777100
141090,83743.2,1332350,112800,73482.6,555250,28290,10260.6,777100
145180,96009.7,1332350,114570,82529.8,555250,30610,13479.9,777100
149280,100383.7,1332350,116340,84367.8,555250,32940,16015.9,777100
153380,100749.6,1332350,118130,83269.1,555250,35250,17480.5,777100
157480,103914.9,1332350,119910,84224.1,555250,37570,19690.8,777100
166450,90724.7,1332350,126420,73515.9,555250,40030,17208.8,777100
175450,98396.3,1332350,132930,79361,555250,42520,19035.3,777100
184400,105043.1,1332350,139450,85328.3,555250,44950,19714.8,777100
193400,116900.1,1332350,145940,93530.1,555250,47460,23370,777100
200920,129729.6,1332350,150820,102021.2,555250,50100,27708.4,777100
208390,139415,1332350,155660,108988.3,555250,52730,30426.7,777100
215830,182448.3,1332350,160490,135913.6,555250,55340,46534.7,777100
223290,202097.5,1332350,165320,146704.6,555250,57970,55392.9,777100
231150,189914.6,1332350,170410,139157.7,555250,60740,50756.9,777100
239040,165214.7,1332350,175470,123413.3,555250,63570,41801.4,777100
246860,190584.2,1332350,180540,139972.2,555250,66320,50612,777100
254840,194520,1332350,185620,143449.7,555250,69220,51070.3,777100
257670,212050.4,1332350,188850,157025.5,555250,68820,55024.9,777100
260590,197905.7,1332350,192070,151442.7,555250,68520,46463,777100
263510,190906,1332350,195300,149335,555250,68210,41571,777100
266370,184177.5,1332350,198510,147094.9,555250,67860,37082.6,777100
268620,181647.6,1332350,202230,151081.2,555250,66390,30566.4,777100
270830,164192.7,1332350,205980,141509.6,555250,64850,22683.1,777100
273150,142992.5,1332350,209720,125294.9,555250,63430,17697.6,777100
275430,130620,1332350,213460,114815.7,555250,61970,15804.3,777100
277650,126285.1,1332350,216510,109832.8,555250,61140,16452.3,777100
280020,148856,1332350,219560,130764.9,555250,60460,18091.1,777100
282260,165236.7,1332350,222590,147010.1,555250,59670,18226.6,777100
284510,165388.2,1332350,225610,149063.2,555250,58900,16325,777100
285840,195038.4,1332350,225300,171197.9,555250,60540,23840.5,777100
287120,233190.4,1332350,224980,196045.3,555250,62140,37145.1,777100
288380,247938,1332350,224660,204011.2,555250,63720,43926.8,777100
289690,274501.9,1332350,224360,219240.5,555250,65330,55261.4,777100
291210,268036.1,1332350,224540,214394.5,555250,66670,53641.6,777100
292800,289410.5,1332350,224790,227040.2,555250,68010,62370.3,777100
294320,222755.3,1332350,225020,184944.7,555250,69300,37810.6,777100
295860,268687.1,1332350,225240,213676.9,555250,70620,55010.2,777100
297130,354581.2,1332350,225450,261956.1,555250,71680,92625.1,777100
298360,379945,1332350,225660,277781.7,555250,72700,102163.3,777100
299540,376824.6,1332350,225840,276271.4,555250,73700,100553.2,777100
300700,345832.1,1332350,226070,259268.9,555250,74630,86563.2,777100
298770,335472.6,1332350,226210,253832,555250,72560,81640.6,777100
296760,355249.4,1332350,226380,266258.6,555250,70380,88990.8,777100
294790,369771.8,1332350,226550,275373.8,555250,68240,94398,777100
292790,358943.4,1332350,226720,270221.5,555250,66070,88721.9,777100
290220,358529,1332350,226230,271660.2,555250,63990,86868.8,777100
287570,328344.2,1332350,225740,256089.2,555250,61830,72255,777100
285000,316411.8,1332350,225260,247927.7,555250,59740,68484.1,777100
282410,258290.5,1332350,224790,213712.5,555250,57620,44578,777100
279170,222883.6,1332350,223700,190223.3,555250,55470,32660.3,777100
275990,201558.3,1332350,222590,176471.6,555250,53400,25086.7,777100
272760,198549.6,1332350,221520,172911.2,555250,51240,25638.4,777100
269550,228749.2,1332350,220420,195998.9,555250,49130,32750.3,777100
266650,250714.4,1332350,219420,210044,555250,47230,40670.4,777100
263720,266645,1332350,218390,222691.1,555250,45330,43953.9,777100
260830,310030.9,1332350,217370,247673.4,555250,43460,62357.5,777100
257940,382503.7,1332350,216360,292100.1,555250,41580,90403.6,777100
256130,417483.8,1332350,216480,315321.2,555250,39650,102162.6,777100
254350,431133.7,1332350,216590,322524.8,555250,37760,108608.9,777100
252550,442797.6,1332350,216710,330160.8,555250,35840,112636.8,777100
250740,444361.8,1332350,216800,333390.9,555250,33940,110970.9,777100
248980,443712.2,1332350,216830,334292.4,555250,32150,109419.8,777100
247200,421622.7,1332350,216830,323131.3,555250,30370,98491.4,777100
245440,391563.5,1332350,216830,306883.2,555250,28610,84680.3,777100
243630,388757.4,1332350,216840,306382.9,555250,26790,82374.5,777100
244110,399852.3,1332350,215290,311569.7,555250,28820,88282.6,777100
244530,375252.6,1332350,213710,295507.5,555250,30820,79745.1,777100
244950,348825.9,1332350,212150,278773.2,555250,32800,70052.7,777100
245420,327051.3,1332350,210590,264455.2,555250,34830,62596.1,777100
246330,311917.4,1332350,209460,254919.9,555250,36870,56997.5,777100
247310,296090.5,1332350,208350,243983,555250,38960,52107.5,777100
248280,282271.1,1332350,207240,233555,555250,41040,48716.1,777100
249230,277487.6,1332350,206110,225570,555250,43120,51917.6,777100
249030,265940.7,1332350,203750,214867.3,555250,45280,51073.4,777100
248730,247390.5,1332350,201350,201345.6,555250,47380,46044.9,777100
248520,261776.6,1332350,198990,205915.5,555250,49530,55861.1,777100
248200,254691,1332350,196610,199130.5,555250,51590,55560.5,777100
252110,265574.4,1332350,197100,202097.2,555250,55010,63477.2,777100
255990,265577.4,1332350,197610,199652.6,555250,58380,65924.8,777100
259820,253738.6,1332350,198060,189587.8,555250,61760,64150.8,777100
235500,240590.1,1332350,193050,186597.6,555250,42450,53992.5,777100
237370,215034.3,1332350,192770,169631,555250,44600,45403.3,777100
239150,212682.7,1332350,192510,166169.5,555250,46640,46513.2,777100
240930,231549.4,1332350,192250,175731.6,555250,48680,55817.8,777100
242800,241274.8,1332350,191970,181530.7,555250,50830,59744.1,777100
245210,242036.3,1332350,192300,180069,555250,52910,61967.3,777100
247590,267259.5,1332350,192590,192493.6,555250,55000,74765.9,777100
249960,261055.4,1332350,192910,187831.8,555250,57050,73223.6,777100
252340,231559,1332350,193230,171142.2,555250,59110,60416.8,777100
255350,212413.4,1332350,193340,157873.3,555250,62010,54540.1,777100
258450,196249.7,1332350,193450,146745.5,555250,65000,49504.2,777100
261300,175866.6,1332350,193530,133715.6,555250,67770,42151,777100
264430,151113.6,1332350,193640,117218.4,555250,70790,33895.2,777100
266670,142835.1,1332350,193360,109249.6,555250,73310,33585.5,777100
269130,147043.8,1332350,193120,111724.4,555250,76010,35319.4,777100
271440,153408.7,1332350,192880,114349.7,555250,78560,39059,777100
273790,161624.7,1332350,192610,117985.3,555250,81180,43639.4,777100
275250,160601.7,1332350,191480,115113,555250,83770,45488.7,777100
276720,166525,1332350,190340,116076.1,555250,86380,50448.9,777100
278140,141900.1,1332350,189200,98761.5,555250,88940,43138.6,777100
279610,138074.2,1332350,188070,95148.2,555250,91540,42926,777100
278890,150571.8,1332350,185540,99374.2,555250,93350,51197.6,777100
278200,151142.1,1332350,183000,97331.4,555250,95200,53810.7,777100
277450,149246.7,1332350,180490,94838.8,555250,96960,54407.9,777100
276710,160288.4,1332350,177940,98992.9,555250,98770,61295.5,777100
277230,168343.3,1332350,176490,100299.2,555250,100740,68044.1,777100
277800,163539.2,1332350,175060,93535.2,555250,102740,70004,777100
278350,171939.7,1332350,173640,96913.5,555250,104710,75026.2,777100
278870,180806.4,1332350,172210,97572.1,555250,106660,83234.3,777100
279570,185078.7,1332350,170450,97505.6,555250,109120,87573.1,777100
280180,179650.9,1332350,168700,93568.7,555250,111480,86082.2,777100
280850,177571.9,1332350,166950,91380.7,555250,113900,86191.2,777100
281550,180239.1,1332350,165180,93934.9,555250,116370,86304.2,777100
274000,174099.8,1332350,161680,92766,555250,112320,81333.8,777100
266410,162407.1,1332350,158150,89538.6,555250,108260,72868.5,777100
258820,141434.9,1332350,154630,81690.8,555250,104190,59744.1,777100
251240,118272.9,1332350,151100,70416.2,555250,100140,47856.7,777100
238460,87693.9,1332350,146250,54043.6,555250,92210,33650.3,777100
225490,72307.6,1332350,141340,47254.2,555250,84150,25053.4,777100
212610,72971.3,1332350,136480,51421.8,555250,76130,21549.5,777100
199690,75160.6,1332350,131610,54851.1,555250,68080,20309.5,777100
189550,75231.1,1332350,126990,55925.7,555250,62560,19305.4,777100
179530,79360.6,1332350,122410,58970.6,555250,57120,20390,777100
169370,88429.3,1332350,117770,63737.4,555250,51600,24691.9,777100
159320,94235.9,1332350,113180,68103.4,555250,46140,26132.5,777100
157200,102099.5,1332350,110900,70659.7,555250,46300,31439.8,777100
155080,102068.6,1332350,108620,70347.6,555250,46460,31721,777100
152960,119600.4,1332350,106310,80127.4,555250,46650,39473,777100
150850,119364.2,1332350,104030,79358.9,555250,46820,40005.3,777100
150380,122082.5,1332350,103790,80432.2,555250,46590,41650.3,777100
149830,120693,1332350,103530,79357.5,555250,46300,41335.5,777100
149270,126084.6,1332350,103270,80732.5,555250,46000,45352.1,777100
148800,134759.2,1332350,103020,86158.4,555250,45780,48600.8,777100
149050,143478.2,1332350,103300,90980.8,555250,45750,52497.4,777100
149240,157969.9,1332350,103520,102351.1,555250,45720,55618.8,777100
149470,185848.1,1332350,103800,117451,555250,45670,68397.1,777100
149680,182210.7,1332350,104040,116802.2,555250,45640,65408.5,777100
150970,162050,1332350,106340,106840.4,555250,44630,55209.6,777100
152340,159310.7,1332350,108640,102920,555250,43700,56390.7,777100
153630,147099.3,1332350,110920,96866.8,555250,42710,50232.5,777100
154910,134352.3,1332350,113210,90973.9,555250,41700,43378.4,777100
155200,138538.8,1332350,114320,94116.7,555250,40880,44422.1,777100
155490,123814,1332350,115380,86216.3,555250,40110,37597.7,777100
155690,94340.8,1332350,116460,62060.3,555250,39230,32280.5,777100
155950,80225.5,1332350,117540,52973.7,555250,38410,27251.8,777100
157590,62490.2,1332350,120150,37980.7,555250,37440,24509.5,777100
159110,54005.6,1332350,122730,33296.3,555250,36380,20709.3,777100
160610,47816.8,1332350,125310,31124.7,555250,35300,16692.1,777100
162230,47514.8,1332350,127930,32063.5,555250,34300,15451.3,777100
159290,53282.4,1332350,125340,37417.2,555250,33950,15865.2,777100
156360,54340,1332350,122760,40225.3,555250,33600,14114.7,777100
153430,62406.6,1332350,120190,49424.7,555250,33240,12981.9,777100
150500,75000.9,1332350,117610,60271.1,555250,32890,14729.8,777100
148920,116974.5,1332350,116180,94649.1,555250,32740,22325.4,777100
147500,179690.8,1332350,114770,133280.1,555250,32730,46410.7,777100
146050,221505.7,1332350,113380,154299.5,555250,32670,67206.2,777100
144510,261315.4,1332350,111930,175540.2,555250,32580,85775.2,777100
142440,252265.5,1332350,110290,171404.4,555250,32150,80861.1,777100
140370,222026.8,1332350,108640,152580.4,555250,31730,69446.4,777100
138290,192999.5,1332350,106940,132564.3,555250,31350,60435.2,777100
136230,230488.7,1332350,105290,156547.8,555250,30940,73940.9,777100
132510,264162.8,1332350,101320,174025.6,555250,31190,90137.2,777100
128850,242315.3,1332350,97380,159562.1,555250,31470,82753.2,777100
125130,230102.8,1332350,93410,152472.5,555250,31720,77630.3,777100
121520,267487,1332350,89460,173832.9,555250,32060,93654.1,777100
120310,308978.1,1332350,88370,199279,555250,31940,109699.1,777100
119180,357590.1,1332350,87330,228280.7,555250,31850,129309.4,777100
118020,334642.2,1332350,86200,213612.5,555250,31820,121029.7,777100
116920,340175.7,1332350,85180,215448.4,555250,31740,124727.3,777100
115640,281612.2,1332350,83690,180829.8,555250,31950,100782.4,777100
114490,241926.9,1332350,82240,157322.3,555250,32250,84604.6,777100
113330,238813.4,1332350,80750,155289.2,555250,32580,83524.2,777100
112060,256454.2,1332350,79310,164662.2,555250,32750,91792,777100
113080,216273.8,1332350,81110,139320.3,555250,31970,76953.5,777100
114000,219383.2,1332350,82900,139868.7,555250,31100,79514.5,777100
115010,189205.1,1332350,84720,125020.5,555250,30290,64184.6,777100
128110,151911.2,1332350,96530,108939.5,555250,31580,42971.7,777100
128370,118984.9,1332350,97290,90015.8,555250,31080,28969.1,777100
128730,133457.4,1332350,98050,98089.9,555250,30680,35367.5,777100
129020,148974.7,1332350,98810,108135.1,555250,30210,40839.6,777100
129330,116514.9,1332350,99570,90978.1,555250,29760,25536.8,777100
129070,99339.8,1332350,99730,81102.6,555250,29340,18237.2,777100
128790,88886.4,1332350,99870,74110.6,555250,28920,14775.8,777100
128600,83444.9,1332350,100000,70498.8,555250,28600,12946.1,777100
128340,80599.4,1332350,100180,68282.2,555250,28160,12317.2,777100
129170,80581.6,1332350,101170,68677.6,555250,28000,11904,777100
130020,80318.4,1332350,102160,68219.1,555250,27860,12099.3,777100
130850,72140.7,1332350,103160,61293.6,555250,27690,10847.1,777100
131730,63221.3,1332350,104200,55831.1,555250,27530,7390.2,777100
132100,54817.6,1332350,104590,49160.6,555250,27510,5657,777100
132320,51074.3,1332350,104950,44988,555250,27370,6086.3,777100
132660,54720,1332350,105350,48778.7,555250,27310,5941.3,777100
132970,60266.8,1332350,105710,53303.4,555250,27260,6963.4,777100
131800,60513.8,1332350,104700,54529.1,555250,27100,5984.7,777100
130650,56862.5,1332350,103680,51949.8,555250,26970,4912.7,777100
129450,47324.5,1332350,102630,43107.3,555250,26820,4217.2,777100
128310,39681,1332350,101620,34871.9,555250,26690,4809.1,777100
127120,35945.7,1332350,100330,29807.1,555250,26790,6138.6,777100
126010,39913.7,1332350,99020,32484.8,555250,26990,7428.9,777100
124890,43557.4,1332350,97740,34738.2,555250,27150,8819.2,777100
123710,41239.2,1332350,96460,33737.8,555250,27250,7501.4,777100
123270,41124,1332350,95770,33986.5,555250,27500,7137.5,777100
122810,44301.6,1332350,95090,36911.1,555250,27720,7390.5,777100
122300,47775,1332350,94370,39575.3,555250,27930,8199.7,777100
121890,54523.2,1332350,93710,45090.5,555250,28180,9432.7,777100
121220,72434.8,1332350,92610,58069.4,555250,28610,14365.4,777100
120510,76842.4,1332350,91550,60737.7,555250,28960,16104.7,777100
119950,85832.9,1332350,90490,68639.1,555250,29460,17193.8,777100
119270,92869.5,1332350,89390,73274.9,555250,29880,19594.6,777100
123940,96498.2,1332350,93440,75818.2,555250,30500,20680,777100
128650,103571.8,1332350,97530,80951.2,555250,31120,22620.6,777100
133310,123548.6,1332350,101590,94479.8,555250,31720,29068.8,777100
138030,119679.7,1332350,105640,93655.8,555250,32390,26023.9,777100
143360,119523.3,1332350,110310,93740.6,555250,33050,25782.7,777100
148810,134390.4,1332350,115010,102488.5,555250,33800,31901.9,777100
154110,156519.1,1332350,119700,117207.7,555250,34410,39311.4,777100
159440,168331.5,1332350,124390,124214.4,555250,35050,44117.1,777100
163520,177642.4,1332350,127730,130160.5,555250,35790,47481.9,777100
167770,213566.8,1332350,131100,146741,555250,36670,66825.8,777100
171960,213421.4,1332350,134430,146418.2,555250,37530,67003.2,777100
176130,207328.8,1332350,137770,139301.6,555250,38360,68027.2,777100
182660,217491.4,1332350,140390,145296.2,555250,42270,72195.2,777100
189300,236312.6,1332350,143010,152444.8,555250,46290,83867.8,777100
195900,233820.2,1332350,145650,149013.8,555250,50250,84806.4,777100
202490,244571.6,1332350,148270,153611.4,555250,54220,90960.2,777100
209980,301855.4,1332350,151650,185477.8,555250,58330,116377.6,777100
217420,350389.8,1332350,155030,211923.5,555250,62390,138466.3,777100
224960,351111.1,1332350,158400,211611.3,555250,66560,139499.8,777100
232540,384948.4,1332350,161790,231524.7,555250,70750,153423.7,777100
239330,462520.5,1332350,164060,273792.5,555250,75270,188728,777100
246240,518274.7,1332350,166330,305015.5,555250,79910,213259.2,777100
253010,512906.4,1332350,168580,297706.2,555250,84430,215200.2,777100
259860,506262.6,1332350,170860,291897.5,555250,89000,214365.1,777100
275560,465956.9,1332350,181470,269295.1,555250,94090,196661.8,777100
291240,452344.3,1332350,192080,270015,555250,99160,182329.3,777100
306920,411655.3,1332350,202690,244248.8,555250,104230,167406.5,777100
322660,368286.1,1332350,213290,220376.6,555250,109370,147909.5,777100
338220,343824.1,1332350,223910,214774.9,555250,114310,129049.2,777100
353870,349475.8,1332350,234530,222523.5,555250,119340,126952.3,777100
369530,348933.6,1332350,245170,222154.9,555250,124360,126778.7,777100
385100,352125.2,1332350,255770,224853.5,555250,129330,127271.7,777100
402070,343035.9,1332350,267810,227060.4,555250,134260,115975.5,777100
418930,408573.5,1332350,279860,265618,555250,139070,142955.5,777100
435790,450991.5,1332350,291890,291579.5,555250,143900,159412,777100
452690,495514.2,1332350,303960,319325.8,555250,148730,176188.4,777100
455260,472384.3,1332350,307710,306602.4,555250,147550,165781.9,777100
457730,461705.1,1332350,311460,303478.3,555250,146270,158226.8,777100
460160,512329.7,1332350,315210,339505.6,555250,144950,172824.1,777100
462720,499382.6,1332350,318970,337066.7,555250,143750,162315.9,777100
464330,510765.1,1332350,322310,344363.4,555250,142020,166401.7,777100
466060,531221.2,1332350,325670,359226.6,555250,140390,171994.6,777100
467640,512127.1,1332350,329020,353847.3,555250,138620,158279.8,777100
469340,514604.2,1332350,332360,359115.4,555250,136980,155488.8,777100
469610,497244.6,1332350,334630,355326.4,555250,134980,141918.2,777100
470000,464256,1332350,336900,338777.7,555250,133100,125478.3,777100
470350,510218.5,1332350,339170,370616.2,555250,131180,139602.3,777100
470660,540950.7,1332350,341480,390343.5,555250,129180,150607.2,777100
468070,568363.6,1332350,339830,403806.1,555250,128240,164557.5,777100
465580,573504.4,1332350,338210,405201.3,555250,127370,168303.1,777100
463100,553098.3,1332350,336610,387774.5,555250,126490,165323.8,777100
460540,527970.9,1332350,334960,364475.8,555250,125580,163495.1,777100
458320,486981.8,1332350,333060,339774.1,555250,125260,147207.7,777100
456030,439570.1,1332350,331170,313807.7,555250,124860,125762.4,777100
453800,383849.7,1332350,329270,284481.3,555250,124530,99368.4,777100
451530,442720.6,1332350,327360,314443.1,555250,124170,128277.5,777100
447620,504774.7,1332350,323660,345301.8,555250,123960,159472.9,777100
443770,559086.9,1332350,319970,374244.3,555250,123800,184842.6,777100
439820,569956.1,1332350,316270,377781,555250,123550,192175.1,777100
435890,539296.4,1332350,312560,356061.8,555250,123330,183234.6,777100
441950,525239.9,1332350,315050,346162.1,555250,126900,179077.8,777100
448010,518667.3,1332350,317540,340836.9,555250,130470,177830.4,777100
454010,508405.8,1332350,320050,335394.7,555250,133960,173011.1,777100
480540,508032.4,1332350,315670,327446.8,555250,164870,180585.6,777100
496010,490097.6,1332350,325420,322290.2,555250,170590,167807.4,777100
511510,473635.1,1332350,335220,315844.5,555250,176290,157790.6,777100
526920,443574.2,1332350,344960,300385.2,555250,181960,143189,777100
542350,424486.5,1332350,354740,287309.6,555250,187610,137176.9,777100
554030,513050.2,1332350,361060,335779.9,555250,192970,177270.3,777100
565710,535108.2,1332350,367370,347271.9,555250,198340,187836.3,777100
577350,482071.6,1332350,373700,321575,555250,203650,160496.6,777100
589060,459003.5,1332350,380030,313392.5,555250,209030,145611,777100
594930,450805.2,1332350,382680,310273.2,555250,212250,140532,777100
600770,507260.4,1332350,385360,338937,555250,215410,168323.4,777100
606570,558241.8,1332350,387980,364230.4,555250,218590,194011.4,777100
612480,571981.1,1332350,390650,368902.9,555250,221830,203078.2,777100
619640,620231.4,1332350,393330,392291.1,555250,226310,227940.3,777100
626700,633807.4,1332350,396010,399817.3,555250,230690,233990.1,777100
633840,620989.5,1332350,398720,395532.8,555250,235120,225456.7,777100
641000,639088.8,1332350,401380,405995.2,555250,239620,233093.6,777100
644920,686138.1,1332350,401010,427181.2,555250,243910,258956.9,777100
648840,686187.5,1332350,400630,423712.6,555250,248210,262474.9,777100
652680,677841.6,1332350,400250,415353,555250,252430,262488.6,777100
656610,675187.3,1332350,399830,411446.8,555250,256780,263740.5,777100
659910,703768.4,1332350,398600,429175.6,555250,261310,274592.8,777100
663210,703387.3,1332350,397330,430658.5,555250,265880,272728.8,777100
666520,699112.2,1332350,396090,427277.3,555250,270430,271834.9,777100
669780,690166.6,1332350,394840,415554.8,555250,274940,274611.8,777100
671710,720525.3,1332350,392000,429003.8,555250,279710,291521.5,777100
673670,738407.9,1332350,389140,436333.3,555250,284530,302074.6,777100
675720,764222.5,1332350,386340,442042.1,555250,289380,322180.4,777100
677680,764915.9,1332350,383470,439402.9,555250,294210,325513,777100
677800,762807.3,1332350,380180,434087.5,555250,297620,328719.8,777100
677820,758195.4,1332350,376870,429842.3,555250,300950,328353.1,777100
677970,726594,1332350,373580,410338.9,555250,304390,316255.1,777100
678020,730138.1,1332350,370260,409670.1,555250,307760,320468,777100
678860,750009,1332350,368400,414409.7,555250,310460,335599.3,777100
679700,761101.6,1332350,366510,422387.3,555250,313190,338714.3,777100
680610,729835.4,1332350,364640,404174.5,555250,315970,325660.9,777100
681430,703322.1,1332350,362760,390487,555250,318670,312835.1,777100
679330,635655.1,1332350,358260,349342,555250,321070,286313.1,777100
677190,643691.2,1332350,353720,360715.6,555250,323470,282975.6,777100
675000,646288.2,1332350,349190,355688.4,555250,325810,290599.8,777100
672810,625351.2,1332350,344670,343148.6,555250,328140,282202.6,777100
672220,641664.7,1332350,341960,348261.5,555250,330260,293403.2,777100
671540,580647.1,1332350,339220,308898.2,555250,332320,271748.9,777100
670900,445309.1,1332350,336480,233894.8,555250,334420,211414.3,777100
670260,372691.6,1332350,333760,199509.1,555250,336500,173182.5,777100
659610,335863.6,1332350,324760,181479.5,555250,334850,154384.1,777100
648910,340242.6,1332350,315780,181409.8,555250,333130,158832.8,777100
638200,356542.2,1332350,306800,182505.9,555250,331400,174036.3,777100
627590,380756.8,1332350,297820,188701.3,555250,329770,192055.5,777100
616110,396302,1332350,289340,192292,555250,326770,204010,777100
604650,416767.5,1332350,280900,196891.4,555250,323750,219876.1,777100
593140,418284.9,1332350,272420,195291,555250,320720,222993.9,777100
581720,391266.5,1332350,263970,180415,555250,317750,210851.5,777100
571170,383585.1,1332350,255830,179752.8,555250,315340,203832.3,777100
560750,363097.3,1332350,247730,168811.7,555250,313020,194285.6,777100
550170,373701.3,1332350,239590,166322.9,555250,310580,207378.4,777100
539700,383158.4,1332350,231460,171439.5,555250,308240,211718.9,777100
525020,391853.9,1332350,227020,176077.7,555250,298000,215776.2,777100
510280,379478.2,1332350,222530,168598.6,555250,287750,210879.6,777100
495550,368308.6,1332350,218080,173491.3,555250,277470,194817.3,777100
480870,368475.8,1332350,213630,179120.4,555250,267240,189355.4,777100
466690,364696.7,1332350,210150,178137.8,555250,256540,186558.9,777100
452290,385601.2,1332350,206600,187938.6,555250,245690,197662.6,777100
438070,373421.5,1332350,203110,181916.6,555250,234960,191504.9,777100
423800,350089,1332350,199610,170540.9,555250,224190,179548.1,777100
411310,351089,1332350,195920,169946.1,555250,215390,181142.9,777100
398790,353407.5,1332350,192270,173053.4,555250,206520,180354.1,777100
386240,384547.8,1332350,188610,199738.8,555250,197630,184809,777100
373770,387724.2,1332350,184930,207354.2,555250,188840,180370,777100
364720,394754.8,1332350,183540,214315.3,555250,181180,180439.5,777100
355700,442169.8,1332350,182160,249306.5,555250,173540,192863.3,777100
346670,467105.4,1332350,180780,267902.6,555250,165890,199202.8,777100
337660,465545.8,1332350,179390,267383.1,555250,158270,198162.7,777100
329790,445862.5,1332350,179450,255227.2,555250,150340,190635.3,777100
322040,382194.4,1332350,179530,221585.8,555250,142510,160608.6,777100
314200,369547.9,1332350,179580,220019.9,555250,134620,149528,777100
306370,339884,1332350,179640,206245.7,555250,126730,133638.3,777100
299240,324616.9,1332350,180040,204465.3,555250,119200,120151.6,777100
292020,368498.7,1332350,180440,229329.4,555250,111580,139169.3,777100
284890,409845,1332350,180830,255478.8,555250,104060,154366.2,777100
277730,395005,1332350,181220,245210.4,555250,96510,149794.6,777100
272370,377486.6,1332350,178220,237388.6,555250,94150,140098,777100
267040,334547.7,1332350,175240,211763.9,555250,91800,122783.8,777100
261620,309604.5,1332350,172230,193463.3,555250,89390,116141.2,777100
256310,289117.5,1332350,169240,181189.9,555250,87070,107927.6,777100
250600,225477.1,1332350,165780,140515.8,555250,84820,84961.3,777100
244760,166050.9,1332350,162310,108958.8,555250,82450,57092.1,777100
239030,135630.3,1332350,158860,89748.6,555250,80170,45881.7,777100
233310,171304.6,1332350,155400,109382.3,555250,77910,61922.3,777100
226640,244068.7,1332350,151280,149972.4,555250,75360,94096.3,777100
219820,266822.9,1332350,147190,161352.9,555250,72630,105470,777100
213100,251618.4,1332350,143040,147986.1,555250,70060,103632.3,777100
206380,219479.9,1332350,138930,128855.5,555250,67450,90624.4,777100
203930,196410.3,1332350,136610,118720.8,555250,67320,77689.5,777100
201470,221749.3,1332350,134290,132867.7,555250,67180,88881.6,777100
199000,226853.1,1332350,131940,136547.8,555250,67060,90305.3,777100
188030,243919.3,1332350,139500,156988,555250,48530,86931.3,777100
181760,275428.7,1332350,133760,176101.8,555250,48000,99326.9,777100
175440,278226.1,1332350,128030,177902.3,555250,47410,100323.8,777100
169190,267231.6,1332350,122290,171542.8,555250,46900,95688.8,777100
162980,250895.5,1332350,116590,163741.1,555250,46390,87154.4,777100
160180,209890.1,1332350,114050,142304.5,555250,46130,67585.6,777100
157390,177542,1332350,111490,124410.3,555250,45900,53131.7,777100
154540,183272,1332350,108980,125877.4,555250,45560,57394.6,777100
151750,210910.6,1332350,106430,141381.9,555250,45320,69528.7,777100
150550,176123.6,1332350,104430,117541.7,555250,46120,58581.9,777100
149250,211107.5,1332350,102370,133388.7,555250,46880,77718.8,777100
147950,210339.1,1332350,100410,129243.9,555250,47540,81095.2,777100
146680,221978,1332350,98380,134218.7,555250,48300,87759.3,777100
145080,207494.1,1332350,96160,127175.6,555250,48920,80318.5,777100
143470,187455.3,1332350,93930,118019.9,555250,49540,69435.4,777100
141890,200608.8,1332350,91730,125938.6,555250,50160,74670.2,777100
140280,232055.3,1332350,89490,139304,555250,50790,92751.3,777100
138680,239066.1,1332350,87050,138937.6,555250,51630,100128.5,777100
137160,263583.9,1332350,84610,152311.7,555250,52550,111272.2,777100
135490,243550.5,1332350,82150,138992.3,555250,53340,104558.2,777100
133960,247205.5,1332350,79710,137931.1,555250,54250,109274.4,777100
132460,268998.9,1332350,77080,150141.5,555250,55380,118857.4,777100
130990,266197.1,1332350,74460,145121.2,555250,56530,121075.9,777100
129490,257863.6,1332350,71840,132598.9,555250,57650,125264.7,777100
127960,226134.4,1332350,69190,109597.9,555250,58770,116536.5,777100
127310,263064.7,1332350,67410,127563.1,555250,59900,135501.6,777100
126680,302516.4,1332350,65640,150213.2,555250,61040,152303.2,777100
125960,292124.1,1332350,63840,145289.7,555250,62120,146834.4,777100
125350,325446.1,1332350,62090,165603.8,555250,63260,159842.3,777100
126040,316235.4,1332350,62290,159658.9,555250,63750,156576.5,777100
126680,362355.3,1332350,62520,188642.6,555250,64160,173712.7,777100
127370,408705.2,1332350,62720,214648.6,555250,64650,194056.6,777100
128070,349990.2,1332350,62950,180367.8,555250,65120,169622.4,777100
130130,283658.2,1332350,63790,139739.3,555250,66340,143918.9,777100
132260,248902.8,1332350,64690,120033.2,555250,67570,128869.6,777100
134330,292549.9,1332350,65530,146233.9,555250,68800,146316,777100
136390,254597.9,1332350,66400,128663.7,555250,69990,125934.2,777100
134770,269312.9,1332350,63470,139011.9,555250,71300,130301,777100
133090,297265.5,1332350,60510,154795.2,555250,72580,142470.3,777100
131380,311371,1332350,57520,157147.8,555250,73860,154223.2,777100
129710,311185.1,1332350,54570,152806.4,555250,75140,158378.7,777100
132290,302999.1,1332350,54910,143296.5,555250,77380,159702.6,777100
134860,285556.7,1332350,55300,132496.6,555250,79560,153060.1,777100
137440,293576.6,1332350,55650,125027.5,555250,81790,168549.1,777100
140020,280080,1332350,55990,116332.4,555250,84030,163747.6,777100
150600,253861.6,1332350,57690,99500.9,555250,92910,154360.7,777100
161230,242127,1332350,59330,84984,555250,101900,157143,777100
171910,236861.8,1332350,60990,79182.4,555250,110920,157679.4,777100
182520,238577.3,1332350,62670,76353.8,555250,119850,162223.5,777100
191370,204384.4,1332350,63290,59318.6,555250,128080,145065.8,777100
200220,193547.3,1332350,63900,53374,555250,136320,140173.3,777100
209080,197457.2,1332350,64520,54110.7,555250,144560,143346.5,777100
217880,194487.4,1332350,65120,50186.6,555250,152760,144300.8,777100
223750,203523.9,1332350,64920,55694.9,555250,158830,147829,777100
229640,205323.7,1332350,64700,55381.6,555250,164940,149942.1,777100
235500,208781,1332350,64460,57028.2,555250,171040,151752.8,777100
241360,226823.6,1332350,64250,60126.8,555250,177110,166696.8,777100
236800,222291.9,1332350,61710,59577.7,555250,175090,162714.2,777100
232230,219741.6,1332350,59180,56663.7,555250,173050,163077.9,777100
227700,215648.4,1332350,56650,52178.3,555250,171050,163470.1,777100
223160,193336.3,1332350,54130,43289.8,555250,169030,150046.5,777100
218240,215609.7,1332350,51110,53926.6,555250,167130,161683.1,777100
213450,213774.6,1332350,48100,46339.2,555250,165350,167435.4,777100
208600,220474.3,1332350,45100,42119.6,555250,163500,178354.7,777100
203670,211423.7,1332350,42070,40119.8,555250,161600,171303.9,777100
198150,184302.4,1332350,39160,38699.7,555250,158990,145602.7,777100
192660,176023.8,1332350,36310,34487.2,555250,156350,141536.6,777100
187270,169697.9,1332350,33430,34964.6,555250,153840,134733.3,777100
181870,169175.7,1332350,30580,33215.2,555250,151290,135960.5,777100
175800,178526.5,1332350,29180,40542,555250,146620,137984.5,777100
169900,168236.1,1332350,27820,35584.2,555250,142080,132651.9,777100
163920,149099.4,1332350,26440,24899.3,555250,137480,124200.1,777100
158000,160058.5,1332350,25050,29166.8,555250,132950,130891.7,777100
151590,161681.9,1332350,23920,31274,555250,127670,130407.9,777100
145100,144968,1332350,22760,24193.4,555250,122340,120774.6,777100
138670,125736.7,1332350,21570,20068.9,555250,117100,105667.8,777100
132200,122354.6,1332350,20430,19120.2,555250,111770,103234.4,777100
125860,111840.7,1332350,19430,15506.9,555250,106430,96333.8,777100
119520,104828,1332350,18420,15316.2,555250,101100,89511.8,777100
113220,93209.5,1332350,17400,12584.3,555250,95820,80625.2,777100
106870,87002.7,1332350,16390,10591.2,555250,90480,76411.5,777100
102800,86613,1332350,15780,11866.5,555250,87020,74746.5,777100
98650,85158.7,1332350,15130,11968.2,555250,83520,73190.5,777100
94600,85871.2,1332350,14510,12700.4,555250,80090,73170.8,777100
90550,83245.8,1332350,13900,12513.2,555250,76650,70732.6,777100
85900,81670.9,1332350,12970,9750.7,555250,72930,71920.2,777100
81380,80656.3,1332350,12060,8656.9,555250,69320,71999.4,777100
76810,75370.9,1332350,11160,7707,555250,65650,67663.9,777100
72250,74023.1,1332350,10250,6974.3,555250,62000,67048.8,777100
68110,68095.1,1332350,9590,7113.5,555250,58520,60981.6,777100
63950,63231.7,1332350,8910,6086.8,555250,55040,57144.9,777100
59840,57212.3,1332350,8270,3851.3,555250,51570,53361,777100
55720,54253.2,1332350,7590,3354.7,555250,48130,50898.5,777100
53410,51522.9,1332350,7400,3134.3,555250,46010,48388.6,777100
51110,48168,1332350,7200,2792.9,555250,43910,45375.1,777100
48760,41227.5,1332350,6970,2243.2,555250,41790,38984.3,777100
46170,36481.9,1332350,6090,2094.1,555250,40080,34387.8,777100
42830,31700.2,1332350,5640,2084,555250,37190,29616.2,777100
39540,28967.4,1332350,5160,1968.6,555250,34380,26998.8,777100
36200,26117.1,1332350,4720,1566.1,555250,31480,24551,777100
32880,23614.4,1332350,4250,1266.7,555250,28630,22347.7,777100
29920,21783.9,1332350,3830,1146.4,555250,26090,20637.5,777100
26820,17644.6,1332350,3410,873.5,555250,23410,16771.1,777100
23850,15674.1,1332350,2980,849.1,555250,20870,14825,777100
20820,15016.2,1332350,2580,1277.6,555250,18240,13738.6,777100
19830,13466.2,1332350,2440,1204,555250,17390,12262.2,777100
18810,15559.9,1332350,2320,2954.1,555250,16490,12605.8,777100
17790,17164.8,1332350,2180,4055.5,555250,15610,13109.3,777100
16830,10594.7,1332350,2070,551.7,555250,14760,10043,777100
16110,10419.6,1332350,2180,905.9,555250,13930,9513.7,777100
15300,12383.1,1332350,2300,2546.8,555250,13000,9836.3,777100
14610,12375.6,1332350,2420,3047.6,555250,12190,9328,777100
13880,9401.3,1332350,2560,1280.9,555250,11320,8120.4,777100
12960,7704.4,1332350,2470,667.1,555250,10490,7037.3,777100
11910,7524.6,1332350,2380,735.8,555250,9530,6788.8,777100
10860,7390.4,1332350,2270,653.3,555250,8590,6737.1,777100
9910,6701.6,1332350,2170,462.1,555250,7740,6239.5,777100
9700,7475.6,1332350,2350,643.1,555250,7350,6832.5,777100
9530,6484.2,1332350,2510,151.1,555250,7020,6333.1,777100
9340,6830.7,1332350,2710,141.6,555250,6630,6689.1,777100
9120,7207.4,1332350,2860,222.9,555250,6260,6984.5,777100
8680,7080.7,1332350,2700,431.8,555250,5980,6648.9,777100
8250,6860.8,1332350,2560,381.6,555250,5690,6479.2,777100
7720,6060.6,1332350,2400,241.6,555250,5320,5819,777100
7340,8014.4,1332350,2260,411,555250,5080,7603.4,777100
6870,9047.9,1332350,2120,545.4,555250,4750,8502.5,777100
6490,8927.1,1332350,2020,543.5,555250,4470,8383.6,777100
6100,10931.3,1332350,1900,972.4,555250,4200,9958.9,777100
5680,10642.3,1332350,1800,876.1,555250,3880,9766.2,777100
5270,9898.5,1332350,1650,1061.6,555250,3620,8836.9,777100
4880,9050,1332350,1480,1201.1,555250,3400,7848.9,777100
4500,9040.5,1332350,1330,1389.4,555250,3170,7651.1,777100
4090,8231,1332350,1160,1018.7,555250,2930,7212.3,777100
3660,7181.6,1332350,1020,568.8,555250,2640,6612.8,777100
3180,5995.2,1332350,840,456,555250,2340,5539.2,777100
2670,6335.6,1332350,670,486,555250,2000,5849.6,777100
2210,6250.9,1332350,500,436,555250,1710,5814.9,777100
1910,6254.3,1332350,460,436,555250,1450,5818.3,777100
1700,5911,1332350,430,357.9,555250,1270,5553.1,777100
1400,5734.9,1332350,400,339.4,555250,1000,5395.5,777100
1180,5760.6,1332350,360,365.7,555250,820,5394.9,777100
1180,6130.2,1332350,390,398,555250,790,5732.2,777100
1200,6615.1,1332350,430,418.9,555250,770,6196.2,777100
1210,7300.8,1332350,460,430,555250,750,6870.8,777100
1210,8250.2,1332350,480,435.8,555250,730,7814.4,777100
1330,8717.5,1332350,610,445.5,555250,720,8272,777100
1420,8231.9,1332350,690,369.8,555250,730,7862.1,777100
1520,8033.2,1332350,800,409.1,555250,720,7624.1,777100
1610,8158.8,1332350,900,418.4,555250,710,7740.4,777100
1570,8053.6,1332350,850,373.4,555250,720,7680.2,777100
1580,7969.1,1332350,790,429.8,555250,790,7539.3,777100
1530,7454.9,1332350,720,471.4,555250,810,6983.5,777100
1480,8048.7,1332350,680,421.7,555250,800,7627,777100
1620,8306.2,1332350,600,586.9,555250,1020,7719.3,777100
1800,9306.8,1332350,560,891.1,555250,1240,8415.7,777100
1980,10240.3,1332350,490,1144.4,555250,1490,9095.9,777100
2130,9336.2,1332350,440,980.9,555250,1690,8355.3,777100
2320,8928.9,1332350,440,771,555250,1880,8157.9,777100
2530,8603.3,1332350,440,840,555250,2090,7763.3,777100
2680,7841.6,1332350,440,819.2,555250,2240,7022.4,777100
2910,7762.7,1332350,450,758.7,555250,2460,7004,777100
2910,8872,1332350,420,595.2,555250,2490,8276.8,777100
3020,10005.9,1332350,400,607.9,555250,2620,9398,777100
3030,8242.5,1332350,370,597.1,555250,2660,7645.4,777100
3070,7941.6,1332350,350,654.4,555250,2720,7287.2,777100
3440,9011.1,1332350,390,491.7,555250,3050,8519.4,777100
3740,8597.7,1332350,420,541.3,555250,3320,8056.4,777100
4120,9016.1,1332350,460,620.9,555250,3660,8395.2,777100
4500,9655.5,1332350,500,610.6,555250,4000,9044.9,777100
5110,9780.4,1332350,560,729,555250,4550,9051.4,777100
5710,9009.8,1332350,620,633.9,555250,5090,8375.9,777100
6360,9322.9,1332350,710,641,555250,5650,8681.9,777100
7020,10026,1332350,790,681,555250,6230,9345,777100
7570,11037.9,1332350,900,763.2,555250,6670,10274.7,777100
8200,9364.5,1332350,1020,752.5,555250,7180,8612,777100
8760,10235,1332350,1130,898.5,555250,7630,9336.5,777100
9400,12072.1,1332350,1290,1011,555250,8110,11061.1,777100
12350,13723.2,1332350,1820,1041.6,555250,10530,12681.6,777100
15290,14088.7,1332350,2360,1159.6,555250,12930,12929.1,777100
18240,14185.5,1332350,2900,1243.3,555250,15340,12942.2,777100
21220,15549.3,1332350,3430,1314.9,555250,17790,14234.4,777100
23910,17325.4,1332350,3860,1256,555250,20050,16069.4,777100
26640,22110.8,1332350,4310,1345.4,555250,22330,20765.4,777100
29430,25152.9,1332350,4750,1336,555250,24680,23816.9,777100
32170,25426.3,1332350,5160,1248.5,555250,27010,24177.8,777100
34930,27622.3,1332350,5610,1429.2,555250,29320,26193.1,777100
37700,32928.6,1332350,6000,2880.1,555250,31700,30048.5,777100
40530,32509.9,1332350,6420,2812.8,555250,34110,29697.1,777100
43290,33304.8,1332350,6800,3422,555250,36490,29882.8,777100
46510,39599.1,1332350,7730,5247.4,555250,38780,34351.7,777100
49800,46381.3,1332350,8630,7132,555250,41170,39249.3,777100
53100,48084.6,1332350,9530,6979.6,555250,43570,41105,777100
26770,46297.8,1332350,1590,6839.8,555250,25180,39458,777100
28150,46066.8,1332350,1830,8184.9,555250,26320,37881.9,777100
29500,44594.1,1332350,2070,7658.1,555250,27430,36936,777100
30820,42738.9,1332350,2320,7745.2,555250,28500,34993.7,777100
32150,43063.5,1332350,2570,7937.9,555250,29580,35125.6,777100
33610,44105.1,1332350,2870,8052.7,555250,30740,36052.4,777100
34990,45624,1332350,3170,8449.6,555250,31820,37174.4,777100
36410,46341,1332350,3480,7488.5,555250,32930,38852.5,777100
37830,48496.5,1332350,3780,7435.7,555250,34050,41060.8,777100
37600,49284.9,1332350,3820,6791.7,555250,33780,42493.2,777100
37310,49706.2,1332350,3830,8077.7,555250,33480,41628.5,777100
37120,49492.5,1332350,3890,8472.5,555250,33230,41020,777100
36930,46377.9,1332350,3910,7174.4,555250,33020,39203.5,777100
36770,44107.8,1332350,4020,5846.6,555250,32750,38261.2,777100
36710,44357.2,1332350,4140,5770.2,555250,32570,38587,777100
36530,47986.6,1332350,4250,7520.3,555250,32280,40466.3,777100
36460,45073.1,1332350,4330,6002.6,555250,32130,39070.5,777100
36250,44211.6,1332350,4430,5642,555250,31820,38569.6,777100
36050,42910.8,1332350,4540,5394.6,555250,31510,37516.2,777100
35910,43197.4,1332350,4620,5537.1,555250,31290,37660.3,777100
35790,44233.8,1332350,4720,5881.4,555250,31070,38352.4,777100
33580,48885.6,1332350,4440,8230.7,555250,29140,40654.9,777100
31490,55386.3,1332350,4160,9635.6,555250,27330,45750.7,777100
29350,57892.8,1332350,3890,9817.1,555250,25460,48075.7,777100
27190,54332.1,1332350,3590,7307.6,555250,23600,47024.5,777100
25140,53147.3,1332350,3360,6952.5,555250,21780,46194.8,777100
23100,49992.3,1332350,3120,5893.7,555250,19980,44098.6,777100
21090,48607.4,1332350,2900,6317.7,555250,18190,42289.7,777100
18970,45671.1,1332350,2640,4643.3,555250,16330,41027.8,777100
17020,46667.6,1332350,2400,5608.3,555250,14620,41059.3,777100
14960,43525.7,1332350,2160,5269,555250,12800,38256.7,777100
12920,39209.7,1332350,1900,4572.2,555250,11020,34637.5,777100
10950,35358.5,1332350,1640,3500.1,555250,9310,31858.4,777100
10050,33834,1332350,1530,2847.3,555250,8520,30986.7,777100
9220,32936.7,1332350,1410,2671.3,555250,7810,30265.4,777100
8310,28087.4,1332350,1300,2400.2,555250,7010,25687.2,777100
7410,22328.5,1332350,1150,2156.3,555250,6260,20172.2,777100
6540,17717.7,1332350,1050,1827.9,555250,5490,15889.8,777100
5640,15827.9,1332350,930,1861.1,555250,4710,13966.8,777100
4730,13454,1332350,820,1544.3,555250,3910,11909.7,777100
3880,11258.5,1332350,720,998.5,555250,3160,10260,777100
3070,9260.3,1332350,650,477.1,555250,2420,8783.2,777100
2300,7196,1332350,590,339.1,555250,1710,6856.9,777100
1510,6438.8,1332350,530,422.6,555250,980,6016.2,777100
730,4061.1,1332350,480,786.4,555250,250,3274.7,777100
730,2895.2,1332350,390,254.2,555250,340,2641,777100
730,3066.1,1332350,300,243.3,555250,430,2822.8,777100
810,3479.3,1332350,220,244.1,555250,590,3235.2,777100
890,4748,1332350,150,366.5,555250,740,4381.5,777100
970,7469.1,1332350,170,1354.9,555250,800,6114.2,777100
1080,8146.7,1332350,200,1741.3,555250,880,6405.4,777100
1210,8112.7,1332350,230,946.5,555250,980,7166.2,777100
1330,6885.3,1332350,250,798.3,555250,1080,6087,777100
1450,7592.1,1332350,280,1185.9,555250,1170,6406.2,777100
1550,9186.3,1332350,280,2142.3,555250,1270,7044,777100
1710,6836.5,1332350,310,729.2,555250,1400,6107.3,777100
1840,7136.4,1332350,320,616.8,555250,1520,6519.6,777100
1810,5594,1332350,390,536.1,555250,1420,5057.9,777100
1810,5508.9,1332350,470,881.8,555250,1340,4627.1,777100
1840,7397.5,1332350,550,2327.8,555250,1290,5069.7,777100
1810,5014.2,1332350,610,945.9,555250,1200,4068.3,777100
1800,1577.9,1332350,640,148.5,555250,1160,1429.4,777100
1810,2076.2,1332350,670,184.7,555250,1140,1891.5,777100
1740,1637.3,1332350,680,135.5,555250,1060,1501.8,777100
1710,1595.6,1332350,700,166.5,555250,1010,1429.1,777100
1830,1788.6,1332350,790,554.4,555250,1040,1234.2,777100
1840,1896,1332350,880,572.4,555250,960,1323.6,777100
1940,1617.5,1332350,970,540,555250,970,1077.5,777100
2030,1227.3,1332350,1060,205,555250,970,1022.3,777100
2050,1501.2,1332350,1040,228.1,555250,1010,1273.1,777100
2110,1541.7,1332350,1040,168.9,555250,1070,1372.8,777100
2150,1759.9,1332350,1020,143.5,555250,1130,1616.4,777100
2210,1682,1332350,1030,206.1,555250,1180,1475.9,777100
2320,1978.7,1332350,1040,231.3,555250,1280,1747.4,777100
2530,2867.6,1332350,1090,186.6,555250,1440,2681,777100
2760,2603.4,1332350,1150,156.5,555250,1610,2446.9,777100
2950,3349.6,1332350,1170,143.5,555250,1780,3206.1,777100
3380,3509.4,1332350,1180,136,555250,2200,3373.4,777100
3860,3606.6,1332350,1210,136,555250,2650,3470.6,777100
4310,3700.7,1332350,1230,156.3,555250,3080,3544.4,777100
4710,4681.5,1332350,1240,224,555250,3470,4457.5,777100
7050,7275.6,1332350,1670,473.7,555250,5380,6801.9,777100
9240,7975.9,1332350,2030,409,555250,7210,7566.9,777100
11540,9873.3,1332350,2410,516.5,555250,9130,9356.8,777100
13720,12375.4,1332350,2780,926.4,555250,10940,11449,777100
16230,14794.7,1332350,3320,1217.6,555250,12910,13577.1,777100
18690,18735.5,1332350,3830,1865.9,555250,14860,16869.6,777100
21190,24310.3,1332350,4380,4498.3,555250,16810,19812,777100
23630,28814.7,1332350,4890,6757,555250,18740,22057.7,777100
25710,34302.4,1332350,5300,9454.7,555250,20410,24847.7,777100
27770,31633.2,1332350,5720,6568.8,555250,22050,25064.4,777100
29760,32370.8,1332350,6110,6488.2,555250,23650,25882.6,777100
31790,32222.6,1332350,6550,7338.3,555250,25240,24884.3,777100
33350,34132.5,1332350,7320,8085.5,555250,26030,26047,777100
34760,38552.1,1332350,8050,10079.9,555250,26710,28472.2,777100
36290,43239.6,1332350,8810,12113.1,555250,27480,31126.5,777100
42070,47572.6,1332350,12120,14335.5,555250,29950,33237.1,777100
44000,46668.9,1332350,12450,13704,555250,31550,32964.9,777100
45840,48522.9,1332350,12760,13963.7,555250,33080,34559.2,777100
47800,47989.7,1332350,13110,13755.7,555250,34690,34234,777100
49640,47885.5,1332350,13430,15238.6,555250,36210,32646.9,777100
52420,49337.9,1332350,14580,14884.1,555250,37840,34453.8,777100
55130,51426,1332350,15710,16250.3,555250,39420,35175.7,777100
57790,50435.1,1332350,16820,15918.2,555250,40970,34516.9,777100
60520,45768.9,1332350,17970,12952.7,555250,42550,32816.2,777100
58390,46406.3,1332350,17920,14608.3,555250,40470,31798,777100
56170,45552.5,1332350,17850,16089.6,555250,38320,29462.9,777100
54020,38237.3,1332350,17810,14368.6,555250,36210,23868.7,777100
51740,30277.7,1332350,17740,10664.2,555250,34000,19613.5,777100
48580,22055.4,1332350,16780,7122.5,555250,31800,14932.9,777100
45330,19886.8,1332350,15790,6848.7,555250,29540,13038.1,777100
42170,31654.9,1332350,14810,14994.5,555250,27360,16660.4,777100
38900,38972.8,1332350,13870,19255.7,555250,25030,19717.1,777100
37030,32869.5,1332350,13850,16232.2,555250,23180,16637.3,777100
35170,29490,1332350,13820,14842.6,555250,21350,14647.4,777100
33230,36171.2,1332350,13790,19398.5,555250,19440,16772.7,777100
31320,32855.1,1332350,13760,18325.7,555250,17560,14529.4,777100
30370,34235.6,1332350,13260,19861.9,555250,17110,14373.7,777100
29350,46776.9,1332350,12780,27197.4,555250,16570,19579.5,777100
28380,34691,1332350,12280,19921.9,555250,16100,14769.1,777100
27330,14651.1,1332350,11750,7908.2,555250,15580,6742.9,777100
26610,3297.2,1332350,11460,595.6,555250,15150,2701.6,777100
25890,3027.4,1332350,11170,513.2,555250,14720,2514.2,777100
25230,3236.3,1332350,10870,543.5,555250,14360,2692.8,777100
24550,3583.6,1332350,10580,536,555250,13970,3047.6,777100
29260,1774.1,1332350,15590,363.6,555250,13670,1410.5,777100
33930,2725.7,1332350,20660,1500.6,555250,13270,1225.1,777100
38700,1143.4,1332350,25720,477.3,555250,12980,666.1,777100
43410,809.9,1332350,30750,200,555250,12660,609.9,777100
44600,853.6,1332350,31480,389.2,555250,13120,464.4,777100
45720,7423.5,1332350,32150,6635.9,555250,13570,787.6,777100
46940,1671.7,1332350,32860,947.5,555250,14080,724.2,777100
48110,2113.8,1332350,33560,624.7,555250,14550,1489.1,777100
49330,1551.1,1332350,35700,340.2,555250,13630,1210.9,777100
50600,1742.2,1332350,37870,212.5,555250,12730,1529.7,777100
51830,4190.6,1332350,40010,2148.5,555250,11820,2042.1,777100
53010,2730.8,1332350,42170,679.1,555250,10840,2051.7,777100
51280,2441.4,1332350,40820,141.6,555250,10460,2299.8,777100
49470,3893.4,1332350,39450,328.9,555250,10020,3564.5,777100
47630,2891.7,1332350,38090,136,555250,9540,2755.7,777100
45860,2655.3,1332350,36730,149.1,555250,9130,2506.2,777100
49190,2434.6,1332350,37640,143.5,555250,11550,2291.1,777100
52530,3831.2,1332350,38540,336,555250,13990,3495.2,777100
55920,7886.5,1332350,39460,4476.4,555250,16460,3410.1,777100
59260,7912.4,1332350,40390,4825,555250,18870,3087.4,777100
58990,9550.5,1332350,37120,4747.5,555250,21870,4803,777100
58750,11045.6,1332350,33880,4798.7,555250,24870,6246.9,777100
58510,13456.3,1332350,30650,5114.2,555250,27860,8342.1,777100
58280,16933.1,1332350,27430,5355.1,555250,30850,11578,777100
56180,19087.2,1332350,24020,5218.8,555250,32160,13868.4,777100
54160,22530.9,1332350,20610,5019.3,555250,33550,17511.6,777100
52150,26512,1332350,17230,4931.5,555250,34920,21580.5,777100
50040,30901.8,1332350,13820,5485.3,555250,36220,25416.5,777100
47340,32319.2,1332350,12370,5424.9,555250,34970,26894.3,777100
44520,31429.7,1332350,10910,5167.2,555250,33610,26262.5,777100
41790,31819.2,1332350,9480,5455.2,555250,32310,26364,777100
39100,32683.1,1332350,8030,5941.9,555250,31070,26741.2,777100
37780,38976.1,1332350,8310,6248.6,555250,29470,32727.5,777100
36450,33840.4,1332350,8570,4775.8,555250,27880,29064.6,777100
35070,29154.4,1332350,8870,4107.1,555250,26200,25047.3,777100
33740,25585.2,1332350,9140,3251,555250,24600,22334.2,777100
34320,31784.4,1332350,10480,4561.3,555250,23840,27223.1,777100
34910,35706.4,1332350,11810,4964.4,555250,23100,30742,777100
35490,37856.8,1332350,13150,5820.3,555250,22340,32036.5,777100
36080,40374.3,1332350,14480,6869.3,555250,21600,33505,777100
38730,52813,1332350,16250,11599.1,555250,22480,41213.9,777100
41360,55437.1,1332350,18050,10221.8,555250,23310,45215.3,777100
44100,51760.7,1332350,19860,8073.7,555250,24240,43687,777100
46770,60687.5,1332350,21650,11032.6,555250,25120,49654.9,777100
48590,61504.2,1332350,22100,10454.6,555250,26490,51049.6,777100
50350,62125.3,1332350,22510,9059.1,555250,27840,53066.2,777100
52210,67893.6,1332350,22950,10900.3,555250,29260,56993.3,777100
54010,70180.6,1332350,23390,13660.6,555250,30620,56520,777100
58990,70963.6,1332350,26540,17519.9,555250,32450,53443.7,777100
63910,77302.8,1332350,29680,19423.8,555250,34230,57879,777100
68920,67536.7,1332350,32820,14350,555250,36100,53186.7,777100
73900,53868.8,1332350,35960,5812.2,555250,37940,48056.6,777100
81100,66653.4,1332350,40140,7458.9,555250,40960,59194.5,777100
88360,90156.8,1332350,44320,7928.7,555250,44040,82228.1,777100
95570,90061,1332350,48490,8993.3,555250,47080,81067.7,777100
102750,68409.8,1332350,52630,6033.9,555250,50120,62375.9,777100
105590,62986.5,1332350,53000,8163,555250,52590,54823.5,777100
108370,63175.8,1332350,53360,10971.3,555250,55010,52204.5,777100
111250,77146,1332350,53710,13866.1,555250,57540,63279.9,777100
114070,103249.2,1332350,54100,20244.4,555250,59970,83004.8,777100
118800,98266.3,1332350,56170,18590,555250,62630,79676.3,777100
123580,106087.9,1332350,58250,19155.6,555250,65330,86932.3,777100
128330,118824.9,1332350,60340,20094.4,555250,67990,98730.5,777100
133120,123247.2,1332350,62440,21526.3,555250,70680,101720.9,777100
129970,103104.4,1332350,60040,22234,555250,69930,80870.4,777100
126770,101460.9,1332350,57620,22648.9,555250,69150,78812,777100
123640,103899,1332350,55220,21651.4,555250,68420,82247.6,777100
125430,105877.4,1332350,40390,21864.8,555250,85040,84012.6,777100
127480,35699.8,1332350,42570,18269,555250,84910,17430.8,777100
129460,39857.3,1332350,44700,20972.4,555250,84760,18884.9,777100
131430,36871.2,1332350,46870,18051.6,555250,84560,18819.6,777100
133530,46952.9,1332350,49040,28997.5,555250,84490,17955.4,777100
131730,40121.4,1332350,48270,23230,555250,83460,16891.4,777100
129880,28503.3,1332350,47500,13248.4,555250,82380,15254.9,777100
128060,37525.5,1332350,46720,23040.1,555250,81340,14485.4,777100
126320,48974,1332350,45940,36553.8,555250,80380,12420.2,777100
127250,39883.3,1332350,47170,28865.2,555250,80080,11018.1,777100
128260,31183.2,1332350,48380,19641.7,555250,79880,11541.5,777100
129230,26955.4,1332350,49600,14432.2,555250,79630,12523.2,777100
130300,25867.3,1332350,50830,11988.6,555250,79470,13878.7,777100
132820,25915.9,1332350,53400,13120.9,555250,79420,12795,777100
135360,36403.1,1332350,55980,24342.6,555250,79380,12060.5,777100
137970,45911.5,1332350,58570,34259,555250,79400,11652.5,777100
140570,44250.4,1332350,61150,33134.5,555250,79420,11115.9,777100
142770,35868.3,1332350,62960,24893.2,555250,79810,10975.1,777100
144880,28246.6,1332350,64750,16442.5,555250,80130,11804.1,777100
147020,25531.1,1332350,66560,13056.5,555250,80460,12474.6,777100
149120,29335.2,1332350,68300,16819.6,555250,80820,12515.6,777100
147250,42458.9,1332350,67230,30046.3,555250,80020,12412.6,777100
145380,48540.2,1332350,66120,37142.2,555250,79260,11398,777100
143540,53718.6,1332350,65010,42373.1,555250,78530,11345.5,777100
141710,50766.8,1332350,63930,38840.3,555250,77780,11926.5,777100
141260,51840.1,1332350,63550,40692.9,555250,77710,11147.2,777100
140770,50603.3,1332350,63160,39807.5,555250,77610,10795.8,777100
140290,43913.8,1332350,62780,35385.3,555250,77510,8528.5,777100
139830,40938.4,1332350,62420,32831.5,555250,77410,8106.9,777100
139730,50591.9,1332350,62750,41194.4,555250,76980,9397.5,777100
139730,56477.7,1332350,63120,46318.1,555250,76610,10159.6,777100
139630,61789.3,1332350,63480,49272,555250,76150,12517.3,777100
139540,140373.1,1332350,63830,58539,555250,75710,81834.1,777100
133180,143345.1,1332350,61910,60933.2,555250,71270,82411.9,777100
126770,133179.8,1332350,59940,57306.6,555250,66830,75873.2,777100
120470,130326.7,1332350,57980,55661.4,555250,62490,74665.3,777100
114100,125349.4,1332350,56050,48804.5,555250,58050,76544.9,777100
104630,111537,1332350,52390,41728.8,555250,52240,69808.2,777100
95250,88596,1332350,48740,31215.3,555250,46510,57380.7,777100
85760,89000.8,1332350,45060,31638.5,555250,40700,57362.3,777100
76420,103482.4,1332350,41440,38862,555250,34980,64620.4,777100
69490,101990.6,1332350,38900,33272.6,555250,30590,68718,777100
62560,107706.9,1332350,36360,33729.3,555250,26200,73977.6,777100
55630,100973.3,1332350,33850,25874.2,555250,21780,75099.1,777100
48770,82589.3,1332350,31310,24527.2,555250,17460,58062.1,777100
49060,49491,1332350,31170,18246.9,555250,17890,31244.1,777100
49360,55383.2,1332350,31000,23426.4,555250,18360,31956.8,777100
49620,59125.9,1332350,30850,25053.1,555250,18770,34072.8,777100
49940,63608.4,1332350,30680,25834.5,555250,19260,37773.9,777100
50940,78228.4,1332350,31330,28637.7,555250,19610,49590.7,777100
51820,85119.3,1332350,31970,30439.3,555250,19850,54680,777100
52740,83217.8,1332350,32570,32639.1,555250,20170,50578.7,777100
53680,82679.6,1332350,33190,34025,555250,20490,48654.6,777100
53470,84863,1332350,33130,38281,555250,20340,46582,777100
53140,76074.6,1332350,33020,33958.7,555250,20120,42115.9,777100
52950,79632.4,1332350,32940,38111.7,555250,20010,41520.7,777100
52730,77895.3,1332350,32840,34847.9,555250,19890,43047.4,777100
53950,76191.5,1332350,34520,32363.8,555250,19430,43827.7,777100
55230,77142.4,1332350,36180,34569.6,555250,19050,42572.8,777100
56510,78917.7,1332350,37850,41270.9,555250,18660,37646.8,777100
57860,71365.7,1332350,39540,40411,555250,18320,30954.7,777100
59870,65523,1332350,42000,35415.4,555250,17870,30107.6,777100
61860,67290.3,1332350,44490,37886.9,555250,17370,29403.4,777100
63940,78779.8,1332350,47010,51300.9,555250,16930,27478.9,777100
65860,84904.5,1332350,49480,55632.7,555250,16380,29271.8,777100
70090,72231.9,1332350,53770,43918.5,555250,16320,28313.4,777100
74320,67743.6,1332350,58090,39066.9,555250,16230,28676.7,777100
78490,62117.3,1332350,62390,36455.6,555250,16100,25661.7,777100
82810,60314,1332350,66700,35489.1,555250,16110,24824.9,777100
92150,67525.3,1332350,72920,43487.1,555250,19230,24038.2,777100
101490,73381.4,1332350,79130,46850.8,555250,22360,26530.6,777100
110810,73108.4,1332350,85340,46725.1,555250,25470,26383.3,777100
120210,78170.4,1332350,91560,47855.6,555250,28650,30314.8,777100
129940,82388,1332350,97760,50493.5,555250,32180,31894.5,777100
139640,80796.4,1332350,104000,49022.7,555250,35640,31773.7,777100
149350,80919.4,1332350,110200,48553.1,555250,39150,32366.3,777100
159140,90329.9,1332350,116410,55949.2,555250,42730,34380.7,777100
167080,103538.5,1332350,120970,66560.3,555250,46110,36978.2,777100
175030,112460.9,1332350,125510,73033,555250,49520,39427.9,777100
183010,119503.3,1332350,130040,73898.3,555250,52970,45605,777100
190900,138816.4,1332350,134580,82133.3,555250,56320,56683.1,777100
200890,162527,1332350,136250,94524.4,555250,64640,68002.6,777100
210900,196189.8,1332350,137960,109072.1,555250,72940,87117.7,777100
220870,243994.7,1332350,139640,133800.2,555250,81230,110194.5,777100
230890,285407.4,1332350,141360,160360.5,555250,89530,125046.9,777100
239870,310141.9,1332350,142090,168818.9,555250,97780,141323,777100
248950,343352.1,1332350,142860,175050.3,555250,106090,168301.8,777100
257940,360050,1332350,143620,178967.9,555250,114320,181082.1,777100
266930,386537.2,1332350,144380,194886.3,555250,122550,191650.9,777100
276790,397942.4,1332350,146030,198927,555250,130760,199015.4,777100
286620,216173.1,1332350,147680,174573.5,555250,138940,41599.6,777100
296550,215615.9,1332350,149340,171352.7,555250,147210,44263.2,777100
306390,224810.4,1332350,151020,179250.3,555250,155370,45560.1,777100
309400,234103.4,1332350,152710,190909.6,555250,156690,43193.8,777100
312460,254814.6,1332350,154420,210407.4,555250,158040,44407.2,777100
315500,283557.4,1332350,156140,239022.9,555250,159360,44534.5,777100
231440,302230.8,1332350,109550,255375.1,555250,121890,46855.7,777100
235140,304454.6,1332350,110990,257111.7,555250,124150,47342.9,777100
238910,311479.4,1332350,112430,265411.4,555250,126480,46068,777100
242550,309791.7,1332350,113910,260707.7,555250,128640,49084,777100
246230,300631.5,1332350,115360,249836.5,555250,130870,50795,777100
250260,296280.9,1332350,117030,245881.6,555250,133230,50399.3,777100
254340,290883.6,1332350,118690,240510.2,555250,135650,50373.4,777100
258460,276011.8,1332350,120360,227122.5,555250,138100,48889.3,777100
262550,255388.7,1332350,122020,205535.1,555250,140530,49853.6,777100
258180,233892,1332350,118400,184902.8,555250,139780,48989.2,777100
253870,221965.6,1332350,114770,173607.6,555250,139100,48358,777100
249520,207364.8,1332350,111170,156184.3,555250,138350,51180.5,777100
245160,185826.2,1332350,107560,134459.1,555250,137600,51367.1,777100
240810,173083.4,1332350,104150,124226.5,555250,136660,48856.9,777100
236440,164645.7,1332350,100770,118225.6,555250,135670,46420.1,777100
232030,164968.9,1332350,97360,118500.8,555250,134670,46468.1,777100
227670,148827.9,1332350,93970,101739.6,555250,133700,47088.3,777100
221480,139329.4,1332350,89110,93051.6,555250,132370,46277.8,777100
215350,134036.8,1332350,84270,90289.5,555250,131080,43747.3,777100
209170,133984.4,1332350,79450,93244.7,555250,129720,40739.7,777100
203050,131136.5,1332350,74580,91202.3,555250,128470,39934.2,777100
195870,127977,1332350,71290,87391.4,555250,124580,40585.6,777100
188760,121707.1,1332350,67970,82548.5,555250,120790,39158.6,777100
181600,241588.9,1332350,64670,84011,555250,116930,157577.9,777100
174520,241272.9,1332350,61370,87062.9,555250,113150,154210,777100
165020,236955,1332350,55920,90007.8,555250,109100,146947.2,777100
155590,246803,1332350,50510,103071.9,555250,105080,143731.1,777100
146240,238876,1332350,45080,100516.8,555250,101160,138359.2,777100
136790,192282.8,1332350,39650,70417.3,555250,97140,121865.5,777100
128580,180465.1,1332350,35640,84083.6,555250,92940,96381.5,777100
120370,221065.1,1332350,31640,104464,555250,88730,116601.1,777100
112120,252260.9,1332350,27630,109001.4,555250,84490,143259.5,777100
103920,169990.7,1332350,23630,65383.1,555250,80290,104607.6,777100
97050,167224.7,1332350,21060,59084.7,555250,75990,108140,777100
90230,210367.7,1332350,18510,91316.4,555250,71720,119051.3,777100
83330,200999.2,1332350,15910,108935.6,555250,67420,92063.6,777100
76450,157213.2,1332350,13370,81514.7,555250,63080,75698.5,777100
70110,95022.2,1332350,11950,30640.3,555250,58160,64381.9,777100
63640,69338.9,1332350,10510,17831.2,555250,53130,51507.7,777100
57230,53379.7,1332350,9100,4666.2,555250,48130,48713.5,777100
50810,46350.5,1332350,7670,3057.6,555250,43140,43292.9,777100
46820,39424.3,1332350,6510,2939.3,555250,40310,36485,777100
42870,37564.4,1332350,5330,5308.3,555250,37540,32256.1,777100
38910,47885.3,1332350,4170,7447.2,555250,34740,40438.1,777100
34920,40627.5,1332350,3020,6450.5,555250,31900,34177,777100
32930,35283,1332350,3120,13499.6,555250,29810,21783.4,777100
30980,36127.5,1332350,3200,16508.6,555250,27780,19618.9,777100
29030,22807.3,1332350,3300,6765.8,555250,25730,16041.5,777100
27070,21791,1332350,3410,2473.4,555250,23660,19317.6,777100
26030,26965.4,1332350,3710,1232.7,555250,22320,25732.7,777100
25000,20005,1332350,4020,1185,555250,20980,18820,777100
24010,13156.7,1332350,4350,1218.6,555250,19660,11938.1,777100
22960,16147,1332350,4660,2579.2,555250,18300,13567.8,777100
22980,17839.4,1332350,5080,2600,555250,17900,15239.4,777100
22920,15540.5,1332350,5470,1331.4,555250,17450,14209.1,777100
22930,17070.7,1332350,5860,1157.7,555250,17070,15913,777100
22920,19410,1332350,6250,1550.8,555250,16670,17859.2,777100
22660,24270.9,1332350,6040,3356.9,555250,16620,20914,777100
22370,24533.1,1332350,5790,2891.7,555250,16580,21641.4,777100
22160,21395.5,1332350,5590,2241.3,555250,16570,19154.2,777100
21930,23891.6,1332350,5360,3045.5,555250,16570,20846.1,777100
21900,40275.5,1332350,5210,9384.9,555250,16690,30890.6,777100
21820,115534.9,1332350,5040,43108.1,555250,16780,72426.8,777100
21790,88089.7,1332350,4890,33190,555250,16900,54899.7,777100
21760,70245.6,1332350,4730,20841.7,555250,17030,49403.9,777100
22530,52472.1,1332350,5320,14661.4,555250,17210,37810.7,777100
23350,73028.5,1332350,5920,22618.8,555250,17430,50409.7,777100
24140,58147.8,1332350,6510,21796.9,555250,17630,36350.9,777100
24880,46655.6,1332350,7120,15935.6,555250,17760,30720,777100
27690,36300,1332350,8240,12551.5,555250,19450,23748.5,777100
30430,42675.7,1332350,9320,11292,555250,21110,31383.7,777100
33160,24981.3,1332350,10370,8530.3,555250,22790,16451,777100
35940,19297.9,1332350,11480,3310.9,555250,24460,15987,777100
38490,37382.1,1332350,12390,11883.6,555250,26100,25498.5,777100
41090,30684.9,1332350,13280,9257.6,555250,27810,21427.3,777100
43590,25717.2,1332350,14160,7226,555250,29430,18491.2,777100
46130,23976.5,1332350,15070,6473.1,555250,31060,17503.4,777100
49210,37911.8,1332350,16330,10266.6,555250,32880,27645.2,777100
52370,33081.5,1332350,17580,6111,555250,34790,26970.5,777100
55450,28665.6,1332350,18810,4965.9,555250,36640,23699.7,777100
58550,20988.4,1332350,20090,4354.1,555250,38460,16634.3,777100
62940,25744.9,1332350,21240,6044.3,555250,41700,19700.6,777100
67370,26958.7,1332350,22420,7821.1,555250,44950,19137.6,777100
71740,25047.2,1332350,23560,7254.5,555250,48180,17792.7,777100
76170,20743.5,1332350,24730,4791.6,555250,51440,15951.9,777100
80710,23066.2,1332350,26200,4295.1,555250,54510,18771.1,777100
85300,26314.3,1332350,27700,5152.1,555250,57600,21162.2,777100
89830,26593.6,1332350,29150,5114.7,555250,60680,21478.9,777100
94470,32155.1,1332350,30640,7169.7,555250,63830,24985.4,777100
99290,32173,1332350,33100,7186.9,555250,66190,24986.1,777100
104090,33557.6,1332350,35530,7427,555250,68560,26130.6,777100
108940,36960.4,1332350,37980,9789.8,555250,70960,27170.6,777100
113800,32547.8,1332350,40430,7819.2,555250,73370,24728.6,777100
112800,45112,1332350,39170,11991.6,555250,73630,33120.4,777100
111760,56130.5,1332350,37920,15135.5,555250,73840,40995,777100
110720,61044.7,1332350,36650,16536.2,555250,74070,44508.5,777100
56170,61114.2,1332350,16300,15171,555250,39870,45943.2,777100
56990,80897.1,1332350,16290,22430.2,555250,40700,58466.9,777100
57880,104912.7,1332350,16290,31444.5,555250,41590,73468.2,777100
58630,77105.4,1332350,16270,19202.9,555250,42360,57902.5,777100
59540,80100.4,1332350,16270,19733.3,555250,43270,60367.1,777100
61200,95178.2,1332350,16900,24845.9,555250,44300,70332.3,777100
62720,103990.5,1332350,17500,32593,555250,45220,71397.5,777100
64310,94791.2,1332350,18140,27467.5,555250,46170,67323.7,777100
65890,90528,1332350,18760,30416.5,555250,47130,60111.5,777100
68440,99613.4,1332350,19660,31617.9,555250,48780,67995.5,777100
71000,106584.5,1332350,20580,34329.4,555250,50420,72255.1,777100
73540,102813.5,1332350,21510,33823.5,555250,52030,68990,777100
76020,107898.7,1332350,22410,39804.2,555250,53610,68094.5,777100
77700,98049.2,1332350,22810,40330.5,555250,54890,57718.7,777100
79260,90296.7,1332350,23230,41573.4,555250,56030,48723.3,777100
80730,84318.5,1332350,23630,35418.9,555250,57100,48899.6,777100
82300,97756.8,1332350,24030,41521.3,555250,58270,56235.5,777100
84980,116506.3,1332350,25210,46844.8,555250,59770,69661.5,777100
87590,134910.8,1332350,26390,50212.5,555250,61200,84698.3,777100
90190,132953.8,1332350,27570,47133.7,555250,62620,85820.1,777100
92830,163729.2,1332350,28750,67675.9,555250,64080,96053.3,777100
97390,169883.2,1332350,32030,62249.6,555250,65360,107633.6,777100
101840,176128.7,1332350,35260,67906.5,555250,66580,108222.2,777100
106340,201010.2,1332350,38540,82356.1,555250,67800,118654.1,777100
110760,202232,1332350,41790,83616.1,555250,68970,118615.9,777100
115380,175722.4,1332350,45410,65571,555250,69970,110151.4,777100
120070,203184.6,1332350,49040,86201.6,555250,71030,116983,777100
124800,214057,1332350,52660,92732.8,555250,72140,121324.2,777100
129530,250332.1,1332350,56310,110783.1,555250,73220,139549,777100
134710,240415.3,1332350,60680,102610.7,555250,74030,137804.6,777100
139790,217473.4,1332350,65050,87095.6,555250,74740,130377.8,777100
144940,115685.2,1332350,69430,88230.2,555250,75510,27455,777100
150220,120810.1,1332350,73830,94776.9,555250,76390,26033.2,777100
153070,119106.6,1332350,78210,92055.7,555250,74860,27050.9,777100
155960,114160.6,1332350,82590,88179.9,555250,73370,25980.7,777100
158830,127277.7,1332350,86970,108242.3,555250,71860,19035.4,777100
161730,149298.9,1332350,91330,130843,555250,70400,18455.9,777100
165220,135705,1332350,96550,119456.6,555250,68670,16248.4,777100
168710,107052.6,1332350,101750,95514.3,555250,66960,11538.3,777100
172260,105079,1332350,106980,94306.5,555250,65280,10772.5,777100
175730,106073.4,1332350,112160,93724.8,555250,63570,12348.6,777100
176940,117195,1332350,114770,103231.9,555250,62170,13963.1,777100
178290,122964.2,1332350,117360,106067.9,555250,60930,16896.3,777100
179500,146988.3,1332350,119960,129359.2,555250,59540,17629.1,777100
180680,143132.1,1332350,122540,126804.3,555250,58140,16327.8,777100
171310,134944.5,1332350,116100,118468,555250,55210,16476.5,777100
161820,131484.6,1332350,109650,116801.7,555250,52170,14682.9,777100
152440,144768.1,1332350,103200,128007.8,555250,49240,16760.3,777100
143020,138087.1,1332350,96720,123785.9,555250,46300,14301.2,777100
133970,120659.4,1332350,90700,110263.4,555250,43270,10396,777100
124980,107438.4,1332350,84680,96949,555250,40300,10489.4,777100
115910,155328.9,1332350,78650,95551.4,555250,37260,59777.5,777100
106890,144412.7,1332350,72640,92059.5,555250,34250,52353.2,777100
98300,148919.6,1332350,66960,91794.5,555250,31340,57125.1,777100
89810,145910.2,1332350,61260,92482.5,555250,28550,53427.7,777100
81270,140574.7,1332350,55580,92317,555250,25690,48257.7,777100
72770,139232.1,1332350,49920,93701,555250,22850,45531.1,777100
68810,113884.1,1332350,47540,76227.5,555250,21270,37656.6,777100
65030,79719.7,1332350,45210,50744.4,555250,19820,28975.3,777100
61130,78548.8,1332350,42860,52852.6,555250,18270,25696.2,777100
57250,87533.3,1332350,40520,63341.8,555250,16730,24191.5,777100
53740,101673.3,1332350,38420,76835.9,555250,15320,24837.4,777100
50210,109988.5,1332350,36340,88736.4,555250,13870,21252.1,777100
46680,120558.1,1332350,34230,102996.7,555250,12450,17561.4,777100
43190,117957.5,1332350,32140,105311.7,555250,11050,12645.8,777100
39900,90079,1332350,30190,79242.6,555250,9710,10836.4,777100
36570,79143.7,1332350,28260,70760.8,555250,8310,8382.9,777100
33260,80354.8,1332350,26300,73932.4,555250,6960,6422.4,777100
29920,83616.1,1332350,24350,77476.7,555250,5570,6139.4,777100
31960,85682,1332350,25940,79705.4,555250,6020,5976.6,777100
33880,80707.1,1332350,27510,76174.2,555250,6370,4532.9,777100
35920,69271.2,1332350,29100,64155.7,555250,6820,5115.5,777100
37870,72940.2,1332350,30650,66786.3,555250,7220,6153.9,777100
39900,86473.3,1332350,32210,79755.7,555250,7690,6717.6,777100
42000,90553.9,1332350,33790,82781.9,555250,8210,7772,777100
43940,97284,1332350,35350,89282,555250,8590,8002,777100
45980,93914.2,1332350,36890,84504.2,555250,9090,9410,777100
48220,100133.7,1332350,38620,88362.8,555250,9600,11770.9,777100
50440,87172.2,1332350,40310,73461.6,555250,10130,13710.6,777100
52690,87557.3,1332350,42020,69145.7,555250,10670,18411.6,777100
54930,87667.7,1332350,43750,64692.3,555250,11180,22975.4,777100
57600,84749.3,1332350,43770,57416.9,555250,13830,27332.4,777100
60290,71872.5,1332350,43790,46371.2,555250,16500,25501.3,777100
62920,58854.7,1332350,43830,33854.7,555250,19090,25000,777100
65610,49603.1,1332350,43860,27412,555250,21750,22191.1,777100
67930,43356.4,1332350,43580,24594.9,555250,24350,18761.5,777100
70260,40598.9,1332350,43300,23822.3,555250,26960,16776.6,777100
72470,40162.7,1332350,43030,22309.7,555250,29440,17853,777100
74830,37238.6,1332350,42750,16819.3,555250,32080,20419.3,777100
78070,34431.2,1332350,43150,11871.7,555250,34920,22559.5,777100
81440,32671.3,1332350,43550,10711.9,555250,37890,21959.4,777100
84730,42008.8,1332350,43940,14220.1,555250,40790,27788.7,777100
87990,49973.3,1332350,44340,19346.3,555250,43650,30627,777100
90370,59408,1332350,45760,27839,555250,44610,31569,777100
92670,56522.7,1332350,47140,25243.5,555250,45530,31279.2,777100
94970,62986.3,1332350,48540,27253,555250,46430,35733.3,777100
94590,67029.2,1332350,59020,28120.2,555250,35570,38909,777100
104760,75094.9,1332350,66310,26992.9,555250,38450,48102,777100
114960,90819.5,1332350,73620,30872.1,555250,41340,59947.4,777100
125190,102037.1,1332350,80950,32122.7,555250,44240,69914.4,777100
135350,95202.3,1332350,88250,34061,555250,47100,61141.3,777100
142540,97603.2,1332350,92330,43037.9,555250,50210,54565.3,777100
149860,100072.8,1332350,96420,49917.5,555250,53440,50155.3,777100
157050,103320.4,1332350,100470,52103.8,555250,56580,51216.6,777100
164370,102175.8,1332350,104560,47557.6,555250,59810,54618.2,777100
174260,107696.6,1332350,110500,50076.4,555250,63760,57620.2,777100
184170,107689.5,1332350,116430,53500.5,555250,67740,54189,777100
194070,115154.4,1332350,122340,61865.3,555250,71730,53289.1,777100
204100,109251.5,1332350,128290,58302.8,555250,75810,50948.7,777100
212060,113615,1332350,132930,58145.8,555250,79130,55469.2,777100
220100,126221.9,1332350,137550,67255.2,555250,82550,58966.7,777100
228060,134979,1332350,142190,77141.9,555250,85870,57837.1,777100
236000,138191.4,1332350,146800,74144.8,555250,89200,64046.6,777100
243950,149481.5,1332350,151200,79874.6,555250,92750,69606.9,777100
251850,149523,1332350,155560,76786.9,555250,96290,72736.1,777100
259690,145689.9,1332350,159940,72340.7,555250,99750,73349.2,777100
267630,143866.2,1332350,164310,68125,555250,103320,75741.2,777100
273130,142961.2,1332350,166750,64513.9,555250,106380,78447.3,777100
278550,146683.5,1332350,169190,67677.8,555250,109360,79005.7,777100
284060,161409.3,1332350,171610,82595.7,555250,112450,78813.6,777100
289460,170163.3,1332350,174050,92266,555250,115410,77897.3,777100
294510,167044.4,1332350,175510,97667.9,555250,119000,69376.5,777100
299470,152408.5,1332350,176980,87799.7,555250,122490,64608.8,777100
304400,135393.1,1332350,178400,68840.7,555250,126000,66552.4,777100
309430,127778.6,1332350,179880,59157.5,555250,129550,68621.1,777100
314370,126459.4,1332350,180950,51837.3,555250,133420,74622.1,777100
319330,122108.9,1332350,182010,50442.1,555250,137320,71666.8,777100
324330,115179.2,1332350,183060,50258.7,555250,141270,64920.5,777100
329220,117141.9,1332350,184130,50795.6,555250,145090,66346.3,777100
326510,116249.4,1332350,182460,50275.3,555250,144050,65974.1,777100
323760,113232.4,1332350,180740,50868.9,555250,143020,62363.5,777100
321060,111563.6,1332350,179070,54587.2,555250,141990,56976.4,777100
318320,99282.7,1332350,177390,47187.4,555250,140930,52095.3,777100
309690,94409.9,1332350,173150,43756.4,555250,136540,50653.5,777100
300950,102887.4,1332350,168870,53816.6,555250,132080,49070.8,777100
292230,89452,1332350,164610,42009.2,555250,127620,47442.8,777100
283540,89661.5,1332350,160350,43655.7,555250,123190,46005.8,777100
279150,97364.2,1332350,156320,49637.3,555250,122830,47726.9,777100
274740,102907,1332350,152320,51138.6,555250,122420,51768.4,777100
270320,111591.6,1332350,148310,55307.1,555250,122010,56284.5,777100
265890,128276.3,1332350,144300,59954.1,555250,121590,68322.2,777100
273910,140346,1332350,145450,64520,555250,128460,75826,777100
281860,152782.4,1332350,146610,71928.9,555250,135250,80853.5,777100
289930,192983.1,1332350,147760,91031.9,555250,142170,101951.2,777100
297870,217277.5,1332350,148890,100657.4,555250,148980,116620.1,777100
308850,232978,1332350,151460,107447.1,555250,157390,125530.9,777100
319690,270837.9,1332350,153960,118996.6,555250,165730,151841.3,777100
330760,311144,1332350,156510,140208.6,555250,174250,170935.4,777100
341640,305999,1332350,159040,144096.6,555250,182600,161902.4,777100
352050,320054.1,1332350,161940,139158.4,555250,190110,180895.7,777100
362410,340678.8,1332350,164800,148690.5,555250,197610,191988.3,777100
372700,373009.1,1332350,167650,164319.9,555250,205050,208689.2,777100
383100,362385.9,1332350,170540,165914.9,555250,212560,196471,777100
388160,368326,1332350,175090,175086.7,555250,213070,193239.3,777100
393110,368558.5,1332350,179640,173848.2,555250,213470,194710.3,777100
398110,359609.3,1332350,184210,178343.3,555250,213900,181266,777100
403120,337309.6,1332350,188740,177133.7,555250,214380,160175.9,777100
408800,304873.4,1332350,193760,163454.5,555250,215040,141418.9,777100
414420,325901.2,1332350,198780,167737.1,555250,215640,158164.1,777100
420140,314882.3,1332350,203800,153280,555250,216340,161602.3,777100
425740,309050.8,1332350,208820,149401.4,555250,216920,159649.4,777100
431540,293569.4,1332350,214190,149477.3,555250,217350,144092.1,777100
437350,282553.6,1332350,219560,149680.7,555250,217790,132872.9,777100
443160,298019.2,1332350,224960,160361.8,555250,218200,137657.4,777100
448920,316407.5,1332350,230350,166586.4,555250,218570,149821.1,777100
445030,317763.8,1332350,231400,171115.1,555250,213630,146648.7,777100
441240,306349.9,1332350,232470,166507.9,555250,208770,139842,777100
437320,308847.2,1332350,233530,168280.1,555250,203790,140567.1,777100
433440,297186.5,1332350,234600,161269.2,555250,198840,135917.3,777100
426120,291274.4,1332350,233650,157945.5,555250,192470,133328.9,777100
418780,304859.2,1332350,232670,164401.6,555250,186110,140457.6,777100
411440,303522.8,1332350,231680,160566.9,555250,179760,142955.9,777100
404030,288064.6,1332350,230690,148866.2,555250,173340,139198.4,777100
397080,306808.8,1332350,229080,154547.7,555250,168000,152261.1,777100
390180,269682.2,1332350,227460,144036.4,555250,162720,125645.8,777100
383200,256697.4,1332350,225850,141354,555250,157350,115343.4,777100
376290,267905.7,1332350,224260,147576.7,555250,152030,120329,777100
372540,258458,1332350,220660,140333.5,555250,151880,118124.5,777100
368790,231486.7,1332350,217050,134668.1,555250,151740,96818.6,777100
364960,242166.4,1332350,213420,145471.9,555250,151540,96694.5,777100
361230,270767.2,1332350,209850,163724.8,555250,151380,107042.4,777100
357010,278337.1,1332350,206180,170699,555250,150830,107638.1,777100
352740,274268.5,1332350,202550,166394.9,555250,150190,107873.6,777100
348540,250894.4,1332350,198900,155598.5,555250,149640,95295.9,777100
344250,232756.7,1332350,195260,144694.6,555250,148990,88062.1,777100
340800,238312.4,1332350,191830,138292.1,555250,148970,100020.3,777100
337320,247673.3,1332350,188380,140417,555250,148940,107256.3,777100
333790,237933.4,1332350,184940,138775.6,555250,148850,99157.8,777100
330340,241006.6,1332350,181520,141877.5,555250,148820,99129.1,777100
323740,233163.9,1332350,178700,139909.1,555250,145040,93254.8,777100
317180,226796.2,1332350,175910,131036.2,555250,141270,95760,777100
310610,218840.7,1332350,173080,126053.5,555250,137530,92787.2,777100
244790,226190.6,1332350,132410,123050.5,555250,112380,103140.1,777100
238670,217607.4,1332350,128120,114387.2,555250,110550,103220.2,777100
232570,205721.7,1332350,123810,104659.7,555250,108760,101062,777100
226490,199750.6,1332350,119540,102061.8,555250,106950,97688.8,777100
220370,193923.1,1332350,115230,94214.5,555250,105140,99708.6,777100
214690,177336,1332350,111560,85745.3,555250,103130,91590.7,777100
208950,168993.4,1332350,107880,82947.1,555250,101070,86046.3,777100
203230,152453.3,1332350,104180,71450,555250,99050,81003.3,777100
197530,137812.6,1332350,100490,66051.5,555250,97040,71761.1,777100
191320,146632,1332350,97090,81538.6,555250,94230,65093.4,777100
185000,135725.1,1332350,93670,73338.5,555250,91330,62386.6,777100
178790,123449.8,1332350,90310,63387.4,555250,88480,60062.4,777100
172480,111208.3,1332350,86940,56910.8,555250,85540,54297.5,777100
166990,105508.6,1332350,84070,51154.9,555250,82920,54353.7,777100
161390,94570.2,1332350,81230,44951.4,555250,80160,49618.8,777100
155790,84590.4,1332350,78350,39937.9,555250,77440,44652.5,777100
150270,82372.1,1332350,75500,38882.6,555250,74770,43489.5,777100
144350,74692.8,1332350,72680,36169.5,555250,71670,38523.3,777100
138440,68421.4,1332350,69880,31111.9,555250,68560,37309.5,777100
132470,67231.4,1332350,67040,29421.8,555250,65430,37809.6,777100
126610,64198.2,1332350,64220,27327.4,555250,62390,36870.8,777100
122710,63160.2,1332350,61940,24470,555250,60770,38690.2,777100
118780,68318.9,1332350,59690,29090.5,555250,59090,39228.4,777100
114880,71205,1332350,57400,34700,555250,57480,36505,777100
110950,71507.4,1332350,55120,34310.9,555250,55830,37196.5,777100
107360,74591.5,1332350,52730,36327.7,555250,54630,38263.8,777100
103720,75703,1332350,50310,36412.6,555250,53410,39290.4,777100
100080,74188.9,1332350,47910,34664,555250,52170,39524.9,777100
96470,74057.9,1332350,45520,30315.8,555250,50950,43742.1,777100
92730,72994.8,1332350,42970,30629.6,555250,49760,42365.2,777100
88950,68995.1,1332350,40370,30030.4,555250,48580,38964.7,777100
85220,65409.9,1332350,37830,30915.8,555250,47390,34494.1,777100
81530,64077.2,1332350,35280,30207.7,555250,46250,33869.5,777100
77700,64880.4,1332350,33740,31351,555250,43960,33529.4,777100
73960,61289.9,1332350,32250,31591.2,555250,41710,29698.7,777100
70180,49742.8,1332350,30710,25081.5,555250,39470,24661.3,777100
66430,43427.1,1332350,29180,21844.7,555250,37250,21582.4,777100
61910,36938.3,1332350,27800,19405.3,555250,34110,17533,777100
57230,30756.7,1332350,26370,14838,555250,30860,15918.7,777100
52610,28364.6,1332350,24980,12898.6,555250,27630,15466,777100
47950,24538.5,1332350,23580,12240,555250,24370,12298.5,777100
44020,22305.3,1332350,22050,11438.2,555250,21970,10867.1,777100
40090,21515.3,1332350,20500,11233.2,555250,19590,10282.1,777100
36040,21716.2,1332350,18950,11391.5,555250,17090,10324.7,777100
32070,22671.5,1332350,17380,11117,555250,14690,11554.5,777100
34330,22459.4,1332350,17870,11517.4,555250,16460,10942,777100
36590,24216.4,1332350,18350,13123.5,555250,18240,11092.9,777100
38780,30188.5,1332350,18850,14559.8,555250,19930,15628.7,777100
40930,32346.4,1332350,19280,15579.8,555250,21650,16766.6,777100
43920,33169.1,1332350,20220,13708.5,555250,23700,19460.6,777100
46840,35199.4,1332350,21160,14376.5,555250,25680,20822.9,777100
49840,41004.2,1332350,22130,12998.3,555250,27710,28005.9,777100
52820,44431.6,1332350,23080,15399,555250,29740,29032.6,777100
56290,47663.5,1332350,24320,16785.3,555250,31970,30878.2,777100
59780,46599.6,1332350,25610,15301.8,555250,34170,31297.8,777100
63250,47101.9,1332350,26860,17176.1,555250,36390,29925.8,777100
66730,46736.6,1332350,28130,17967.9,555250,38600,28768.7,777100
71580,50953.1,1332350,31730,20146.6,555250,39850,30806.5,777100
76510,47981.9,1332350,35360,22059.1,555250,41150,25922.8,777100
81370,50713.8,1332350,38950,26020.7,555250,42420,24693.1,777100
86240,63593.2,1332350,42560,36069.4,555250,43680,27523.8,777100
91100,75128.5,1332350,46430,41910.6,555250,44670,33217.9,777100
95960,72962.3,1332350,50310,41298.2,555250,45650,31664.1,777100
100780,75034,1332350,54180,41472.6,555250,46600,33561.4,777100
105650,75034,1332350,58110,41472.6,555250,47540,54353.7,777100
110320,75034,1332350,61820,157796.064,555250,48500,49618.8,777100
115060,75034,1332350,65550,157796.064,555250,49510,44652.5,777100
119720,75034,1332350,69250,157796.064,555250,50470,43489.5,777100
124430,75034,1332350,72980,157796.064,555250,51450,38523.3,777100
132400,75034,1332350,78810,157796.064,555250,53590,37309.5,777100
140170,75034,1332350,84590,157796.064,555250,55580,37809.6,777100
148080,75034,1332350,90390,157796.064,555250,57690,36870.8,777100
156050,75034,1332350,96220,157796.064,555250,59830,38690.2,777100
164390,75034,1332350,102360,157796.064,555250,62030,39228.4,777100
172830,75034,1332350,108500,157796.064,555250,64330,36505,777100
181200,75034,1332350,114610,157796.064,555250,66590,37196.5,777100
189660,75034,1332350,120730,157796.064,555250,68930,38263.8,777100
196210,75034,1332350,125440,157796.064,555250,70770,39290.4,777100
202770,75034,1332350,130170,157796.064,555250,72600,39524.9,777100
209310,75034,1332350,134890,157796.064,555250,74420,43742.1,777100
215800,75034,1332350,139600,157796.064,555250,76200,42365.2,777100
217250,75034,1332350,138750,157796.064,555250,78500,38964.7,777100
218720,75034,1332350,137940,157796.064,555250,80780,34494.1,777100
220180,75034,1332350,137120,157796.064,555250,83060,33869.5,777100
221630,75034,1332350,136290,157796.064,555250,85340,33529.4,777100
223150,75034,1332350,135350,157796.064,555250,87800,29698.7,777100
224620,75034,1332350,134400,157796.064,555250,90220,24661.3,777100
226020,75034,1332350,133410,157796.064,555250,92610,21582.4,777100
227500,75034,1332350,132430,157796.064,555250,95070,17533,777100
229340,75034,1332350,132040,157796.064,555250,97300,15918.7,777100
231110,75034,1332350,131590,157796.064,555250,99520,15466,777100
232910,75034,1332350,131200,157796.064,555250,101710,12298.5,777100
234800,75034,1332350,130800,157796.064,555250,104000,10867.1,777100
229430,75034,1332350,127420,157796.064,555250,102010,10282.1,777100
224200,75034,1332350,124060,157796.064,555250,100140,10324.7,777100
218950,75034,1332350,120670,157796.064,555250,98280,11554.5,777100
179690,75034,1332350,93530,157796.064,555250,86160,10942,777100
173190,75034,1332350,89600,157796.064,555250,83590,11092.9,777100
166670,75034,1332350,85650,157796.064,555250,81020,15628.7,777100
160140,75034,1332350,81690,157796.064,555250,78450,16766.6,777100
153610,75034,1332350,77760,157796.064,555250,75850,19460.6,777100
148280,75034,1332350,75000,157796.064,555250,73280,20822.9,777100
142990,75034,1332350,72260,157796.064,555250,70730,28005.9,777100
137650,75034,1332350,69490,157796.064,555250,68160,29032.6,777100
132330,75034,1332350,66750,157796.064,555250,65580,30878.2,777100
132280,75034,1332350,67720,157796.064,555250,64560,31297.8,777100
132250,75034,1332350,68740,157796.064,555250,63510,29925.8,777100
132190,75034,1332350,69700,157796.064,555250,62490,28768.7,777100
132130,75034,1332350,70720,157796.064,555250,61410,30806.5,777100
133050,75034,1332350,72110,157796.064,555250,60940,25922.8,777100
133910,75034,1332350,73520,157796.064,555250,60390,24693.1,777100
134740,75034,1332350,74920,157796.064,555250,59820,27523.8,777100
135640,75034,1332350,76340,157796.064,555250,59300,33217.9,777100
136960,75034,1332350,77920,157796.064,555250,59040,31664.1,777100
138360,75034,1332350,79540,157796.064,555250,58820,33561.4,777100
139700,75034,1332350,81110,157796.064,555250,58590,54353.7,777100
141090,75034,1332350,82680,157796.064,555250,58410,49618.8,777100
140280,75034,1332350,82420,157796.064,555250,57860,44652.5,777100
139340,75034,1332350,82130,157796.064,555250,57210,43489.5,777100
138410,75034,1332350,81830,157796.064,555250,56580,38523.3,777100
137500,75034,1332350,81540,157796.064,555250,55960,37309.5,777100
134380,75034,1332350,79090,157796.064,555250,55290,37809.6,777100
131320,75034,1332350,76670,157796.064,555250,54650,36870.8,777100
128190,75034,1332350,74240,157796.064,555250,53950,38690.2,777100
125040,75034,1332350,71780,157796.064,555250,53260,39228.4,777100
123210,75034,1332350,70750,157796.064,555250,52460,36505,777100
121350,75034,1332350,69740,157796.064,555250,51610,37196.5,777100
119410,75034,1332350,68710,157796.064,555250,50700,38263.8,777100
117500,75034,1332350,67680,157796.064,555250,49820,39290.4,777100
113280,75034,1332350,65700,157796.064,555250,47580,39524.9,777100
109010,75034,1332350,63750,157796.064,555250,45260,43742.1,777100
104710,75034,1332350,61780,157796.064,555250,42930,42365.2,777100
100440,75034,1332350,59790,157796.064,555250,40650,38964.7,777100
95950,75034,1332350,57780,157796.064,555250,38170,34494.1,777100
91340,75034,1332350,55710,157796.064,555250,35630,33869.5,777100
86770,75034,1332350,53670,157796.064,555250,33100,33529.4,777100
82200,75034,1332350,51630,157796.064,555250,30570,29698.7,777100
78040,82952.9,1332350,49560,57902.1,555250,28480,24661.3,777100
73910,74933.9,1332350,47480,48505.2,555250,26430,21582.4,777100
69780,63407.1,1332350,45430,38551.6,555250,24350,17533,777100
65660,72403.8,1332350,43390,42176.4,555250,22270,15918.7,777100
65180,79446.6,1332350,42180,43604.3,555250,23000,15466,777100
64670,86550.4,1332350,40960,48990.5,555250,23710,12298.5,777100
64200,84237.4,1332350,39730,53666.6,555250,24470,10867.1,777100
63590,90484.8,1332350,38490,52053.6,555250,25100,10282.1,777100
62920,97569.4,1332350,37260,50761.6,555250,25660,10324.7,777100
62230,97010.5,1332350,36010,47223.4,555250,26220,11554.5,777100
61510,95664.9,1332350,34790,48315,555250,26720,10942,777100
60900,98626.9,1332350,33540,43371.1,555250,27360,11092.9,777100
59880,93623.5,1332350,32350,42258.7,555250,27530,15628.7,777100
58940,82390.7,1332350,31130,37298.7,555250,27810,16766.6,777100
57900,71416.7,1332350,29910,29791.6,555250,27990,19460.6,777100
56950,74942.6,1332350,28700,28842.2,555250,28250,20822.9,777100
59150,77474,1332350,29790,32987.7,555250,29360,28005.9,777100
61380,69393.2,1332350,30860,29951.1,555250,30520,29032.6,777100
63630,72494.1,1332350,31960,29045,555250,31670,30878.2,777100
65930,67657.5,1332350,33060,28779.9,555250,32870,31297.8,777100
68690,68035.9,1332350,34460,32699.1,555250,34230,29925.8,777100
71400,78054.6,1332350,35830,43430.5,555250,35570,28768.7,777100
74090,77220.9,1332350,37200,38865.4,555250,36890,30806.5,777100
76850,83224.2,1332350,38590,42956.3,555250,38260,25922.8,777100
79260,80428.5,1332350,39420,43317.3,555250,39840,24693.1,777100
81640,79440,1332350,40230,45362.7,555250,41410,27523.8,777100
83990,82007.9,1332350,41060,45790.2,555250,42930,33217.9,777100
86460,83319,1332350,41870,45585.3,555250,44590,31664.1,777100
88560,79474,1332350,42480,39507.2,555250,46080,33561.4,777100
90680,76367.2,1332350,43060,33147.9,555250,47620,43219.3,777100
92750,71375.3,1332350,43660,29846.9,555250,49090,41528.4,777100
94910,73269,1332350,44270,31792.3,555250,50640,41476.7,777100
95900,78568,1332350,43970,33174.6,555250,51930,45393.4,777100
96830,72389.8,1332350,43660,28326.6,555250,53170,44063.2,777100
97780,69759.7,1332350,43360,28086.1,555250,54420,41673.6,777100
98810,71270.4,1332350,43080,33921.2,555250,55730,37349.2,777100
98820,76256.9,1332350,42860,38408.7,555250,55960,37848.2,777100
98920,79746.6,1332350,42640,41734,555250,56280,38012.6,777100
98930,84089,1332350,42430,47339.1,555250,56500,36749.9,777100
98980,84228.7,1332350,42200,47261.4,555250,56780,36967.3,777100
96030,88429.4,1332350,39910,43677.5,555250,56120,44751.9,777100
93140,91164.3,1332350,37550,41580.3,555250,55590,49584,777100
90190,93747.2,1332350,35190,37019.4,555250,55000,56727.8,777100
87210,94329.6,1332350,32860,33421.9,555250,54350,60907.7,777100
84630,88814.7,1332350,30630,28694.1,555250,54000,60120.6,777100
82090,89040.5,1332350,28430,24969.3,555250,53660,64071.2,777100
79410,91864,1332350,26200,22255.4,555250,53210,69608.6,777100
76870,95545.9,1332350,24010,22667.2,555250,52860,72878.7,777100
74170,88712.2,1332350,21830,16508.1,555250,52340,72204.1,777100
71380,83109.3,1332350,19630,13243.1,555250,51750,69866.2,777100
68670,81492.3,1332350,17440,13554,555250,51230,67938.3,777100
65920,78793.6,1332350,15270,14575.9,555250,50650,64217.7,777100
62700,65913.5,1332350,14400,12283.3,555250,48300,53630.2,777100
59510,70515.7,1332350,13570,13935.2,555250,45940,56580.5,777100
56290,79790.4,1332350,12710,16354.7,555250,43580,63435.7,777100
40330,72813.8,1332350,8120,14039.2,555250,32210,58774.6,777100
37430,63639.9,1332350,7500,11069.9,555250,29930,52570,777100
34440,55379.9,1332350,6920,8089.6,555250,27520,47290.3,777100
31430,47667,1332350,6320,6384.3,555250,25110,41282.7,777100
28440,46017,1332350,5750,5729.3,555250,22690,40287.7,777100
25550,41680,1332350,5150,5297.2,555250,20400,36382.8,777100
22710,33577.3,1332350,4540,4722.6,555250,18170,28854.7,777100
19800,24753.5,1332350,3940,3570.9,555250,15860,21182.6,777100
16920,19485.3,1332350,3330,3166.2,555250,13590,16319.1,777100
15720,15729.8,1332350,3130,2593.9,555250,12590,13135.9,777100
14470,10486.1,1332350,2880,1810.9,555250,11590,8675.2,777100
13160,5944.8,1332350,2660,777.5,555250,10500,5167.3,777100
11960,3623.9,1332350,2430,356,555250,9530,3267.9,777100
10710,2972,1332350,2230,339.8,555250,8480,2632.2,777100
9540,2837.7,1332350,1980,347.3,555250,7560,2490.4,777100
8310,2907.9,1332350,1760,312.9,555250,6550,2595,777100
7060,3634.9,1332350,1540,347.3,555250,5520,3287.6,777100
5930,4025.3,1332350,1360,339.8,555250,4570,3685.5,777100
4820,3404.7,1332350,1170,274.1,555250,3650,3130.6,777100
3720,3099.7,1332350,1010,236,555250,2710,2863.7,777100
2620,3387.4,1332350,830,1860,555250,1790,1527.4,777100
3150,7010.6,1332350,1470,5428.3,555250,1680,1582.3,777100
3670,8069.2,1332350,2130,6301.7,555250,1540,1767.5,777100
4180,8230.2,1332350,2770,6721.6,555250,1410,1508.6,777100
4700,5230.6,1332350,3430,4242.7,555250,1270,987.9,777100
5320,1493.5,1332350,4140,761.6,555250,1180,731.9,777100
5950,6121.7,1332350,4880,5472.9,555250,1070,648.8,777100
6550,4226.2,1332350,5590,3648.5,555250,960,577.7,777100
7160,4035.6,1332350,6310,3500.9,555250,850,534.7,777100
7780,2923.7,1332350,7020,2482.3,555250,760,441.4,777100
8360,4226.1,1332350,7700,3847.6,555250,660,378.5,777100
8970,3765.4,1332350,8410,1734.7,555250,560,2030.7,777100
9610,3984.2,1332350,9100,2757.9,555250,510,1226.3,777100
11350,2729.5,1332350,10880,2445.3,555250,470,284.2,777100
13140,4436.4,1332350,12650,4145.5,555250,490,290.9,777100
14910,2964,1332350,14430,2527.5,555250,480,436.5,777100
16690,2702,1332350,16190,2287.9,555250,500,414.1,777100
18470,4119.9,1332350,17990,2858.2,555250,480,1261.7,777100
20180,5863.6,1332350,19740,3029.9,555250,440,2833.7,777100
21950,6026.5,1332350,21520,3430.4,555250,430,2596.1,777100
23700,9227.4,1332350,23280,6767.4,555250,420,2460,777100
25280,13385.3,1332350,24890,11044.3,555250,390,2341,777100
26880,24587.1,1332350,26510,22357.7,555250,370,2229.4,777100
28450,27595.4,1332350,28100,25338.1,555250,350,2257.3,777100
30030,36866.3,1332350,29700,34655,555250,330,2211.3,777100
31470,38356.4,1332350,31090,36063.8,555250,380,2292.6,777100
32930,38972.2,1332350,32490,36574.8,555250,440,2397.4,777100
34340,37753.8,1332350,33880,36487,555250,460,1266.8,777100
35820,41639.3,1332350,35270,40282.5,555250,550,1356.8,777100
37260,48565.3,1332350,36660,46988.5,555250,600,1576.8,777100
38690,50521.1,1332350,38030,48874.5,555250,660,1646.6,777100
40130,50416.6,1332350,39400,48489.2,555250,730,1927.4,777100
41590,47897.6,1332350,40800,45733.2,555250,790,2164.4,777100
42970,47644.9,1332350,42170,45639.4,555250,800,2005.5,777100
44430,47413.5,1332350,43550,45262.1,555250,880,2151.4,777100
45870,50707.8,1332350,44940,48821.8,555250,930,1886,777100
47270,45985.6,1332350,46310,44103,555250,960,1882.6,777100
46960,42287,1332350,45870,40152.8,555250,1090,2134.2,777100
46760,35492.3,1332350,45430,33035.2,555250,1330,2457.1,777100
46570,32949.1,1332350,44980,30475.2,555250,1590,2473.9,777100
46340,32606.7,1332350,44540,30298.8,555250,1800,2307.9,777100
46250,26543.4,1332350,44220,24187.2,555250,2030,2356.2,777100
46120,20872.5,1332350,43900,18684.6,555250,2220,2187.9,777100
46040,16248.1,1332350,43580,13720.8,555250,2460,2527.3,777100
45910,10528.5,1332350,43250,8273.2,555250,2660,2255.3,777100
45940,5975.2,1332350,42990,3524.8,555250,2950,2450.4,777100
45870,6142.6,1332350,42680,3883.8,555250,3190,2258.8,777100
45950,5431.2,1332350,42440,3907.9,555250,3510,1523.3,777100
45900,3837.9,1332350,42150,2317.1,555250,3750,1520.8,777100
50420,3835.8,1332350,46210,2672.5,555250,4210,1163.3,777100
54890,5064.8,1332350,50270,3356.6,555250,4620,1708.2,777100
59270,6275.4,1332350,54300,4760.8,555250,4970,1514.6,777100
63750,9673.6,1332350,58330,8230.4,555250,5420,1443.2,777100
68400,8893.9,1332350,62460,7486.4,555250,5940,1407.5,777100
73080,10695.2,1332350,66600,8918.4,555250,6480,1776.8,777100
77710,10757,1332350,70730,9088.8,555250,6980,1668.2,777100
82360,16031.1,1332350,74830,13792.8,555250,7530,2238.3,777100
87090,22312,1332350,79110,20170.5,555250,7980,2141.5,777100
91800,30062.3,1332350,83400,27474.1,555250,8400,2588.2,777100
96490,37261.7,1332350,87670,33597.3,555250,8820,3664.4,777100
101220,42735.9,1332350,91920,38804.3,555250,9300,3931.6,777100
101920,56292.1,1332350,92440,51379.6,555250,9480,4912.5,777100
102740,71722,1332350,92950,66450.8,555250,9790,5271.2,777100
103500,84876.4,1332350,93430,79352.9,555250,10070,5523.5,777100
104350,91973.4,1332350,93980,86364.8,555250,10370,5608.6,777100
104900,100759.1,1332350,94370,95046.9,555250,10530,5712.2,777100
105530,106500.7,1332350,94820,100752.7,555250,10710,5748,777100
106160,109761.6,1332350,95240,104881.1,555250,10920,4880.5,777100
106820,113936.6,1332350,95670,109824.8,555250,11150,4111.8,777100
108270,115093.5,1332350,96970,111139.4,555250,11300,3954.1,777100
109740,114686.1,1332350,98290,110940.6,555250,11450,3745.5,777100
111220,115342.3,1332350,99580,112135.4,555250,11640,3206.9,777100
112670,114816.7,1332350,100870,112031.2,555250,11800,2785.5,777100
112120,108195.7,1332350,99930,105123.6,555250,12190,3072.1,777100
111630,100865.4,1332350,99000,96475.6,555250,12630,4389.8,777100
111170,105362.9,1332350,98060,100187.1,555250,13110,5175.8,777100
77640,103923.4,1332350,64310,99398.9,555250,13330,4524.5,777100
78630,93158.3,1332350,65160,88100.4,555250,13470,5057.9,777100
79630,93460.1,1332350,66020,88861.2,555250,13610,4598.9,777100
80620,87038,1332350,66880,82434.3,555250,13740,4603.7,777100
81600,82375.6,1332350,67740,76384.1,555250,13860,5991.5,777100
80940,76817.7,1332350,66910,68291.7,555250,14030,8526,777100
80210,71913.2,1332350,66100,63287.6,555250,14110,8625.6,777100
79550,67868.3,1332350,65290,58063.6,555250,14260,9804.7,777100
78870,62832.1,1332350,64480,53073.2,555250,14390,9758.9,777100
78030,58916.3,1332350,63340,49341.2,555250,14690,9575.1,777100
77170,57441.3,1332350,62160,48062.8,555250,15010,9378.5,777100
76280,47915.3,1332350,61030,37944,555250,15250,9971.3,777100
75410,42485.9,1332350,59860,32727.6,555250,15550,9758.3,777100
74870,42172.9,1332350,59040,32322.1,555250,15830,9850.8,777100
74270,41600.7,1332350,58230,32527.2,555250,16040,9073.5,777100
73770,39097.9,1332350,57390,30451.4,555250,16380,8646.5,777100
73230,36942.7,1332350,56570,28941.3,555250,16660,8001.4,777100
73360,35750.3,1332350,56400,28404,555250,16960,7346.3,777100
73510,33671.1,1332350,56220,26104.8,555250,17290,7566.3,777100
73720,31465.9,1332350,56060,24123.8,555250,17660,7342.1,777100
73920,32084.4,1332350,55880,28381,555250,18040,3703.4,777100
74300,39577.6,1332350,55720,31632.2,555250,18580,7945.4,777100
74720,38861.3,1332350,55560,31367.5,555250,19160,7493.8,777100
75150,36177.3,1332350,55380,28087,555250,19770,8090.3,777100
75590,38629.6,1332350,55230,29808.4,555250,20360,8821.2,777100
75750,42385.3,1332350,54810,33450.9,555250,20940,8934.4,777100
75990,39928.6,1332350,54450,30914,555250,21540,9014.6,777100
76230,38368,1332350,54070,29171.3,555250,22160,9196.7,777100
76420,37424.1,1332350,53660,28245.1,555250,22760,9179,777100
75250,34118.7,1332350,51940,25823.8,555250,23310,8294.9,777100
74020,31554.8,1332350,50250,23863.4,555250,23770,7691.4,777100
72870,34114.7,1332350,48520,25988.3,555250,24350,8126.4,777100
71690,34945.3,1332350,46820,26961.2,555250,24870,7984.1,777100
70700,35287.8,1332350,46760,28590.9,555250,23940,6696.9,777100
69640,46759.2,1332350,46680,40434.1,555250,22960,6325.1,777100
68570,51229.2,1332350,46620,45813.5,555250,21950,5415.7,777100
67590,54151.8,1332350,46580,49274.2,555250,21010,4877.6,777100
66280,56962.1,1332350,47520,52527.3,555250,18760,4434.8,777100
64940,49909.5,1332350,48480,45444,555250,16460,4465.5,777100
63520,46824.3,1332350,49400,42637.8,555250,14120,4186.5,777100
62160,47777,1332350,50330,43492.7,555250,11830,4284.3,777100
61970,59652.5,1332350,51120,55350.4,555250,10850,4302.1,777100
61850,63533.9,1332350,51890,59023.9,555250,9960,4510,777100
61640,62420.1,1332350,52650,57306.4,555250,8990,5113.7,777100
61420,54807.5,1332350,53410,48668.3,555250,8010,6139.2,777100
65780,54917.7,1332350,55340,47606.8,555250,10440,7310.9,777100
70050,58413.4,1332350,57230,50576.7,555250,12820,7836.7,777100
74350,52992.3,1332350,59180,43966.4,555250,15170,9025.9,777100
78640,54154.1,1332350,61080,44687.9,555250,17560,9466.2,777100
82950,47659.8,1332350,63010,38230.7,555250,19940,9429.1,777100
87150,51713.6,1332350,64880,40700,555250,22270,11013.6,777100
91440,61688.9,1332350,66800,51054.6,555250,24640,10634.3,777100
95550,69192.1,1332350,68690,58638.8,555250,26860,10553.3,777100
99680,63307.5,1332350,70480,52178.1,555250,29200,11129.4,777100
103870,63553.5,1332350,72330,53245.7,555250,31540,10307.8,777100
108020,63430.3,1332350,74130,52508.7,555250,33890,10921.6,777100
112100,68540.7,1332350,75930,57195.7,555250,36170,11345,777100
116890,74717.3,1332350,78900,63097.2,555250,37990,11620.1,777100
121690,83732.2,1332350,81830,69054,555250,39860,14678.2,777100
126480,94852.4,1332350,84810,79716.8,555250,41670,15135.6,777100
131340,101900.6,1332350,87770,87137.2,555250,43570,14763.4,777100
136590,106372.7,1332350,91300,92109.7,555250,45290,14263,777100
141880,114032.5,1332350,94860,99455,555250,47020,14577.5,777100
147130,140671.9,1332350,98390,125453.8,555250,48740,15218.1,777100
152390,174625.3,1332350,101950,161033.3,555250,50440,13592,777100
159000,204562.9,1332350,106790,189915.7,555250,52210,14647.2,777100
165700,218768.5,1332350,111680,204209.9,555250,54020,14558.6,777100
172320,225770.8,1332350,116560,209641.6,555250,55760,16129.2,777100
178950,235008.1,1332350,121440,220534,555250,57510,14474.1,777100
185470,252052,1332350,127550,238799.7,555250,57920,13252.3,777100
192050,265367.2,1332350,133690,249722.4,555250,58360,15644.8,777100
198620,278872.9,1332350,139880,263737.7,555250,58740,15135.2,777100
205120,298228.7,1332350,146010,281865.6,555250,59110,16363.1,777100
214810,328758.1,1332350,155570,311007.6,555250,59240,17750.5,777100
224490,345438.5,1332350,165150,328407.4,555250,59340,17031.1,777100
234240,350394.1,1332350,174700,331621.9,555250,59540,18772.2,777100
243910,339311.6,1332350,184290,319528.8,555250,59620,19782.8,777100
251970,343515.8,1332350,191920,321528.3,555250,60050,21987.5,777100
260070,353392.1,1332350,199510,331823.3,555250,60560,21568.8,777100
268180,357702.2,1332350,207130,338181.7,555250,61050,19520.5,777100
276340,353313.2,1332350,214780,337154.6,555250,61560,16158.6,777100
277090,354929.5,1332350,214410,339030.8,555250,62680,15898.7,777100
277910,354252.2,1332350,214050,338394,555250,63860,15858.2,777100
278640,348679.1,1332350,213670,330498.4,555250,64970,18180.7,777100
279520,332715.7,1332350,213310,314361.4,555250,66210,18354.3,777100
278400,323355.1,1332350,210940,304212.5,555250,67460,19142.6,777100
277350,319722.7,1332350,208590,302287.8,555250,68760,17434.9,777100
276340,297175.9,1332350,206260,280176,555250,70080,16999.9,777100
275210,294355.8,1332350,203930,276862.1,555250,71280,17493.7,777100
275380,286026.1,1332350,202590,269155.9,555250,72790,16870.2,777100
275480,265433.1,1332350,201280,247442.3,555250,74200,17990.8,777100
275620,261372.2,1332350,199980,242000.1,555250,75640,19372.1,777100
275780,226565.1,1332350,198640,207906.4,555250,77140,18658.7,777100
272310,249987.4,1332350,195480,229800.6,555250,76830,20186.8,777100
268750,263343.7,1332350,192330,242715.8,555250,76420,20627.9,777100
265230,257038.8,1332350,189160,237055.8,555250,76070,19983,777100
267570,243758.8,1332350,185910,223459.5,555250,81660,20299.3,777100
264060,269104.1,1332350,182090,250615.6,555250,81970,18488.5,777100
260540,246461.8,1332350,178260,227664.8,555250,82280,18797,777100
257040,227495.5,1332350,174490,209318.2,555250,82550,18177.3,777100
253520,221450.8,1332350,170650,202120.7,555250,82870,19330.1,777100
249330,207029.7,1332350,166060,186608.4,555250,83270,20421.3,777100
245110,186865.5,1332350,161440,168193.2,555250,83670,18672.3,777100
240980,182976.9,1332350,156830,165192.3,555250,84150,17784.6,777100
236810,170319.5,1332350,152210,155356.9,555250,84600,14962.6,777100
231730,185453,1332350,147810,171005.8,555250,83920,14447.2,777100
226730,191755,1332350,143400,177044.6,555250,83330,14710.4,777100
221600,193991.8,1332350,139000,180526,555250,82600,13465.8,777100
216630,202470.2,1332350,134580,189160.2,555250,82050,13310,777100
210370,234146.2,1332350,128980,221643.9,555250,81390,12502.3,777100
204160,233275.5,1332350,123400,220616.9,555250,80760,12658.6,777100
197960,192112.4,1332350,117790,179235,555250,80170,12877.4,777100
191730,150342.3,1332350,112200,136437.3,555250,79530,13905,777100
190300,133522.8,1332350,111370,119245,555250,78930,14277.8,777100
188740,130098.2,1332350,110500,115554.3,555250,78240,14543.9,777100
187270,146291.2,1332350,109680,131437.8,555250,77590,14853.4,777100
185730,149602.2,1332350,108850,135065.8,555250,76880,14536.4,777100
192840,138738.9,1332350,116340,125335.7,555250,76500,13403.2,777100
199910,136387.8,1332350,123840,122520,555250,76070,13867.8,777100
206900,142911,1332350,131330,128885.6,555250,75570,14025.4,777100
214000,138153.9,1332350,138830,123054.5,555250,75170,15099.4,777100
219210,136340.6,1332350,144810,120897.8,555250,74400,15442.8,777100
224420,138866.1,1332350,150790,123632.6,555250,73630,15233.5,777100
229670,143866.6,1332350,156750,129497.4,555250,72920,14369.2,777100
234870,139741.7,1332350,162720,126481.7,555250,72150,13260,777100
238500,149460.2,1332350,167140,134812.1,555250,71360,14648.1,777100
242020,158843.8,1332350,171510,144141.5,555250,70510,14702.3,777100
245640,181731,1332350,175930,165507.5,555250,69710,16223.5,777100
249140,194131.9,1332350,180330,177238.3,555250,68810,16893.6,777100
248370,224939.2,1332350,180460,207853.1,555250,67910,17086.1,777100
247610,238140.4,1332350,180610,222475,555250,67000,15665.4,777100
246790,252169.8,1332350,180750,237653.4,555250,66040,14516.4,777100
245980,270136.1,1332350,180890,256977.1,555250,65090,13159,777100
244570,284377.9,1332350,179550,270418.4,555250,65020,13959.5,777100
243070,287883.4,1332350,178240,274955.6,555250,64830,12927.8,777100
241590,258603.9,1332350,176900,243869.4,555250,64690,14734.5,777100
240160,254297.8,1332350,175570,238750.4,555250,64590,15547.4,777100
238510,227803.2,1332350,173680,215388.4,555250,64830,12414.8,777100
236840,229623.9,1332350,171780,214446.2,555250,65060,15177.7,777100
235150,217896.2,1332350,169890,199865.7,555250,65260,18030.5,777100
233470,209201.5,1332350,167980,192212.1,555250,65490,16989.4,777100
236320,197639.6,1332350,167980,180243.2,555250,68340,17396.4,777100
239200,181042.9,1332350,167960,164651.6,555250,71240,16391.3,777100
242070,162059.4,1332350,167960,145656.7,555250,74110,16402.7,777100
244990,147690.3,1332350,167970,131444.7,555250,77020,16245.6,777100
248280,145896.3,1332350,168610,128774.9,555250,79670,17121.4,777100
251640,149450.3,1332350,169250,132781.1,555250,82390,16669.2,777100
255070,144888.9,1332350,169960,129281.2,555250,85110,15607.7,777100
258440,139203.9,1332350,170580,122608.7,555250,87860,16595.2,777100
261470,144794.2,1332350,170670,128650.7,555250,90800,16143.5,777100
264500,148190.8,1332350,170770,130880.2,555250,93730,17310.6,777100
267570,141195.8,1332350,170890,124368.8,555250,96680,16827,777100
270560,138815.2,1332350,170970,122846.9,555250,99590,15968.3,777100
273520,171123.9,1332350,169570,153818.2,555250,103950,17305.7,777100
276550,184235.2,1332350,168180,165683,555250,108370,18552.2,777100
279510,165185.2,1332350,166820,146295.2,555250,112690,18890,777100
282480,157043.2,1332350,165380,135900.9,555250,117100,21142.3,777100
286380,157321.2,1332350,165010,132737.7,555250,121370,24583.5,777100
290220,154943.3,1332350,164610,130370.6,555250,125610,24572.7,777100
294140,163233,1332350,164230,136295.5,555250,129910,26937.5,777100
298110,161539.7,1332350,163840,136682.1,555250,134270,24857.6,777100
302360,157642,1332350,163580,130287.7,555250,138780,27354.3,777100
306610,144140.7,1332350,163290,116642.6,555250,143320,27498.1,777100
310840,147414,1332350,163030,119115.2,555250,147810,28298.8,777100
315110,147314.1,1332350,162750,117072.7,555250,152360,30241.4,777100
314650,143572.8,1332350,161400,109371.8,555250,153250,34201,777100
314310,155069.6,1332350,160020,122891.1,555250,154290,32178.5,777100
313890,172965.1,1332350,158650,139232.6,555250,155240,33732.5,777100
313520,187491.1,1332350,157310,149650.8,555250,156210,37840.3,777100
313660,195784.9,1332350,156010,157811.8,555250,157650,37973.1,777100
313750,199928,1332350,154720,157367.5,555250,159030,42560.5,777100
313900,204312.9,1332350,153440,164555.3,555250,160460,39757.6,777100
313980,218869.8,1332350,152150,176268.8,555250,161830,42601,777100
313950,238515.9,1332350,150930,193390.7,555250,163020,45125.2,777100
313900,234442.8,1332350,149700,190140.7,555250,164200,44302.1,777100
313900,217287.1,1332350,148470,176579,555250,165430,40708.1,777100
313900,203458.1,1332350,147280,165327.3,555250,166620,38130.8,777100
304180,177294.9,1332350,140480,138768,555250,163700,38526.9,777100
294390,155149.4,1332350,133690,118009.2,555250,160700,37140.2,777100
284560,155452.2,1332350,126850,119503.7,555250,157710,35948.5,777100
274840,147616.9,1332350,120060,112486.3,555250,154780,35130.6,777100
264990,140060.4,1332350,113560,106156.3,555250,151430,33904.1,777100
255110,132127.6,1332350,107060,95012.2,555250,148050,37115.4,777100
245240,124637.9,1332350,100580,91370.5,555250,144660,33267.4,777100
235480,118347.8,1332350,94090,88504.3,555250,141390,29843.5,777100
224800,111568.7,1332350,87300,81283.3,555250,137500,30285.4,777100
214170,102028.3,1332350,80520,71753.4,555250,133650,30274.9,777100
203580,89836.8,1332350,73750,59394.1,555250,129830,30442.7,777100
192900,76312.1,1332350,66960,45571.7,555250,125940,30740.4,777100
185890,59975.3,1332350,65130,28566.2,555250,120760,31409.1,777100
178730,47708.6,1332350,63290,19543.8,555250,115440,28164.8,777100
171570,36673.9,1332350,61450,10847.7,555250,110120,25826.2,777100
148010,31807.6,1332350,51020,8036.3,555250,96990,23771.3,777100
143140,26877.5,1332350,51030,6735,555250,92110,20142.5,777100
138150,24251.3,1332350,51030,5252.3,555250,87120,18999,777100
133310,25966.9,1332350,51060,5085.9,555250,82250,20881,777100
128400,28762,1332350,51080,8403.9,555250,77320,20358.1,777100
123440,45889.4,1332350,51030,28522,555250,72410,17367.4,777100
118470,47980.3,1332350,51000,32978.7,555250,67470,15001.6,777100
113460,79729.3,1332350,50960,65145,555250,62500,14584.3,777100
108480,81900.7,1332350,50880,68515.6,555250,57600,13385.1,777100
107920,82151.1,1332350,52840,69797.2,555250,55080,12353.9,777100
107400,96637.2,1332350,54800,84944.3,555250,52600,11692.9,777100
106840,94893.4,1332350,56780,85591.1,555250,50060,9302.3,777100
106310,104080.8,1332350,58710,96926.4,555250,47600,7154.4,777100
105020,116251.7,1332350,59950,107784.8,555250,45070,8466.9,777100
103770,114410.1,1332350,61210,104079.6,555250,42560,10330.5,777100
102590,104925.7,1332350,62450,94184.9,555250,40140,10740.8,777100
101310,108782.2,1332350,63700,97399.9,555250,37610,11382.3,777100
100760,99774.2,1332350,65380,89352,555250,35380,10422.2,777100
100320,86802.5,1332350,67060,76025.5,555250,33260,10777,777100
99880,92847.3,1332350,68760,82517,555250,31120,10330.3,777100
99400,95516.4,1332350,70420,85374.2,555250,28980,10142.2,777100
99800,102897.3,1332350,70660,92140.4,555250,29140,10756.9,777100
100240,105580.9,1332350,70930,95059.3,555250,29310,10521.6,777100
100620,101830.3,1332350,71190,91959.3,555250,29430,9871,777100
100920,94410.3,1332350,71420,83897.2,555250,29500,10513.1,777100
102480,75179.7,1332350,72300,63789.9,555250,30180,11389.8,777100
103940,77113.9,1332350,73180,64474.9,555250,30760,12639,777100
105430,72068.2,1332350,74030,57865.1,555250,31400,14203.1,777100
106960,72030.2,1332350,74900,57426.1,555250,32060,14604.1,777100
108100,65893.8,1332350,75750,51248.2,555250,32350,14645.6,777100
109310,62407.2,1332350,76570,46325.9,555250,32740,16081.3,777100
110510,64486.1,1332350,77390,48142,555250,33120,16344.1,777100
111670,58139.5,1332350,78220,42860.6,555250,33450,15278.9,777100
112190,58658.5,1332350,78400,45138.1,555250,33790,13520.4,777100
112800,64797.9,1332350,78560,51901.7,555250,34240,12896.2,777100
113260,70581,1332350,78720,58622.4,555250,34540,11958.6,777100
113800,71977.7,1332350,78860,62057.3,555250,34940,9920.4,777100
114640,66851.6,1332350,79410,58702.3,555250,35230,8149.3,777100
115500,63743.7,1332350,79960,56107.3,555250,35540,7636.4,777100
116430,68654.8,1332350,80520,61962.2,555250,35910,6692.6,777100
117290,72582.6,1332350,81090,66686.8,555250,36200,5895.8,777100
117560,77549.9,1332350,80880,69828.9,555250,36680,7721,777100
117900,87121.1,1332350,80670,75800.4,555250,37230,11320.7,777100
118100,81605.2,1332350,80440,66602.1,555250,37660,15003.1,777100
118450,84275.8,1332350,80260,69324.6,555250,38190,14951.2,777100
119550,94747.6,1332350,79600,75008.3,555250,39950,19739.3,777100
120740,97609.1,1332350,79000,76540.4,555250,41740,21068.7,777100
121950,87600.5,1332350,78390,67824.3,555250,43560,19776.2,777100
123030,82232.6,1332350,77740,62979.8,555250,45290,19252.8,777100
125860,90349.5,1332350,78770,73838,555250,47090,16511.5,777100
128610,92955.6,1332350,79730,76662.4,555250,48880,16293.2,777100
131410,89751,1332350,80740,72333.8,555250,50670,17417.2,777100
134250,101670.1,1332350,81750,84262.2,555250,52500,17407.9,777100
136130,114711.4,1332350,81510,97949.5,555250,54620,16761.9,777100
138130,112287.1,1332350,81350,94847.7,555250,56780,17439.4,777100
140020,115331.4,1332350,81100,96423.9,555250,58920,18907.5,777100
142040,124872.1,1332350,80900,107360.8,555250,61140,17511.3,777100
146840,119960.8,1332350,82850,102797.1,555250,63990,17163.7,777100
151630,124709.9,1332350,84790,107161.6,555250,66840,17548.3,777100
156510,126060.4,1332350,86730,109994.6,555250,69780,16065.8,777100
161310,129538.5,1332350,88670,111387.3,555250,72640,18151.2,777100
166540,137080.9,1332350,91310,117646.5,555250,75230,19434.4,777100
171710,148052.3,1332350,93980,128155.9,555250,77730,19896.4,777100
176860,157167.1,1332350,96640,137354.2,555250,80220,19812.9,777100
182080,164445.1,1332350,99280,142980.5,555250,82800,21464.6,777100
187350,156535,1332350,101580,134745.2,555250,85770,21789.8,777100
192680,152767.1,1332350,103870,131844.1,555250,88810,20923,777100
198040,154662,1332350,106170,130785,555250,91870,23877,777100
203330,167351.2,1332350,108470,145424.6,555250,94860,21926.6,777100
204300,180129.4,1332350,110710,157755.7,555250,93590,22373.7,777100
205250,184671.4,1332350,112990,160607.3,555250,92260,24064.1,777100
206230,185099.5,1332350,115280,162695.1,555250,90950,22404.4,777100
207210,196995,1332350,117520,176264.6,555250,89690,20730.4,777100
206380,206211.9,1332350,117990,185797.4,555250,88390,20414.5,777100
205390,202722.1,1332350,118440,183825.1,555250,86950,18897,777100
204600,213463.4,1332350,118900,194511.1,555250,85700,18952.3,777100
203680,217233.4,1332350,119310,200495.8,555250,84370,16737.6,777100
206340,212066.1,1332350,123540,197043.4,555250,82800,15022.7,777100
208910,215430.6,1332350,127720,202099.8,555250,81190,13330.8,777100
211610,202410.6,1332350,131920,187940.8,555250,79690,14469.8,777100
214160,187988.6,1332350,136110,171471.8,555250,78050,16516.8,777100
211990,169544.4,1332350,134540,152286.2,555250,77450,17258.2,777100
209880,165959.4,1332350,133010,151078.9,555250,76870,14880.5,777100
207660,174854,1332350,131430,162361.9,555250,76230,12492.1,777100
205520,178575.1,1332350,129880,161173.9,555250,75640,17401.2,777100
200100,164924.5,1332350,125170,144421.9,555250,74930,20502.6,777100
194770,182749.7,1332350,120500,157998.5,555250,74270,24751.2,777100
189370,198335.7,1332350,115790,175272.4,555250,73580,23063.3,777100
183990,223600.1,1332350,111100,200910.6,555250,72890,22689.5,777100
182330,256901.6,1332350,109640,232547.4,555250,72690,24354.2,777100
180550,261594.6,1332350,108150,239074.2,555250,72400,22520.4,777100
178830,269998.7,1332350,106680,244901.8,555250,72150,25096.9,777100
177090,270044.7,1332350,105200,244712.4,555250,71890,25332.3,777100
184590,263850.7,1332350,108960,238091.5,555250,75630,25759.2,777100
192090,266682.4,1332350,112780,240811.3,555250,79310,25871.1,777100
199520,283457.8,1332350,116570,256661.2,555250,82950,26796.6,777100
266180,298549.7,1332350,168040,271383.4,555250,98140,27166.3,777100
270870,304884.3,1332350,169400,277495.3,555250,101470,27389,777100
275570,310960.6,1332350,170740,293869.3,555250,104830,17091.3,777100
280250,315867.8,1332350,172070,298803.1,555250,108180,17064.7,777100
284950,322382.1,1332350,173430,305374.8,555250,111520,17007.3,777100
289180,324730.4,1332350,173920,308352.4,555250,115260,16378,777100
293370,299125.9,1332350,174420,281336.5,555250,118950,17789.4,777100
297520,297118,1332350,174900,277398.3,555250,122620,19719.7,777100
301680,219059.4,1332350,175420,199318.6,555250,126260,19740.8,777100
300810,197055.1,1332350,174430,176041.8,555250,126380,21013.3,777100
300010,184046.4,1332350,173490,161743.4,555250,126520,22303,777100
299100,188772.4,1332350,172520,164614.8,555250,126580,24157.6,777100
298260,204578.7,1332350,171570,179196.4,555250,126690,25382.3,777100
297110,250746.9,1332350,170250,223214.3,555250,126860,27532.6,777100
295980,240600.6,1332350,168930,211472.6,555250,127050,29128,777100
294910,224635.2,1332350,167590,194306.3,555250,127320,30328.9,777100
293730,228886,1332350,166270,198351.4,555250,127460,30534.6,777100
294600,209934,1332350,167100,177689.8,555250,127500,32244.2,777100
295430,212479.2,1332350,167930,180325,555250,127500,32154.2,777100
296300,233353.7,1332350,168770,202043.4,555250,127530,31310.3,777100
297190,230421.5,1332350,169610,199034.2,555250,127580,31387.3,777100
294050,228333.1,1332350,168420,199455.2,555250,125630,28877.9,777100
290900,235066.8,1332350,167260,201188,555250,123640,33878.8,777100
287880,226522,1332350,166080,192909.9,555250,121800,33612.1,777100
284790,228360.6,1332350,164930,190745.1,555250,119860,37615.5,777100
280900,242543.9,1332350,162900,207202.2,555250,118000,35341.7,777100
276960,238635.6,1332350,160870,208130.7,555250,116090,30504.9,777100
273130,241001.8,1332350,158840,213946.3,555250,114290,27055.5,777100
269260,238950.2,1332350,156830,212938.2,555250,112430,26012,777100
267610,229989.4,1332350,156910,205737.4,555250,110700,24252,777100
266060,233759.1,1332350,156970,209503.8,555250,109090,24255.3,777100
264500,223673,1332350,157070,201392.6,555250,107430,22280.4,777100
262900,217841,1332350,157160,197890.5,555250,105740,19950.5,777100
262890,212050.9,1332350,156750,194105.2,555250,106140,17945.7,777100
262910,221071,1332350,156390,203817.9,555250,106520,17253.1,777100
262950,202379.9,1332350,156020,186376.9,555250,106930,16003,777100
262920,209973.8,1332350,155640,195532.8,555250,107280,14441,777100
260960,202918.4,1332350,155050,189120.2,555250,105910,13798.2,777100
258920,186835,1332350,154420,174102.2,555250,104500,12732.8,777100
256940,185275.7,1332350,153850,172333.4,555250,103090,12942.3,777100
254970,177163,1332350,153260,164320.2,555250,101710,12842.8,777100
255290,176666.9,1332350,152950,162464.9,555250,102340,14202,777100
255590,172019,1332350,152640,155990.3,555250,102950,16028.7,777100
255950,166997.9,1332350,152360,149921,555250,103590,17076.9,777100
256330,170723,1332350,152050,153917.7,555250,104280,16805.3,777100
255780,183880.9,1332350,150970,165008.6,555250,104810,18872.3,777100
255230,200272.1,1332350,149890,181368.8,555250,105340,18903.3,777100
254680,208342.8,1332350,148780,185648.2,555250,105900,22694.6,777100
254100,202721.8,1332350,147700,176765.8,555250,106400,25956,777100
252910,200597.2,1332350,146400,174806.2,555250,106510,25791,777100
251650,204170.2,1332350,145110,177713.2,555250,106540,26457,777100
250500,196936.3,1332350,143870,167867.1,555250,106630,29069.2,777100
249300,195474.8,1332350,142570,167461,555250,106730,28013.8,777100
247590,207051,1332350,141010,176916.7,555250,106580,30134.3,777100
245840,216968.2,1332350,139420,189380.3,555250,106420,27587.9,777100
244100,334446.6,1332350,137860,227137.8,555250,106240,107308.8,777100
242400,343686.2,1332350,136280,238642.3,555250,106120,105043.9,777100
240160,331308.6,1332350,134270,230422.4,555250,105890,100886.2,777100
237870,318675.5,1332350,132270,223383.3,555250,105600,95292.2,777100
235520,311374.9,1332350,130230,216302.9,555250,105290,95072,777100
233240,296242.7,1332350,128230,208577.8,555250,105010,87664.9,777100
231830,282917.6,1332350,127520,196267.3,555250,104310,86650.3,777100
230410,263801.2,1332350,126800,179066.9,555250,103610,84734.3,777100
228960,246815.1,1332350,126100,169000.9,555250,102860,77814.2,777100
227530,256361.6,1332350,125380,172911.2,555250,102150,83450.4,777100
223970,253358.1,1332350,122510,174764.6,555250,101460,78593.5,777100
220330,240765.6,1332350,119630,164133.9,555250,100700,76631.7,777100
216730,229432.2,1332350,116760,155134.4,555250,99970,74297.8,777100
213170,221687.5,1332350,113920,148260.1,555250,99250,73427.4,777100
207950,215654.1,1332350,111740,142858.3,555250,96210,72795.8,777100
202680,203210.3,1332350,109530,134574.2,555250,93150,68636.1,777100
197400,184489.6,1332350,107340,123155.6,555250,90060,61334,777100
192170,182710.8,1332350,105170,122458.1,555250,87000,60252.7,777100
188140,186224.5,1332350,104180,126901,555250,83960,59323.5,777100
184150,201157,1332350,103210,140305.8,555250,80940,60851.2,777100
180140,201548.8,1332350,102220,152930,555250,77920,48618.8,777100
176180,184295,1332350,101260,141598.8,555250,74920,42696.2,777100
171770,157725.7,1332350,100130,118452.6,555250,71640,39273.1,777100
167290,143211.7,1332350,99020,107624.9,555250,68270,35586.8,777100
162910,143236.7,1332350,97890,105786,555250,65020,37450.7,777100
158510,150498.8,1332350,96770,107845.9,555250,61740,42652.9,777100
155990,155352.1,1332350,94230,111413.3,555250,61760,43938.8,777100
153400,156419.1,1332350,91720,108588.4,555250,61680,47830.7,777100
150920,158962.1,1332350,89200,107549.1,555250,61720,51413,777100
148390,171863.2,1332350,86670,116018.9,555250,61720,55844.3,777100
145740,184495.6,1332350,84110,128622.4,555250,61630,55873.2,777100
143040,178874.8,1332350,81510,121728.5,555250,61530,57146.3,777100
140480,171616.1,1332350,78980,116482.1,555250,61500,55134,777100
137870,180659.4,1332350,76410,123592.6,555250,61460,57066.8,777100
134980,189495.6,1332350,73500,128380.6,555250,61480,61115,777100
132040,201657.3,1332350,70610,133158.9,555250,61430,68498.4,777100
129130,180049.5,1332350,67740,115863.1,555250,61390,64186.4,777100
126260,168353.7,1332350,64850,101878,555250,61410,66475.7,777100
121360,162807.3,1332350,61790,91827,555250,59570,70980.3,777100
116500,151502.9,1332350,58700,83266.6,555250,57800,68236.3,777100
111630,142415.2,1332350,55620,69670.2,555250,56010,72745,777100
100010,131511.4,1487200,53060,60762.1,665950,46950,70749.3,821250
95280,125006.5,1487200,50330,52446.6,665950,44950,72559.9,821250
90440,115651.2,1487200,47540,40789.3,665950,42900,74861.9,821250
85690,105384.8,1487200,44810,30762.4,665950,40880,74622.4,821250
80960,97856.1,1487200,42070,23738.1,665950,38890,74118,821250
75590,95768.5,1487200,38650,23865.1,665950,36940,71903.4,821250
70160,88329.8,1487200,35180,18054.3,665950,34980,70275.5,821250
64700,76564.3,1487200,31730,12765.9,665950,32970,63798.4,821250
59280,66470.9,1487200,28330,11148,665950,30950,55322.9,821250
56730,60173.8,1487200,26640,11368.3,665950,30090,48805.5,821250
54220,54318.7,1487200,24990,11822.3,665950,29230,42496.4,821250
51640,52413.4,1487200,23290,12434.2,665950,28350,39979.2,821250
49190,56746.6,1487200,21650,18087.5,665950,27540,38659.1,821250
46530,54169,1487200,20040,21033.4,665950,26490,33135.6,821250
44140,45692.3,1487200,18460,15839.8,665950,25680,29852.5,821250
41660,38289.8,1487200,16890,12548.6,665950,24770,25741.2,821250
39160,36550.3,1487200,15320,12920.6,665950,23840,23629.7,821250
36820,34100.7,1487200,13730,12072.9,665950,23090,22027.8,821250
34480,33797,1487200,12180,11909,665950,22300,21888,821250
32240,28391.2,1487200,10630,8512.6,665950,21610,19878.6,821250
29940,21457.5,1487200,9050,4229.5,665950,20890,17228,821250
28690,15198.7,1487200,8550,2652.7,665950,20140,12546,821250
27440,16024,1487200,8040,3010.2,665950,19400,13013.8,821250
26260,16483.4,1487200,7540,4219.7,665950,18720,12263.7,821250
25040,14784,1487200,7020,4041.3,665950,18020,10742.7,821250
23960,13031.3,1487200,6670,3325.1,665950,17290,9706.2,821250
22930,10729.3,1487200,6310,1765.3,665950,16620,8964,821250
21870,9358.2,1487200,5990,1381.1,665950,15880,7977.1,821250
20870,9989,1487200,5620,1090.2,665950,15250,8898.8,821250
19820,9213.7,1487200,5270,885.6,665950,14550,8328.1,821250
18770,8986.5,1487200,4910,727.5,665950,13860,8259,821250
17670,8820,1487200,4520,617.7,665950,13150,8202.3,821250
16610,8833,1487200,4150,663.5,665950,12460,8169.5,821250
15270,8069.6,1487200,3830,668.9,665950,11440,7400.7,821250
13970,7216.2,1487200,3530,427.8,665950,10440,6788.4,821250
12690,6137.4,1487200,3230,267.5,665950,9460,5869.9,821250
11340,6019.6,1487200,2910,315.2,665950,8430,5704.4,821250
9940,5281,1487200,2590,263.2,665950,7350,5017.8,821250
8560,4854.4,1487200,2270,165,665950,6290,4689.4,821250
7130,4048.3,1487200,1950,136,665950,5180,3912.3,821250
5810,4098.6,1487200,1620,149.1,665950,4190,3949.5,821250
4570,3909,1487200,1360,151,665950,3210,3758,821250
3340,3460.8,1487200,1080,151,665950,2260,3309.8,821250
2170,3095.5,1487200,860,136,665950,1310,2959.5,821250
970,2835.5,1487200,590,136,665950,380,2699.5,821250
870,2545.1,1487200,510,136,665950,360,2409.1,821250
810,2240.8,1487200,410,136,665950,400,2104.8,821250
730,2309.9,1487200,340,147.2,665950,390,2162.7,821250
630,2321.4,1487200,240,145.4,665950,390,2176,821250
700,2263.5,1487200,280,156,665950,420,2107.5,821250
750,2277.7,1487200,310,149.1,665950,440,2128.6,821250
790,2210.8,1487200,330,136,665950,460,2074.8,821250
840,2275.3,1487200,370,139.8,665950,470,2135.5,821250
900,2434,1487200,360,141.6,665950,540,2292.4,821250
970,2594.1,1487200,370,139.6,665950,600,2454.5,821250
1020,2506.3,1487200,380,140.1,665950,640,2366.2,821250
1060,2071.6,1487200,380,149.1,665950,680,1922.5,821250
1250,1929.8,1487200,430,171.2,665950,820,1758.6,821250
1440,1972.5,1487200,480,154.1,665950,960,1818.4,821250
1620,2110.2,1487200,530,151,665950,1090,1959.2,821250
1800,2208.8,1487200,560,151,665950,1240,2057.8,821250
2030,2245.9,1487200,630,151,665950,1400,2094.9,821250
2240,2689.8,1487200,690,226.5,665950,1550,2463.3,821250
2490,3050.4,1487200,740,244.7,665950,1750,2805.7,821250
2720,2958,1487200,800,200.6,665950,1920,2757.4,821250
3090,2882.6,1487200,920,251,665950,2170,2631.6,821250
3460,3058.2,1487200,1020,279.1,665950,2440,2779.1,821250
3950,3832,1487200,1150,418.1,665950,2800,3413.9,821250
4300,4531.4,1487200,1230,487.7,665950,3070,4043.7,821250
5110,5381.6,1487200,1310,522.5,665950,3800,4859.1,821250
6040,5854.8,1487200,1390,674.5,665950,4650,5180.3,821250
6770,6639.3,1487200,1450,873.1,665950,5320,5766.2,821250
7620,7028.4,1487200,1530,782.7,665950,6090,6245.7,821250
8290,6655.2,1487200,1480,716.5,665950,6810,5938.7,821250
8960,7816.7,1487200,1450,673.3,665950,7510,7143.4,821250
9740,7918.5,1487200,1430,581.5,665950,8310,7337,821250
10370,6757.7,1487200,1370,736.1,665950,9000,6021.6,821250
11200,8295.1,1487200,1500,936.3,665950,9700,7358.8,821250
12050,10740.9,1487200,1600,985.4,665950,10450,9755.5,821250
12930,15398.2,1487200,1740,1606.8,665950,11190,13791.4,821250
13750,21503.4,1487200,1870,2706.5,665950,11880,18796.9,821250
16280,32350.6,1487200,2210,5516.8,665950,14070,26833.8,821250
18980,42681.5,1487200,2600,6141.3,665950,16380,36540.2,821250
21580,56175.9,1487200,2960,7333,665950,18620,48842.9,821250
24170,65198.3,1487200,3300,7920.8,665950,20870,57277.5,821250
26900,71737.4,1487200,3710,9501.5,665950,23190,62235.9,821250
29630,82633.2,1487200,4090,14229.6,665950,25540,68403.6,821250
32430,99681.3,1487200,4500,23727.6,665950,27930,75953.7,821250
35080,110849.5,1487200,4860,28468.3,665950,30220,82381.2,821250
37530,125197.3,1487200,5160,29651.3,665950,32370,95546,821250
39980,124903.9,1487200,5450,28351.3,665950,34530,96552.6,821250
42400,122349.7,1487200,5740,26517.4,665950,36660,95832.3,821250
44790,121628.1,1487200,6030,27084.8,665950,38760,94543.3,821250
44130,118871.6,1487200,5940,29215.4,665950,38190,89656.2,821250
43400,114853.4,1487200,5830,26913.9,665950,37570,87939.5,821250
42680,111658.7,1487200,5750,24992.6,665950,36930,86666.1,821250
65210,124396.7,1487200,12810,26233,665950,52400,98163.7,821250
65390,123045.5,1487200,13000,26560.9,665950,52390,96484.6,821250
65610,113279.9,1487200,13190,23164,665950,52420,90115.9,821250
65890,103594.1,1487200,13380,19024.4,665950,52510,84569.7,821250
66090,92275.9,1487200,13570,15300.7,665950,52520,76975.2,821250
66420,90032.6,1487200,13770,17124.7,665950,52650,72907.9,821250
66640,86906.4,1487200,13940,15324.2,665950,52700,71582.2,821250
66960,91729.6,1487200,14130,17909.5,665950,52830,73820.1,821250
67240,95688.3,1487200,14340,19952.4,665950,52900,75735.9,821250
66920,97438.3,1487200,14540,20283.1,665950,52380,77155.2,821250
66670,97742.2,1487200,14750,24865.1,665950,51920,72877.1,821250
66440,88250.6,1487200,14940,21991.7,665950,51500,66258.9,821250
66160,74707.6,1487200,15160,15219,665950,51000,59488.6,821250
65440,70265.4,1487200,14820,12764.9,665950,50620,57500.5,821250
64720,62276.6,1487200,14500,10091.5,665950,50220,52185.1,821250
63940,55460,1487200,14150,8817.5,665950,49790,46642.5,821250
63340,56229.3,1487200,13840,12065.2,665950,49500,44164.1,821250
62590,55774.4,1487200,13500,15152.9,665950,49090,40621.5,821250
61750,57134.4,1487200,13180,15846.7,665950,48570,41287.7,821250
61040,65547.9,1487200,12860,17771.7,665950,48180,47776.2,821250
60330,73790.4,1487200,12500,18590.8,665950,47830,55199.6,821250
60640,70838,1487200,13200,19958.3,665950,47440,50879.7,821250
60970,69940.5,1487200,13890,20167.9,665950,47080,49772.6,821250
61360,71202.5,1487200,14630,20929,665950,46730,50273.5,821250
61710,75408.1,1487200,15280,21795.2,665950,46430,53612.9,821250
61720,71253,1487200,15700,20192.6,665950,46020,51060.4,821250
61800,64061.8,1487200,16130,17567.1,665950,45670,46494.7,821250
61820,57608.6,1487200,16540,15731.2,665950,45280,41877.4,821250
61910,55911.6,1487200,17000,14789,665950,44910,41122.6,821250
61600,48154.5,1487200,17000,12513.8,665950,44600,35640.7,821250
61220,44016.5,1487200,16980,11852.5,665950,44240,32164,821250
60990,43859.9,1487200,16980,10937.8,665950,44010,32922.1,821250
60660,44849.6,1487200,16990,11047.6,665950,43670,33802,821250
58390,42866,1487200,17200,10241.6,665950,41190,32624.4,821250
56160,41921.9,1487200,17420,10223.5,665950,38740,31698.4,821250
53890,35799.6,1487200,17630,8987.4,665950,36260,26812.2,821250
51620,28173.5,1487200,17840,7037.4,665950,33780,21136.1,821250
48440,20675.6,1487200,18010,4210.7,665950,30430,16464.9,821250
45200,16522,1487200,18200,3508,665950,27000,13014,821250
41980,13298.2,1487200,18370,3361.1,665950,23610,9937.1,821250
38730,11744.6,1487200,18530,3219.3,665950,20200,8525.3,821250
35810,10067.6,1487200,18350,2885.1,665950,17460,7182.5,821250
32800,10504.4,1487200,18150,4028.8,665950,14650,6475.6,821250
29790,11913.6,1487200,17940,4506.6,665950,11850,7407,821250
26800,11350.3,1487200,17770,3719.4,665950,9030,7630.9,821250
27400,9667.7,1487200,18170,2876,665950,9230,6791.7,821250
28050,10694.5,1487200,18590,3152.3,665950,9460,7542.2,821250
28650,13264.3,1487200,19020,5137,665950,9630,8127.3,821250
29300,14277.4,1487200,19460,7058.7,665950,9840,7218.7,821250
28960,12669.3,1487200,19050,5815.2,665950,9910,6854.1,821250
28570,11509.6,1487200,18690,5897.6,665950,9880,5612,821250
28230,12725.5,1487200,18300,7606.5,665950,9930,5119,821250
27840,12995.8,1487200,17900,8308,665950,9940,4687.8,821250
27840,14863.1,1487200,17600,9877.4,665950,10240,4985.7,821250
27730,18304.4,1487200,17270,13459,665950,10460,4845.4,821250
27640,22116.7,1487200,16970,17280.4,665950,10670,4836.3,821250
27570,26019.8,1487200,16660,21230.5,665950,10910,4789.3,821250
28120,27213,1487200,17170,22701.4,665950,10950,4511.6,821250
28670,28838.5,1487200,17680,23745,665950,10990,5093.5,821250
29220,32195.4,1487200,18190,27047.5,665950,11030,5147.9,821250
29800,31997.8,1487200,18740,26242.8,665950,11060,5755,821250
30300,33140.5,1487200,19260,27900.7,665950,11040,5239.8,821250
30850,34724,1487200,19810,29363.4,665950,11040,5360.6,821250
31370,38720.1,1487200,20340,33332.1,665950,11030,5388,821250
31890,43829.4,1487200,20870,37592,665950,11020,6237.4,821250
32830,44244.5,1487200,21870,37993.7,665950,10960,6250.8,821250
33760,43462.7,1487200,22880,37439.2,665950,10880,6023.5,821250
34670,44495.5,1487200,23880,38035.1,665950,10790,6460.4,821250
35640,49198.8,1487200,24920,43024.2,665950,10720,6174.6,821250
40890,53816.5,1487200,28770,47806.7,665950,12120,6009.8,821250
46220,59454.9,1487200,32640,53310.8,665950,13580,6144.1,821250
51490,59629.5,1487200,36500,53505.2,665950,14990,6124.3,821250
56830,63921.5,1487200,40390,56242.7,665950,16440,7678.8,821250
61350,69662.2,1487200,43470,61051.4,665950,17880,8610.8,821250
65860,78574.2,1487200,46540,69191.6,665950,19320,9382.6,821250
70400,84334,1487200,49620,72138.2,665950,20780,12195.8,821250
74950,92153,1487200,52720,77563,665950,22230,14590,821250
78610,102660.1,1487200,54890,83494.7,665950,23720,19165.4,821250
82340,105728.6,1487200,57120,83535.5,665950,25220,22193.1,821250
86050,112062,1487200,59320,85646.3,665950,26730,26415.7,821250
89750,122154.9,1487200,61510,92216.1,665950,28240,29938.8,821250
94430,143269.1,1487200,62020,105596.2,665950,32410,37672.9,821250
99050,161653.6,1487200,62520,117684.7,665950,36530,43968.9,821250
103740,172419.8,1487200,63030,126258.4,665950,40710,46161.4,821250
108480,180776.4,1487200,63530,134102.2,665950,44950,46674.2,821250
114310,194627.6,1487200,65180,146009.2,665950,49130,48618.4,821250
120060,210075,1487200,66760,156779.9,665950,53300,53295.1,821250
125890,229945.3,1487200,68360,171803.6,665950,57530,58141.7,821250
131760,251120,1487200,69990,187752.4,665950,61770,63367.6,821250
137860,275808.5,1487200,71740,205266.8,665950,66120,70541.7,821250
143980,289699.3,1487200,73470,215086.8,665950,70510,74612.5,821250
149990,300701.4,1487200,75240,224700.5,665950,74750,76000.9,821250
156150,296257.9,1487200,76990,220555.7,665950,79160,75702.2,821250
158330,303590.6,1487200,76930,225997.5,665950,81400,77593.1,821250
160420,296650.9,1487200,76880,223704.7,665950,83540,72946.2,821250
162650,298263.3,1487200,76850,224056.2,665950,85800,74207.1,821250
194960,293516.4,1487200,104090,211574,665950,90870,81942.4,821250
196170,281632.7,1487200,104770,194215.8,665950,91400,87416.9,821250
197420,278250,1487200,105430,185766.1,665950,91990,92483.9,821250
198660,282652.3,1487200,106110,182413.5,665950,92550,100238.8,821250
199940,279990.1,1487200,106780,170090,665950,93160,109900.1,821250
198770,272306.5,1487200,105210,159130.9,665950,93560,113175.6,821250
197670,273947,1487200,103640,161130.6,665950,94030,112816.4,821250
196580,282860.3,1487200,102060,166167.5,665950,94520,116692.8,821250
195410,301107.3,1487200,100490,172295.5,665950,94920,128811.8,821250
196210,325010.4,1487200,98800,175617,665950,97410,149393.4,821250
196880,330399.5,1487200,97100,176969,665950,99780,153430.5,821250
197620,341796.7,1487200,95370,186067.6,665950,102250,155729.1,821250
198340,349603.8,1487200,93670,188501.2,665950,104670,161102.6,821250
199240,372811.1,1487200,92390,197029.6,665950,106850,175781.5,821250
200230,366356.4,1487200,91080,193306.9,665950,109150,173049.5,821250
201210,353607,1487200,89760,183169.4,665950,111450,170437.6,821250
202160,342813.5,1487200,88480,172390.3,665950,113680,170423.2,821250
203410,326020.7,1487200,87470,157151.4,665950,115940,168869.3,821250
204660,314507.3,1487200,86420,151856.8,665950,118240,162650.5,821250
205820,297627.4,1487200,85370,145202.9,665950,120450,152424.5,821250
207050,277508.2,1487200,84340,136103.4,665950,122710,141404.8,821250
207210,259141.8,1487200,82880,126828.8,665950,124330,132313,821250
207350,248306.8,1487200,81450,117906.6,665950,125900,130400.2,821250
207580,247851.6,1487200,80030,111852.1,665950,127550,135999.5,821250
207630,253232.1,1487200,78570,110343.4,665950,129060,142888.7,821250
207180,253465.2,1487200,76480,105771.1,665950,130700,147694.1,821250
206750,251297.5,1487200,74390,106503.6,665950,132360,144793.9,821250
206190,266703.9,1487200,72310,120843.7,665950,133880,145860.2,821250
205850,286625.9,1487200,70230,136699.4,665950,135620,149926.5,821250
206560,279370.8,1487200,68970,127828,665950,137590,151542.8,821250
207310,262206.8,1487200,67710,117584.5,665950,139600,144622.3,821250
208030,245331.8,1487200,66440,106535.4,665950,141590,138796.4,821250
208760,244277.6,1487200,65180,106808.3,665950,143580,137469.3,821250
197710,226346.1,1487200,61860,99059.1,665950,135850,127287,821250
186670,204404.5,1487200,58520,90569.1,665950,128150,113835.4,821250
175550,176606,1487200,55200,77599.1,665950,120350,99006.9,821250
164520,153086.6,1487200,51840,71479.9,665950,112680,81606.7,821250
150890,131575.3,1487200,48410,70180,665950,102480,61395.3,821250
137450,112812.5,1487200,44990,66781.7,665950,92460,46030.8,821250
123820,86928.1,1487200,41530,53041,665950,82290,33887.1,821250
110270,71602,1487200,38120,43895.7,665950,72150,27706.3,821250
95440,58873.3,1487200,33700,36921.6,665950,61740,21951.7,821250
80710,54509.4,1487200,29290,36801.4,665950,51420,17708,821250
65930,54640.2,1487200,24880,36746,665950,41050,17894.2,821250
51110,51640.8,1487200,20480,32962.2,665950,30630,18678.6,821250
49090,52923.1,1487200,19140,34667.8,665950,29950,18255.3,821250
47160,57464.1,1487200,17820,38824.2,665950,29340,18639.9,821250
45130,57876.2,1487200,16490,39433.3,665950,28640,18442.9,821250
43170,50595.5,1487200,15150,34049.9,665950,28020,16545.6,821250
41010,41485,1487200,13850,26795,665950,27160,14690,821250
39010,32691.7,1487200,12530,17697.9,665950,26480,14993.8,821250
36880,24614.3,1487200,11220,8868.5,665950,25660,15745.8,821250
34860,20158.4,1487200,9930,4054.3,665950,24930,16104.1,821250
32910,22199.8,1487200,8850,1722.3,665950,24060,20477.5,821250
31070,22008.2,1487200,7810,2094.4,665950,23260,19913.8,821250
29250,23999.5,1487200,6750,2335.8,665950,22500,21663.7,821250
27400,27980.2,1487200,5670,2760.9,665950,21730,25219.3,821250
27010,24665.5,1487200,5630,2392.3,665950,21380,22273.2,821250
26650,24684.9,1487200,5570,2370.8,665950,21080,22314.1,821250
26260,25055.3,1487200,5530,2396.2,665950,20730,22659.1,821250
26020,24000,1487200,5510,2610.8,665950,20510,21389.2,821250
25240,24143.8,1487200,5030,1781.1,665950,20210,22362.7,821250
24470,22549.2,1487200,4540,1573.2,665950,19930,20976,821250
23680,25365,1487200,4060,2177.1,665950,19620,23187.9,821250
23080,29285.9,1487200,3590,2373.5,665950,19490,26912.4,821250
22680,29010.6,1487200,3370,2908.3,665950,19310,26102.3,821250
22240,30844.3,1487200,3160,3733.4,665950,19080,27110.9,821250
21660,38177.1,1487200,2910,3800.5,665950,18750,34376.6,821250
21360,42924.6,1487200,2710,7302.1,665950,18650,35622.5,821250
23490,44396.9,1487200,3090,10792.6,665950,20400,33604.3,821250
25640,47736.3,1487200,3480,13028.7,665950,22160,34707.6,821250
27770,60190.7,1487200,3880,23690,665950,23890,36500.7,821250
29940,64833.5,1487200,4290,28294.1,665950,25650,36539.4,821250
32110,72558.6,1487200,4680,32797.5,665950,27430,39761.1,821250
34240,71279.8,1487200,5090,30603.9,665950,29150,40675.9,821250
36400,86524.5,1487200,5480,40878,665950,30920,45646.5,821250
38570,85282.7,1487200,5860,38640.4,665950,32710,46642.3,821250
40740,81901.2,1487200,6250,35729.4,665950,34490,46171.8,821250
42720,80564.3,1487200,6630,28636,665950,36090,51928.3,821250
44960,79679.5,1487200,7010,19901.7,665950,37950,59777.8,821250
47080,89842,1487200,7410,25740.3,665950,39670,64101.7,821250
54790,129649.7,1487200,9320,59174.6,665950,45470,70475.1,821250
62380,151672.2,1487200,11280,71931.8,665950,51100,79740.4,821250
70120,146498.7,1487200,13210,60168.8,665950,56910,86329.9,821250
77770,154469.6,1487200,15120,58149.6,665950,62650,96320,821250
85660,160624.9,1487200,17120,57505.4,665950,68540,103119.5,821250
93560,146015.9,1487200,19100,50194.2,665950,74460,95821.7,821250
101510,135039.8,1487200,21090,36189.3,665950,80420,98850.5,821250
109310,131698.9,1487200,23050,31558.5,665950,86260,100140.4,821250
117420,138411.6,1487200,25040,31207.9,665950,92380,107203.7,821250
125400,140921.8,1487200,27010,28636.6,665950,98390,112285.2,821250
133480,160605.3,1487200,29010,37095.7,665950,104470,123509.6,821250
141480,178513.8,1487200,31000,51015.1,665950,110480,127498.7,821250
144500,182286.6,1487200,31470,66211.1,665950,113030,116075.5,821250
147650,194557.2,1487200,31980,75777.7,665950,115670,118779.5,821250
150780,214158.9,1487200,32490,97178.8,665950,118290,116980.1,821250
171580,231997.9,1487200,71750,105866,665950,99830,126131.9,821250
171790,247627.2,1487200,70940,115200.5,665950,100850,132426.7,821250
172040,252301.4,1487200,70170,112819.9,665950,101870,139481.5,821250
172310,265499.9,1487200,69420,113506.6,665950,102890,151993.3,821250
172550,245177.1,1487200,68630,93468.5,665950,103920,151708.6,821250
172820,236348,1487200,68010,81855.9,665950,104810,154492.1,821250
173120,247904.8,1487200,67400,86496.2,665950,105720,161408.6,821250
173470,249478.6,1487200,66810,83270.9,665950,106660,166207.7,821250
173780,262973.1,1487200,66230,95566.6,665950,107550,167406.5,821250
171220,270590.5,1487200,65410,107572.3,665950,105810,163018.2,821250
168630,275823.5,1487200,64600,118811,665950,104030,157012.5,821250
165950,277234.2,1487200,63800,125731.1,665950,102150,151503.1,821250
163430,279543.7,1487200,63010,130524.3,665950,100420,149019.4,821250
160410,298445.6,1487200,62210,152688.4,665950,98200,145757.2,821250
157350,278871.5,1487200,61390,140714,665950,95960,138157.5,821250
154420,243454.4,1487200,60610,113957.7,665950,93810,129496.7,821250
151440,249593.6,1487200,59790,121931.8,665950,91650,127661.8,821250
148540,245075.4,1487200,58980,118732.1,665950,89560,126343.3,821250
145630,241262.2,1487200,58180,126556.3,665950,87450,114705.9,821250
142870,219800.1,1487200,57380,111459.9,665950,85490,108340.2,821250
139990,189705.4,1487200,56570,89995.4,665950,83420,99710,821250
136350,158723.1,1487200,53660,74157.5,665950,82690,84565.6,821250
132780,168377.3,1487200,50740,80802.4,665950,82040,87574.9,821250
129200,150316,1487200,47840,74011.5,665950,81360,76304.5,821250
125550,132963.9,1487200,44930,65576.4,665950,80620,67387.5,821250
122680,130315.6,1487200,42400,71117.6,665950,80280,59198,821250
119690,153434,1487200,39860,93329,665950,79830,60105,821250
116600,141484.6,1487200,37280,85055.1,665950,79320,56429.5,821250
113680,122709.9,1487200,34760,69920.9,665950,78920,52789,821250
112000,103711.7,1487200,32430,57234.6,665950,79570,46477.1,821250
110250,109663.8,1487200,30140,61279.6,665950,80110,48384.2,821250
108530,126823.6,1487200,27830,74232.9,665950,80700,52590.7,821250
106820,133198.5,1487200,25510,79542.2,665950,81310,53656.3,821250
106470,122696.8,1487200,24920,69388.7,665950,81550,53308.1,821250
106120,120975.8,1487200,24290,74514.9,665950,81830,46460.9,821250
105770,118536.3,1487200,23700,79482.2,665950,82070,39054.1,821250
105370,83328.4,1487200,23090,47666.2,665950,82280,35662.2,821250
100530,57561.8,1487200,22020,27597.4,665950,78510,29964.4,821250
95650,46996,1487200,20950,24116.1,665950,74700,22879.9,821250
90790,45992,1487200,19880,27437.2,665950,70910,18554.8,821250
85840,43869.8,1487200,18840,24896,665950,67000,18973.8,821250
84440,43991.3,1487200,20010,25313.2,665950,64430,18678.1,821250
82930,50671.7,1487200,21190,33623.4,665950,61740,17048.3,821250
81470,53280.8,1487200,22330,34897.8,665950,59140,18383,821250
80020,57405.6,1487200,23520,39322.2,665950,56500,18083.4,821250
86110,62497.2,1487200,26190,46693.5,665950,59920,15803.7,821250
92310,63225.9,1487200,28890,47210.7,665950,63420,16015.2,821250
98470,52115,1487200,31570,31654.9,665950,66900,20460.1,821250
104620,50786.1,1487200,34230,21867.5,665950,70390,28918.6,821250
108930,45571.3,1487200,35450,7880.1,665950,73480,37691.2,821250
113270,61106.6,1487200,36660,4219.1,665950,76610,56887.5,821250
117570,141147.4,1487200,37880,22741.3,665950,79690,118406.1,821250
121850,146925.6,1487200,39090,10376.9,665950,82760,136548.7,821250
133900,151390,1487200,47170,5891.3,665950,86730,145498.7,821250
146010,94045.1,1487200,55260,1763.7,665950,90750,92281.4,821250
158000,48433.1,1487200,63320,408,665950,94680,48025.1,821250
170060,34371.5,1487200,71390,637.7,665950,98670,33733.8,821250
172470,37673.5,1487200,66140,6332.1,665950,106330,31341.4,821250
174870,68713.8,1487200,60880,22272.7,665950,113990,46441.1,821250
177260,161481.2,1487200,55640,96638.2,665950,121620,64843,821250
179640,200408.9,1487200,50370,135007.1,665950,129270,65401.8,821250
187010,150724.3,1487200,49700,90746.8,665950,137310,59977.5,821250
194260,89246.1,1487200,49010,21532.3,665950,145250,67713.8,821250
201590,97656.9,1487200,48350,17860.7,665950,153240,79796.2,821250
208820,112648.8,1487200,47660,19829,665950,161160,92819.8,821250
219710,120906.9,1487200,50550,29513.9,665950,169160,91393,821250
230550,132388.7,1487200,53430,44663.3,665950,177120,87725.4,821250
241410,147850.4,1487200,56310,69259.3,665950,185100,78591.1,821250
252170,161016,1487200,59180,84500.9,665950,192990,76515.1,821250
257600,180934.6,1487200,67660,98562.5,665950,189940,82372.1,821250
262950,142249.8,1487200,76160,74822,665950,186790,67427.8,821250
268270,110814.5,1487200,84620,44508.3,665950,183650,66306.2,821250
273600,104004.4,1487200,93110,46256,665950,180490,57748.4,821250
274020,146796.6,1487200,98110,85336.7,665950,175910,61459.9,821250
274430,173629.8,1487200,103080,104167.7,665950,171350,69462.1,821250
274730,193397.4,1487200,108050,117055.9,665950,166680,76341.5,821250
275090,221183.8,1487200,113030,137635.3,665950,162060,83548.5,821250
280300,232368.6,1487200,123120,165330.1,665950,157180,67038.5,821250
285500,195027.3,1487200,133250,136098.9,665950,152250,58928.4,821250
290760,190273.4,1487200,143400,140471.8,665950,147360,49801.6,821250
295940,186453.6,1487200,153520,146987.3,665950,142420,39466.3,821250
296290,199825.1,1487200,159340,164509.8,665950,136950,35315.3,821250
296740,184406.4,1487200,165190,148345.4,665950,131550,36061,821250
297110,175285.8,1487200,171020,145302.5,665950,126090,29983.3,821250
297410,175048.5,1487200,176830,151270.6,665950,120580,23777.9,821250
295440,172618.8,1487200,180300,147649,665950,115140,24969.8,821250
293420,173032.2,1487200,183760,147162.7,665950,109660,25869.5,821250
291420,198708.9,1487200,187180,173017.7,665950,104240,25691.2,821250
289440,201965.3,1487200,190620,177196.1,665950,98820,24769.2,821250
290980,203579.9,1487200,197650,177965.5,665950,93330,25614.4,821250
292490,195177,1487200,204660,170572,665950,87830,24605,821250
294050,198338.2,1487200,211660,172311.3,665950,82390,26026.9,821250
295630,186420.8,1487200,218690,157424.1,665950,76940,28996.7,821250
288770,149678.3,1487200,214860,124940.6,665950,73910,24737.7,821250
281890,130200.9,1487200,211020,108041.6,665950,70870,22159.3,821250
274960,117483,1487200,207160,96137.5,665950,67800,21345.5,821250
139670,91784.3,1487200,121750,78751.4,665950,17920,13032.9,821250
131310,84038.2,1487200,114630,72352.2,665950,16680,11686,821250
122960,82432.3,1487200,107510,68226.2,665950,15450,14206.1,821250
114630,77480.6,1487200,100410,64786.2,665950,14220,12694.4,821250
106270,87077.2,1487200,93260,78124.1,665950,13010,8953.1,821250
100990,113001.8,1487200,88900,105069.6,665950,12090,7932.2,821250
95680,100300.1,1487200,84540,92973.4,665950,11140,7326.7,821250
90320,85023.2,1487200,80170,80097.7,665950,10150,4925.5,821250
85120,78393.9,1487200,75820,72992.7,665950,9300,5401.2,821250
81440,80414.1,1487200,71900,73986,665950,9540,6428.1,821250
77720,76994.9,1487200,67970,70388.6,665950,9750,6606.3,821250
74050,70260.4,1487200,64050,60236.9,665950,10000,10023.5,821250
70370,67605.9,1487200,60110,56567.4,665950,10260,11038.5,821250
65470,61814.9,1487200,54790,47541.5,665950,10680,14273.4,821250
60470,62416.1,1487200,49480,43015.6,665950,10990,19400.5,821250
55540,62101.8,1487200,44160,40059.6,665950,11380,22042.2,821250
50620,66674.8,1487200,38840,38642,665950,11780,28032.8,821250
47050,66262.8,1487200,34650,36763.7,665950,12400,29499.1,821250
43470,73519.8,1487200,30410,45110.2,665950,13060,28409.6,821250
39760,82134.4,1487200,26190,51592.8,665950,13570,30541.6,821250
36180,83286,1487200,21950,55193.3,665950,14230,28092.7,821250
41650,88713,1487200,26280,59607.9,665950,15370,29105.1,821250
47110,95763.6,1487200,30600,60315.1,665950,16510,35448.5,821250
52560,108822.1,1487200,34920,64868.4,665950,17640,43953.7,821250
57990,122290.6,1487200,39230,70796.1,665950,18760,51494.5,821250
62860,128295.3,1487200,43290,67819.5,665950,19570,60475.8,821250
67720,133308.6,1487200,47330,74474.8,665950,20390,58833.8,821250
72540,173087,1487200,51380,108123.5,665950,21160,64963.5,821250
77400,188748.1,1487200,55430,134520,665950,21970,54228.1,821250
82010,211645.2,1487200,59090,159017.8,665950,22920,52627.4,821250
86630,228049.7,1487200,62780,176642.6,665950,23850,51407.1,821250
91300,204672.1,1487200,66460,151072.1,665950,24840,53600,821250
95920,184355.3,1487200,70130,127854.3,665950,25790,56501,821250
101990,198092.4,1487200,75510,151993.9,665950,26480,46098.5,821250
108000,214647.9,1487200,80890,173725.3,665950,27110,40922.6,821250
114020,199584.9,1487200,86270,160725.2,665950,27750,38859.7,821250
120080,190698.4,1487200,91630,151124,665950,28450,39574.4,821250
125590,194110.4,1487200,96900,163255.4,665950,28690,30855,821250
131090,187323.6,1487200,102180,161221.3,665950,28910,26102.3,821250
136710,178825.9,1487200,107400,150306.8,665950,29310,28519.1,821250
142210,178739.8,1487200,112680,153562.5,665950,29530,25177.3,821250
148170,187736.3,1487200,117720,160567.1,665950,30450,27169.2,821250
154130,200261.5,1487200,122770,175096.6,665950,31360,25164.9,821250
160080,176302.9,1487200,127860,147040.8,665950,32220,29262.1,821250
166040,174157.4,1487200,132900,144673.6,665950,33140,29483.8,821250
166860,226396.8,1487200,131420,197395.3,665950,35440,29001.5,821250
167620,243333.8,1487200,129880,212891.4,665950,37740,30442.4,821250
168400,228705,1487200,128370,196385.4,665950,40030,32319.6,821250
169160,213984,1487200,126860,174172.9,665950,42300,39811.1,821250
172060,233805,1487200,127160,183204.9,665950,44900,50600.1,821250
174890,217549.1,1487200,127430,167918,665950,47460,49631.1,821250
177750,219710.5,1487200,127700,170560.2,665950,50050,49150.3,821250
180650,217569,1487200,127990,171383.3,665950,52660,46185.7,821250
184510,213222.3,1487200,129000,164729.9,665950,55510,48492.4,821250
188370,196977.6,1487200,130060,149542.4,665950,58310,47435.2,821250
192300,171904.7,1487200,131090,126870.6,665950,61210,45034.1,821250
196150,165974.9,1487200,132150,123973.7,665950,64000,42001.2,821250
191020,162594.5,1487200,129440,126235.4,665950,61580,36359.1,821250
185890,114834.5,1487200,126710,85157.1,665950,59180,29677.4,821250
180750,99813,1487200,123990,70489.2,665950,56760,29323.8,821250
175690,95393.7,1487200,121280,65826.2,665950,54410,29567.5,821250
172400,86861.1,1487200,120230,56700.7,665950,52170,30160.4,821250
169180,86531.3,1487200,119200,55622,665950,49980,30909.3,821250
165890,83918.6,1487200,118140,52056.6,665950,47750,31862,821250
162660,82473.9,1487200,117110,52760.3,665950,45550,29713.6,821250
157900,79081.4,1487200,115010,52970.2,665950,42890,26111.2,821250
153000,75056,1487200,112880,49876.3,665950,40120,25179.7,821250
148220,72528.2,1487200,110790,49633.8,665950,37430,22894.4,821250
143350,71799.4,1487200,108680,46901.4,665950,34670,24898,821250
142200,67971.9,1487200,109440,44819.7,665950,32760,23152.2,821250
141060,72307.5,1487200,110170,47338.3,665950,30890,24969.2,821250
139950,77086.1,1487200,110940,55389.4,665950,29010,21696.7,821250
138820,83308.4,1487200,111690,61362.2,665950,27130,21946.2,821250
140940,77745.9,1487200,115450,59136.5,665950,25490,18609.4,821250
143110,79989,1487200,119190,62586.5,665950,23920,17402.5,821250
145200,82269.7,1487200,122950,66033.3,665950,22250,16236.4,821250
147280,83512.6,1487200,126690,67412.1,665950,20590,16100.5,821250
147930,79896.4,1487200,128420,63316.1,665950,19510,16580.3,821250
148530,92314,1487200,130130,77938.6,665950,18400,14375.4,821250
149150,113595.9,1487200,131860,101675.5,665950,17290,11920.4,821250
149780,104273.8,1487200,133600,93472.7,665950,16180,10801.1,821250
142160,84233.4,1487200,126050,73376.2,665950,16110,10857.2,821250
134570,72477.3,1487200,118540,62343.7,665950,16030,10133.6,821250
126950,67731.1,1487200,110980,58935.8,665950,15970,8795.3,821250
119310,55681,1487200,103450,47079.8,665950,15860,8601.2,821250
110520,60083.8,1487200,94840,51676.6,665950,15680,8407.2,821250
101800,60209,1487200,86270,51740.2,665950,15530,8468.8,821250
92930,58301.1,1487200,77620,48756.2,665950,15310,9544.9,821250
84200,54014.6,1487200,69030,43311.3,665950,15170,10703.3,821250
75320,58330.5,1487200,60810,46474.7,665950,14510,11855.8,821250
66440,54323,1487200,52570,42639.1,665950,13870,11683.9,821250
57560,46202.5,1487200,44320,34937.7,665950,13240,11264.8,821250
48720,45703.1,1487200,36090,31726.6,665950,12630,13976.5,821250
45780,46994.8,1487200,33050,34790.2,665950,12730,12204.6,821250
42820,46144.7,1487200,30020,35792,665950,12800,10352.7,821250
39870,39168.5,1487200,26940,29864.4,665950,12930,9304.1,821250
58100,32293.5,1487200,38830,23696.5,665950,19270,8597,821250
56280,26438.6,1487200,35190,18213.2,665950,21090,8225.4,821250
54330,23096.7,1487200,31530,15606.3,665950,22800,7490.4,821250
52430,19014.7,1487200,27910,11787.1,665950,24520,7227.6,821250
50590,17611.9,1487200,24270,9953.8,665950,26320,7658.1,821250
49280,14638.8,1487200,21340,6140,665950,27940,8498.8,821250
47950,12932.5,1487200,18400,2725.2,665950,29550,10207.3,821250
46620,16489.6,1487200,15460,2016.7,665950,31160,14472.9,821250
45300,21183.7,1487200,12510,2116.6,665950,32790,19067.1,821250
45780,21030,1487200,12340,2281.7,665950,33440,18748.3,821250
46200,23292.6,1487200,12170,2525.3,665950,34030,20767.3,821250
46510,29784.8,1487200,12020,2540.1,665950,34490,27244.7,821250
46980,30993.2,1487200,11850,2320.7,665950,35130,28672.5,821250
49280,32035.6,1487200,11990,2558.5,665950,37290,29477.1,821250
51640,34038.5,1487200,12130,2779.9,665950,39510,31258.6,821250
53940,41967.1,1487200,12280,2764.6,665950,41660,39202.5,821250
56330,39222.3,1487200,12430,2751.1,665950,43900,36471.2,821250
56310,46586.5,1487200,11250,3491.7,665950,45060,43094.8,821250
56210,51306,1487200,10050,3420.2,665950,46160,47885.8,821250
56260,56593.9,1487200,8860,3925.7,665950,47400,52668.2,821250
56220,64595.1,1487200,7680,5353.9,665950,48540,59241.2,821250
59270,58370.5,1487200,7890,3713.1,665950,51380,54657.4,821250
62330,56822.7,1487200,8070,3604.7,665950,54260,53218,821250
65380,62409.7,1487200,8270,4723.1,665950,57110,57686.6,821250
68370,69727.8,1487200,8460,5158.7,665950,59910,64569.1,821250
71300,67665.5,1487200,8680,5488.5,665950,62620,62177,821250
74120,62428.3,1487200,8900,4487.8,665950,65220,57940.5,821250
77050,56630.5,1487200,9120,4182.8,665950,67930,52447.7,821250
79940,48069.7,1487200,9330,3590.1,665950,70610,44479.6,821250
82410,40866.5,1487200,9410,2630.2,665950,73000,38236.3,821250
84780,34904.9,1487200,9510,2301.7,665950,75270,32603.2,821250
87150,27619.2,1487200,9590,2412,665950,77560,25207.2,821250
89640,29622.1,1487200,9660,6170.9,665950,79980,23451.2,821250
86060,29663.9,1487200,9810,7039.7,665950,76250,22624.2,821250
82500,26974.5,1487200,9950,8040.7,665950,72550,18933.8,821250
78970,23732.7,1487200,10090,5979.2,665950,68880,17753.5,821250
75340,22114.2,1487200,10230,4517.9,665950,65110,17596.3,821250
72080,30000.4,1487200,10110,12454.5,665950,61970,17545.9,821250
68900,31943.7,1487200,10020,16094.8,665950,58880,15848.9,821250
65670,31223,1487200,9900,15094.5,665950,55770,16128.5,821250
62490,31305.9,1487200,9790,15765,665950,52700,15540.9,821250
59170,31782.9,1487200,9630,16315.6,665950,49540,15467.3,821250
55890,36656.1,1487200,9460,19702.1,665950,46430,16954,821250
52650,33679.7,1487200,9280,17140.7,665950,43370,16539,821250
49400,30178.3,1487200,9100,13052.3,665950,40300,17126,821250
48000,25287,1487200,9960,8871.5,665950,38040,16415.5,821250
46680,21604.1,1487200,10830,8686.3,665950,35850,12917.8,821250
45360,18041.6,1487200,11720,7084.9,665950,33640,10956.7,821250
43920,13256.4,1487200,12580,4416.5,665950,31340,8839.9,821250
42020,8882.6,1487200,12680,1188.6,665950,29340,7694,821250
40070,9557.1,1487200,12780,1967.8,665950,27290,7589.3,821250
38110,21693,1487200,12880,14360.2,665950,25230,7332.8,821250
36130,17756.1,1487200,12970,10782,665950,23160,6974.1,821250
34660,9085,1487200,13310,2758.1,665950,21350,6326.9,821250
33220,8115,1487200,13670,3043.2,665950,19550,5071.8,821250
31760,7777.7,1487200,14010,3663.2,665950,17750,4114.5,821250
30310,9316.7,1487200,14370,5242.8,665950,15940,4073.9,821250
29180,11074.4,1487200,13850,4637.2,665950,15330,6437.2,821250
28080,7325.3,1487200,13370,3345.8,665950,14710,3979.5,821250
27030,7522.8,1487200,12850,1559,665950,14180,5963.8,821250
25890,8724.8,1487200,12360,1602.5,665950,13530,7122.3,821250
25400,12677.1,1487200,12490,4372.8,665950,12910,8304.3,821250
24770,29584.9,1487200,12560,20266.7,665950,12210,9318.2,821250
24270,82928.3,1487200,12690,73259.5,665950,11580,9668.8,821250
23780,77506.6,1487200,12790,67499.3,665950,10990,10007.3,821250
22670,59194.3,1487200,12370,48947.9,665950,10300,10246.4,821250
21600,55204.2,1487200,11940,41667,665950,9660,13537.2,821250
20540,53343.4,1487200,11550,43045.2,665950,8990,10298.2,821250
19560,60976.9,1487200,11140,53889.4,665950,8420,7087.5,821250
20680,83821,1487200,11840,76881.5,665950,8840,6939.5,821250
21770,89495.2,1487200,12510,82777.3,665950,9260,6717.9,821250
22980,93888.2,1487200,13200,83315.7,665950,9780,10572.5,821250
24150,84541.3,1487200,13890,74258.7,665950,10260,10282.6,821250
25750,91082.6,1487200,14930,80223.5,665950,10820,10859.1,821250
27430,110831.5,1487200,15980,99713.3,665950,11450,11118.2,821250
29080,138502.2,1487200,17010,128742.3,665950,12070,9759.9,821250
30700,143926.2,1487200,18030,132063.4,665950,12670,11862.8,821250
32480,128427.4,1487200,19360,109520,665950,13120,18907.4,821250
34400,106195.7,1487200,20700,83286,665950,13700,22909.7,821250
36220,112574.8,1487200,22010,83590.8,665950,14210,28984,821250
38080,129494.5,1487200,23330,97324.3,665950,14750,32170.2,821250
40850,140182.7,1487200,25930,109347.1,665950,14920,30835.6,821250
43570,148245.3,1487200,28540,115395.3,665950,15030,32850,821250
46410,142988.1,1487200,31140,110652.9,665950,15270,32335.2,821250
49150,121300.6,1487200,33730,85840.7,665950,15420,35459.9,821250
52040,103767.2,1487200,36260,69080.8,665950,15780,34686.4,821250
54980,101966.5,1487200,38790,62844.9,665950,16190,39121.6,821250
57940,98869.1,1487200,41330,60007.3,665950,16610,38861.8,821250
60850,91235,1487200,43860,51591.7,665950,16990,39643.3,821250
63580,94229.4,1487200,45950,44078.3,665950,17630,50151.1,821250
66370,87782.7,1487200,48040,39510.2,665950,18330,48272.5,821250
69050,81919,1487200,50110,43468.4,665950,18940,38450.6,821250
71870,98789.4,1487200,52230,57697.4,665950,19640,41092,821250
74380,121012.6,1487200,52890,66877.6,665950,21490,54135,821250
76980,101800.9,1487200,53620,49226.2,665950,23360,52574.7,821250
79520,99460.5,1487200,54300,45833.9,665950,25220,53626.6,821250
186800,105658.6,1487200,157020,45612,665950,29780,60046.6,821250
183730,121415,1487200,152200,39187.1,665950,31530,82227.9,821250
180790,120338.7,1487200,147430,34985.8,665950,33360,85352.9,821250
177760,190388,1487200,142610,114207.9,665950,35150,76180.1,821250
174750,138860.2,1487200,137830,51666.9,665950,36920,87193.3,821250
174860,142661.8,1487200,136420,31345.5,665950,38440,111316.3,821250
174990,176926.2,1487200,134980,68222.9,665950,40010,108703.3,821250
175180,167154.5,1487200,133570,75921.3,665950,41610,91233.2,821250
175320,122863.9,1487200,132140,53265,665950,43180,69598.9,821250
178330,136222,1487200,132220,74390,665950,46110,61832,821250
181260,145459.1,1487200,132310,82317.3,665950,48950,63141.8,821250
184280,129595.9,1487200,132400,69788.5,665950,51880,59807.4,821250
187240,133365.1,1487200,132470,72560.1,665950,54770,60805,821250
190720,151979.6,1487200,132990,91051.8,665950,57730,60927.8,821250
194000,124019.2,1487200,133460,75728.6,665950,60540,48290.6,821250
197400,142848.7,1487200,133960,94818.6,665950,63440,48030.1,821250
200720,162475.7,1487200,134430,108199.9,665950,66290,54275.8,821250
200140,189281.2,1487200,131290,118765.2,665950,68850,70516,821250
199620,202072.1,1487200,128170,131173.6,665950,71450,70898.5,821250
199050,188373.1,1487200,125010,107340,665950,74040,81033.1,821250
198420,171546,1487200,121850,88916.1,665950,76570,82629.9,821250
197000,191413.6,1487200,119010,102527.8,665950,77990,88885.8,821250
195610,211861.1,1487200,116090,110334.2,665950,79520,101526.9,821250
194130,189194.9,1487200,113210,75279,665950,80920,113915.9,821250
192660,189186.5,1487200,110310,63911.5,665950,82350,125275,821250
190300,210203,1487200,107450,80324.1,665950,82850,129878.9,821250
188010,259746.1,1487200,104530,126482.2,665950,83480,133263.9,821250
185670,281034.8,1487200,101660,146565.9,665950,84010,134468.9,821250
183360,293235.7,1487200,98800,149081,665950,84560,144154.7,821250
183990,267566.8,1487200,97790,124072.8,665950,86200,143494,821250
184590,255044.3,1487200,96760,110160.4,665950,87830,144883.9,821250
185100,255028.3,1487200,95730,112531.8,665950,89370,142496.5,821250
185620,253159.8,1487200,94730,103721.4,665950,90890,149438.4,821250
190660,247808.6,1487200,96090,104367.7,665950,94570,143440.9,821250
195660,226106.6,1487200,97480,106776.7,665950,98180,119329.9,821250
200650,207230.1,1487200,98820,107695.5,665950,101830,99534.6,821250
205680,182805.3,1487200,100210,94514.4,665950,105470,88290.9,821250
206800,155399.7,1487200,99520,79490.1,665950,107280,75909.6,821250
207930,141992.7,1487200,98850,82281.7,665950,109080,59711,821250
209120,147820.5,1487200,98180,85999,665950,110940,61821.5,821250
210200,155849.5,1487200,97470,85362.1,665950,112730,70487.4,821250
214330,161405.9,1487200,97940,81445.1,665950,116390,79960.8,821250
218500,170539.5,1487200,98390,80665.9,665950,120110,89873.6,821250
222660,176516,1487200,98850,71875.6,665950,123810,104640.4,821250
226780,183222.5,1487200,99310,71375.6,665950,127470,111846.9,821250
228810,192428.1,1487200,99270,76035.2,665950,129540,116392.9,821250
230800,213311.7,1487200,99230,88584.6,665950,131570,124727.1,821250
232850,230939.7,1487200,99180,96304,665950,133670,134635.7,821250
234950,249487.8,1487200,99170,111798.2,665950,135780,137689.6,821250
237210,261337.3,1487200,99410,122685.7,665950,137800,138651.6,821250
239550,248849.3,1487200,99670,102864.9,665950,139880,145984.4,821250
241790,239088.6,1487200,99900,86577.5,665950,141890,152511.1,821250
244110,241842.9,1487200,100160,92597,665950,143950,149245.9,821250
246220,247493.9,1487200,100000,95397.1,665950,146220,152096.8,821250
248230,256882.8,1487200,99880,89561.1,665950,148350,167321.7,821250
250370,257320.4,1487200,99730,91427.3,665950,150640,165893.1,821250
252420,261467.4,1487200,99590,85248.6,665950,152830,176218.8,821250
250620,254599.7,1487200,99700,77971.5,665950,150920,176628.2,821250
248700,238821.3,1487200,99770,62849.4,665950,148930,175971.9,821250
246930,209444.8,1487200,99860,49621.3,665950,147070,159823.5,821250
245110,203104.3,1487200,99940,42969.9,665950,145170,160134.4,821250
242310,205340.6,1487200,99450,34054.2,665950,142860,171286.4,821250
239430,213598.2,1487200,98930,35762.3,665950,140500,177835.9,821250
236700,216217.9,1487200,98420,32880.9,665950,138280,183337,821250
233900,205183.5,1487200,97910,31179.8,665950,135990,174003.7,821250
230530,183334.6,1487200,97290,34211,665950,133240,149123.6,821250
227060,185840.7,1487200,96670,31914.4,665950,130390,153926.3,821250
223630,178746.8,1487200,96040,22866,665950,127590,155880.8,821250
220160,214046.7,1487200,95420,37246.6,665950,124740,176800.1,821250
211530,191106.3,1487200,93950,33102.9,665950,117580,158003.4,821250
202800,184905.5,1487200,92410,33978.8,665950,110390,150926.7,821250
194150,191071.7,1487200,90960,47040.1,665950,103190,144031.6,821250
185510,193579.2,1487200,89460,54234.4,665950,96050,139344.8,821250
176610,185672.2,1487200,87600,47602.3,665950,89010,138069.9,821250
167850,196556.7,1487200,85740,47013.8,665950,82110,149542.9,821250
158930,226874.2,1487200,83850,59919.5,665950,75080,166954.7,821250
150050,254494.3,1487200,81970,68464.7,665950,68080,186029.6,821250
143680,277206.5,1487200,82040,80664.3,665950,61640,196542.2,821250
137190,286744.3,1487200,82090,77754.9,665950,55100,208989.4,821250
130770,303832.4,1487200,82150,85643.3,665950,48620,218189.1,821250
124360,316791.9,1487200,82240,97362.2,665950,42120,219429.7,821250
123880,284649.3,1487200,81300,91277.6,665950,42580,193371.7,821250
123430,242303.9,1487200,80400,55766.4,665950,43030,186537.5,821250
123010,232973.5,1487200,79480,41995,665950,43530,190978.5,821250
122540,226237.2,1487200,78570,35654.6,665950,43970,190582.6,821250
118160,227377.6,1487200,73660,36764.3,665950,44500,190613.3,821250
113800,198432.5,1487200,68730,35881.1,665950,45070,162551.4,821250
109460,164745.4,1487200,63820,36180.4,665950,45640,128565,821250
105110,177483.7,1487200,58910,50215.9,665950,46200,127267.8,821250
104740,245458.7,1487200,57820,102757.8,665950,46920,142700.9,821250
104470,314868.2,1487200,56740,139227.8,665950,47730,175640.4,821250
104260,340760.6,1487200,55700,137410.4,665950,48560,203350.2,821250
103930,344808.8,1487200,54630,120665.7,665950,49300,224143.1,821250
107430,307286.3,1487200,56930,123496,665950,50500,183790.3,821250
110990,297079.6,1487200,59230,145502.6,665950,51760,151577,821250
114520,255024.2,1487200,61550,128203.6,665950,52970,126820.6,821250
203470,209055.5,1487200,53580,122282.6,665950,149890,86772.9,821250
206100,213568.8,1487200,57730,144984.4,665950,148370,68584.4,821250
208780,158402,1487200,61850,87311.4,665950,146930,71090.6,821250
211470,195239.7,1487200,65970,117057.8,665950,145500,78181.9,821250
214160,251656.6,1487200,70120,142433.7,665950,144040,109222.9,821250
214940,291696.3,1487200,71430,176651.5,665950,143510,115044.8,821250
215700,193812.4,1487200,72790,114066.7,665950,142910,79745.7,821250
216410,308636.7,1487200,74120,234501.6,665950,142290,74135.1,821250
217190,305245.5,1487200,75450,211754.9,665950,141740,93490.6,821250
222800,382135,1487200,81770,284357.7,665950,141030,97777.3,821250
228470,413900.4,1487200,88080,323138.3,665950,140390,90762.1,821250
233980,415347.1,1487200,94350,322897,665950,139630,92450.1,821250
239570,422474.5,1487200,100670,312386.1,665950,138900,110088.4,821250
242890,442913.6,1487200,105330,315459.2,665950,137560,127454.4,821250
246280,402526.5,1487200,110010,267960.6,665950,136270,134565.9,821250
249570,371859.2,1487200,114650,238048.9,665950,134920,133810.3,821250
252940,308455,1487200,119320,177106.1,665950,133620,131348.9,821250
255180,275794.7,1487200,123670,141934.5,665950,131510,133860.2,821250
257510,312917.5,1487200,128040,177329.1,665950,129470,135588.4,821250
259790,363231.1,1487200,132380,223626.3,665950,127410,139604.8,821250
262130,362565.5,1487200,136750,232549.8,665950,125380,130015.7,821250
269860,419323.5,1487200,143930,303345.9,665950,125930,115977.6,821250
277700,487429.7,1487200,151140,372524.9,665950,126560,114904.8,821250
285470,516995,1487200,158330,397376.3,665950,127140,119618.7,821250
293280,499234.7,1487200,165520,387225.1,665950,127760,112009.6,821250
300490,517240.5,1487200,171450,399351.3,665950,129040,117889.2,821250
307740,528346.8,1487200,177410,399854.2,665950,130330,128492.6,821250
314910,557162.7,1487200,183330,419024.1,665950,131580,138138.6,821250
322130,549628.4,1487200,189300,411644.3,665950,132830,137984.1,821250
328300,553342.4,1487200,194480,426943.8,665950,133820,126398.6,821250
334510,544576.4,1487200,199690,406986.8,665950,134820,137589.6,821250
340650,612245.8,1487200,204890,481841.4,665950,135760,130404.4,821250
346730,570455,1487200,210070,455467.8,665950,136660,114987.2,821250
356110,508588.2,1487200,219700,393990.3,665950,136410,114597.9,821250
365430,481600.7,1487200,229310,371535,665950,136120,110065.7,821250
374730,477241,1487200,238940,364962.5,665950,135790,112278.5,821250
384060,479210.2,1487200,248550,357791.9,665950,135510,121418.3,821250
388710,464180,1487200,253620,346963.9,665950,135090,117216.1,821250
393350,433711.5,1487200,258680,320962.4,665950,134670,112749.1,821250
397960,415449.6,1487200,263740,303323.3,665950,134220,112126.3,821250
402660,388719.3,1487200,268780,291835,665950,133880,96884.3,821250
402210,368278.1,1487200,268070,274648.4,665950,134140,93629.7,821250
401830,393235.5,1487200,267350,295121.6,665950,134480,98113.9,821250
401330,506599.9,1487200,266630,400691.6,665950,134700,105908.3,821250
400980,491512.6,1487200,265910,388063.9,665950,135070,103448.7,821250
412750,560681.4,1487200,273420,442268.8,665950,139330,118412.6,821250
424550,550219.4,1487200,280950,417641.6,665950,143600,132577.8,821250
436410,588010.2,1487200,288480,448362.3,665950,147930,139647.9,821250
448150,613315.3,1487200,296010,463253.3,665950,152140,150062,821250
461600,606349.7,1487200,304540,460930.6,665950,157060,145419.1,821250
474890,599918,1487200,313050,443592.1,665950,161840,156325.9,821250
488240,611267.3,1487200,321560,451835.5,665950,166680,159431.8,821250
501760,618061,1487200,330100,456181.3,665950,171660,161879.7,821250
516180,638789.8,1487200,338570,479042.6,665950,177610,159747.2,821250
530680,645136.3,1487200,347030,472184.5,665950,183650,172951.8,821250
545180,621460.5,1487200,355530,441860.8,665950,189650,179599.7,821250
559750,654627.1,1487200,364020,450362.4,665950,195730,204264.7,821250
572840,642190.1,1487200,371290,433579.5,665950,201550,208610.6,821250
585900,670248.6,1487200,378570,455068,665950,207330,215180.6,821250
598950,679000.6,1487200,385840,463058.7,665950,213110,215941.9,821250
612040,672793.1,1487200,393120,462023.7,665950,218920,210769.4,821250
622030,662873.3,1487200,396270,465325.8,665950,225760,197547.5,821250
632060,670182.4,1487200,399430,476209.7,665950,232630,193972.7,821250
642040,707037.7,1487200,402580,493148.9,665950,239460,213888.8,821250
652210,779398.8,1487200,405750,521190.9,665950,246460,258207.9,821250
665110,732811.2,1487200,413850,498888.6,665950,251260,233922.6,821250
678190,746543.1,1487200,421970,499429.6,665950,256220,247113.5,821250
691190,752571.1,1487200,430080,505281.5,665950,261110,247289.6,821250
704160,729399.9,1487200,438190,497861,665950,265970,231538.9,821250
709510,725859.4,1487200,443620,496436.9,665950,265890,229422.5,821250
714860,752841.9,1487200,449050,499645,665950,265810,253196.9,821250
720310,746050.1,1487200,454500,503059.4,665950,265810,242990.7,821250
725620,765602.1,1487200,459940,517530.5,665950,265680,248071.6,821250
730570,788568.5,1487200,466640,526100.5,665950,263930,262468,821250
735470,778030.5,1487200,473350,520225.1,665950,262120,257805.4,821250
740430,805764.5,1487200,480050,526333.1,665950,260380,279431.4,821250
745390,823285.3,1487200,486780,530209.5,665950,258610,293075.8,821250
749060,815337.2,1487200,492220,503988.6,665950,256840,311348.6,821250
752690,836701.4,1487200,497670,507771.8,665950,255020,328929.6,821250
756330,805625.3,1487200,503120,490054.1,665950,253210,315571.2,821250
760010,815758.2,1487200,508580,491035.1,665950,251430,324723.1,821250
769220,829119.8,1487200,511710,499426.3,665950,257510,329693.5,821250
778470,845615.9,1487200,514810,513645.1,665950,263660,331970.8,821250
787630,856475.5,1487200,517940,511193.5,665950,269690,345282,821250
796900,875909.2,1487200,521060,520092.1,665950,275840,355817.1,821250
805670,887466.7,1487200,524090,522417.7,665950,281580,365049,821250
814490,911900.6,1487200,527130,516377.2,665950,287360,395523.4,821250
823260,910165.8,1487200,530160,516690.2,665950,293100,393475.6,821250
832070,906425.1,1487200,533160,514861.8,665950,298910,391563.3,821250
841010,928556.2,1487200,536250,521170.3,665950,304760,407385.9,821250
849990,924389.6,1487200,539340,518700.1,665950,310650,405689.5,821250
858940,944384.3,1487200,542430,527207.7,665950,316510,417176.6,821250
867880,947006.9,1487200,545520,528324.3,665950,322360,418682.6,821250
878210,937676.7,1487200,546920,528677.1,665950,331290,408999.6,821250
888530,944443.3,1487200,548330,531984.5,665950,340200,412458.8,821250
898850,956973.3,1487200,549700,532898.3,665950,349150,424075,821250
1030090,990923.6,1487200,565730,540134.9,665950,464360,450788.7,821250
1034070,988177.4,1487200,565320,540264.8,665950,468750,447912.6,821250
1037940,995692.4,1487200,564900,539321,665950,473040,456371.4,821250
1041940,1007940.1,1487200,564480,543475.1,665950,477460,464465,821250
1045890,998129.3,1487200,564070,542092.9,665950,481820,456036.4,821250
1050570,1009525.5,1487200,564490,534471,665950,486080,475054.5,821250
1055240,1019261.9,1487200,564880,540286.7,665950,490360,478975.2,821250
1059900,1010961,1487200,565310,532366,665950,494590,478595,821250
1064590,1017281.7,1487200,565720,535569.1,665950,498870,481712.6,821250
1049520,1006649.8,1487200,555500,530641.6,665950,494020,476008.2,821250
1034410,1002171.5,1487200,545260,530592.6,665950,489150,471578.9,821250
1019290,1005759.9,1487200,535030,528257.9,665950,484260,477502,821250
1004120,997451.1,1487200,524780,518745.9,665950,479340,478705.2,821250
987980,950748.7,1487200,512520,484176.2,665950,475460,466572.5,821250
971750,933152.8,1487200,500260,476299.1,665950,471490,456853.7,821250
955550,884002.2,1487200,488000,465796.4,665950,467550,418205.8,821250
939270,891019.1,1487200,475700,493786.1,665950,463570,397233,821250
920970,905298.6,1487200,462200,505840.1,665950,458770,399458.5,821250
902700,857470.1,1487200,448650,496506.9,665950,454050,360963.2,821250
884430,821718.8,1487200,435160,488321.7,665950,449270,333397.1,821250
866060,751155.8,1487200,421640,436929,665950,444420,314226.8,821250
832930,704199.6,1487200,404110,428086,665950,428820,276113.6,821250
799650,734039.7,1487200,386550,447487.5,665950,413100,286552.2,821250
766470,750642,1487200,369030,464925.6,665950,397440,285716.4,821250
733230,695693,1487200,351480,428632.5,665950,381750,267060.5,821250
700520,619644.9,1487200,335480,389407.5,665950,365040,230237.4,821250
667750,626942.8,1487200,319450,427219,665950,348300,199723.8,821250
635030,618996.9,1487200,303440,430159.5,665950,331590,188837.4,821250
602270,620351.3,1487200,287410,436269.7,665950,314860,184081.6,821250
572460,618999.8,1487200,274760,430594.3,665950,297700,188405.5,821250
542600,555574.9,1487200,262110,379539.3,665950,280490,176035.6,821250
512660,575165.3,1487200,249460,404072.4,665950,263200,171092.9,821250
482830,598683.8,1487200,236810,437286.5,665950,246020,161397.3,821250
477840,567076.1,1487200,242460,426061.3,665950,235380,141014.8,821250
472830,562453.9,1487200,248110,433775.7,665950,224720,128678.2,821250
467810,567543.9,1487200,253770,441447.2,665950,214040,126096.7,821250
462730,524692.8,1487200,259450,409564.6,665950,203280,115128.2,821250
463300,556209.8,1487200,269560,444634.7,665950,193740,111575.1,821250
463830,561534.8,1487200,279680,450513.4,665950,184150,111021.4,821250
464410,561887,1487200,289820,464534.8,665950,174590,97352.2,821250
464990,553502.1,1487200,299960,461735.8,665950,165030,91766.3,821250
467640,557648.2,1487200,310390,463641.6,665950,157250,94006.6,821250
470280,564923.8,1487200,320850,464767.4,665950,149430,100156.4,821250
472920,589183.9,1487200,331280,466441.7,665950,141640,122742.2,821250
475520,592606.5,1487200,341730,458725.8,665950,133790,133880.7,821250
483890,584375.5,1487200,346900,459190.4,665950,136990,125185.1,821250
492300,599893,1487200,352060,469016.2,665950,140240,130876.8,821250
500640,589336.2,1487200,357210,467044.7,665950,143430,122291.5,821250
509010,599870,1487200,362370,469079.7,665950,146640,130790.3,821250
527110,627010.4,1487200,377380,473902.3,665950,149730,153108.1,821250
545140,625863.4,1487200,392360,470276.9,665950,152780,155586.5,821250
563210,640811.8,1487200,407340,475449.9,665950,155870,165361.9,821250
581270,666821.6,1487200,422320,471577.2,665950,158950,195244.4,821250
590720,678201.6,1487200,428200,472682.9,665950,162520,205518.7,821250
600290,678286.5,1487200,434090,479273.7,665950,166200,199012.8,821250
609690,679146.9,1487200,439980,476386.2,665950,169710,202760.7,821250
619170,701217.2,1487200,445870,483831.9,665950,173300,217385.3,821250
626160,699697.3,1487200,445030,490304.7,665950,181130,209392.6,821250
633070,704204.1,1487200,444220,496071.1,665950,188850,208133,821250
640000,703500.9,1487200,443390,498197.2,665950,196610,205303.7,821250
646910,696293.3,1487200,442570,499291,665950,204340,197002.3,821250
653360,703677,1487200,440060,500750.9,665950,213300,202926.1,821250
659730,736023.8,1487200,437530,499249.4,665950,222200,236774.4,821250
666180,743149.1,1487200,435040,500868.4,665950,231140,242280.7,821250
672550,751937.9,1487200,432530,497916.4,665950,240020,254021.5,821250
673450,772768,1487200,425340,517164.3,665950,248110,255603.7,821250
674350,793057,1487200,418120,532360.2,665950,256230,260696.8,821250
675250,772642.4,1487200,410910,515266,665950,264340,257376.4,821250
676010,787782.7,1487200,403710,526847.7,665950,272300,260935,821250
679090,765853.6,1487200,402240,510347.1,665950,276850,255506.5,821250
682060,748434.2,1487200,400740,513451.9,665950,281320,234982.3,821250
685010,722366,1487200,399250,495561.8,665950,285760,226804.2,821250
688050,720566.9,1487200,397780,495439.7,665950,290270,225127.2,821250
688290,701607.7,1487200,394400,497339.8,665950,293890,204267.9,821250
688470,695344.2,1487200,391000,483801.2,665950,297470,211543,821250
688700,680101.9,1487200,387630,468372.7,665950,301070,211729.2,821250
688990,672697.2,1487200,384270,463284.4,665950,304720,209412.8,821250
690730,642839.1,1487200,383700,443480.5,665950,307030,199358.6,821250
692570,632294.4,1487200,383120,432781.8,665950,309450,199512.6,821250
694330,608880.2,1487200,382510,411042.5,665950,311820,197837.7,821250
696190,613633.7,1487200,381950,412096.5,665950,314240,201537.2,821250
685270,616001.8,1487200,376890,409009.8,665950,308380,206992,821250
674390,566722.4,1487200,371820,369574.8,665950,302570,197147.6,821250
663510,521012.4,1487200,366740,331658.3,665950,296770,189354.1,821250
652630,485278.6,1487200,361680,308731.3,665950,290950,176547.3,821250
638050,460759.1,1487200,354600,289499.7,665950,283450,171259.4,821250
623400,432311.2,1487200,347500,272684,665950,275900,159627.2,821250
608810,408075,1487200,340420,257077.8,665950,268390,150997.2,821250
594250,421270.5,1487200,333320,277938.4,665950,260930,143332.1,821250
578720,387029.7,1487200,324800,258132.9,665950,253920,128896.8,821250
563150,383158.2,1487200,316270,263392.3,665950,246880,119765.9,821250
547610,386117,1487200,307720,265853.3,665950,239890,120263.7,821250
532060,386669,1487200,299210,262623.9,665950,232850,124045.1,821250
519840,381091.1,1487200,293260,255100,665950,226580,125991.1,821250
507420,348707.8,1487200,287270,230479.7,665950,220150,118228.1,821250
495220,330655.5,1487200,281330,221682.7,665950,213890,108972.8,821250
392660,294229.3,1487200,213090,192068.7,665950,179570,102160.6,821250
383670,271432.6,1487200,207490,169245.8,665950,176180,102186.8,821250
374530,252478.3,1487200,201850,155198.3,665950,172680,97280,821250
365540,252198.3,1487200,196240,155050,665950,169300,97148.3,821250
356480,247351.8,1487200,190610,150265.6,665950,165870,97086.2,821250
347770,252157,1487200,185370,154462.2,665950,162400,97694.8,821250
339110,266452.1,1487200,180130,159955.3,665950,158980,106496.8,821250
330360,273614.3,1487200,174880,169221.7,665950,155480,104392.6,821250
321610,286436.4,1487200,169640,182772.8,665950,151970,103663.6,821250
316700,282914.7,1487200,166400,185354,665950,150300,97560.7,821250
311910,275848.2,1487200,163170,181851.5,665950,148740,93996.7,821250
307140,238976.8,1487200,159960,156219.2,665950,147180,82757.6,821250
302310,246693.9,1487200,156690,159217.5,665950,145620,87476.4,821250
298590,256731.3,1487200,154510,161599.8,665950,144080,95131.5,821250
294860,240655.2,1487200,152320,150882.2,665950,142540,89773,821250
291240,240197.4,1487200,150150,155672,665950,141090,84525.4,821250
287440,243570.1,1487200,147940,160773.1,665950,139500,82797,821250
287740,225024.8,1487200,149430,143774.1,665950,138310,81250.7,821250
288010,231987.1,1487200,150950,150347.5,665950,137060,81639.6,821250
288240,255122.9,1487200,152470,167504.3,665950,135770,87618.6,821250
288470,258972.2,1487200,153960,160944.5,665950,134510,98027.7,821250
284040,255113.2,1487200,150650,150642.9,665950,133390,104470.3,821250
279590,249415,1487200,147340,141341.4,665950,132250,108073.6,821250
275070,256216.8,1487200,143990,151237.5,665950,131080,104979.3,821250
270690,256817.4,1487200,140700,162815.5,665950,129990,94001.9,821250
264540,261647.5,1487200,135760,171525.5,665950,128780,90122,821250
258320,275956.5,1487200,130830,186049.5,665950,127490,89907,821250
252060,257180.9,1487200,125870,172010.5,665950,126190,85170.4,821250
245940,261411.5,1487200,120930,181245.8,665950,125010,80165.7,821250
241080,265444.8,1487200,117040,193466.4,665950,124040,71978.4,821250
236300,195971.5,1487200,113160,127951.7,665950,123140,68019.8,821250
231440,188306.8,1487200,109270,123738.1,665950,122170,64568.7,821250
226580,173475.2,1487200,105390,106959.3,665950,121190,66515.9,821250
224130,176889,1487200,103230,111793.8,665950,120900,65095.2,821250
221650,162521.1,1487200,101110,97734.7,665950,120540,64786.4,821250
219250,162623.5,1487200,98990,101325.7,665950,120260,61297.8,821250
216720,155178.1,1487200,96840,98680.6,665950,119880,56497.5,821250
213970,155574.1,1487200,95230,99006.8,665950,118740,56567.3,821250
211160,157023.8,1487200,93600,104189.9,665950,117560,52833.9,821250
208400,163425.9,1487200,92000,110970.6,665950,116400,52455.3,821250
205670,161528.3,1487200,90390,113096.9,665950,115280,48431.4,821250
204130,181191.2,1487200,89310,135155.5,665950,114820,46035.7,821250
202620,190488.2,1487200,88230,145313.4,665950,114390,45174.8,821250
201020,174463.6,1487200,87140,128608.2,665950,113880,45855.4,821250
199580,166888.1,1487200,86070,124432.2,665950,113510,42455.9,821250
197660,147832.7,1487200,84380,104980.4,665950,113280,42852.3,821250
195600,144589.2,1487200,82700,102134,665950,112900,42455.2,821250
193680,134495.7,1487200,81020,96996.9,665950,112660,37498.8,821250
191660,134891,1487200,79350,96089.2,665950,112310,38801.8,821250
189630,145770,1487200,77600,98917.8,665950,112030,46852.2,821250
187480,140498,1487200,75830,95697.4,665950,111650,44800.6,821250
185360,132946.8,1487200,74110,90302,665950,111250,42644.8,821250
183270,136153.7,1487200,72350,93673.8,665950,110920,42479.9,821250
180840,127658.7,1487200,70560,88519.3,665950,110280,39139.4,821250
178450,134106.5,1487200,68760,91683,665950,109690,42423.5,821250
176100,145287.6,1487200,67020,98203.3,665950,109080,47084.3,821250
173670,150103.9,1487200,65210,104697.9,665950,108460,45406,821250
168990,160658.6,1487200,62400,110991,665950,106590,49667.6,821250
164280,152567.9,1487200,59580,104123.8,665950,104700,48444.1,821250
159660,140512,1487200,56760,90856.3,665950,102900,49655.7,821250
154940,134436.8,1487200,53920,81047.8,665950,101020,53389,821250
149330,131690.4,1487200,50160,76842.9,665950,99170,54847.5,821250
143690,135240.4,1487200,46370,74005.7,665950,97320,61234.7,821250
138100,130776.8,1487200,42620,68193.8,665950,95480,62583,821250
132430,122749,1487200,38840,59786.6,665950,93590,62962.4,821250
127380,105625.1,1487200,35680,52419.5,665950,91700,53205.6,821250
122340,97852.7,1487200,32560,46399.8,665950,89780,51452.9,821250
117280,86247.3,1487200,29420,38150.5,665950,87860,48096.8,821250
112320,80626,1487200,26270,34955.9,665950,86050,45670.1,821250
108520,76988.8,1487200,25290,29038.4,665950,83230,47950.4,821250
104740,70391,1487200,24330,24721.9,665950,80410,45669.1,821250
100990,60562.9,1487200,23350,16709.8,665950,77640,43853.1,821250
97240,49528.7,1487200,22370,15967.5,665950,74870,33561.2,821250
92790,49629.6,1487200,21210,19456.6,665950,71580,30173,821250
88340,46859.8,1487200,20040,17496.1,665950,68300,29363.7,821250
83880,44274.6,1487200,18880,14944.3,665950,65000,29330.3,821250
79460,47089.3,1487200,17700,17481.7,665950,61760,29607.6,821250
74680,43230.4,1487200,16180,11274,665950,58500,31956.4,821250
69960,42453.7,1487200,14690,7923.1,665950,55270,34530.6,821250
65170,42510.2,1487200,13170,6498.1,665950,52000,36012.1,821250
60370,38994,1487200,11660,7145,665950,48710,31849,821250
58630,38537.5,1487200,11330,5360.9,665950,47300,33176.6,821250
56870,37066.4,1487200,11010,4616.9,665950,45860,32449.5,821250
55120,39361.3,1487200,10730,4232.4,665950,44390,35128.9,821250
53360,34118,1487200,10390,3112.3,665950,42970,31005.7,821250
51630,29678.5,1487200,10180,2544.6,665950,41450,27133.9,821250
49990,33614.6,1487200,9990,4033.6,665950,40000,29581,821250
48330,37063.7,1487200,9760,6914.7,665950,38570,30149,821250
46690,36629.6,1487200,9580,6607.1,665950,37110,30022.5,821250
45160,29254.7,1487200,9480,4431.5,665950,35680,24823.2,821250
43590,24643.5,1487200,9370,2843,665950,34220,21800.5,821250
42000,24977.3,1487200,9280,5234.9,665950,32720,19742.4,821250
40560,31311.5,1487200,9180,10290.6,665950,31380,21020.9,821250
40480,43098.7,1487200,10180,15141.5,665950,30300,27957.2,821250
40480,49600.4,1487200,11180,16556.4,665950,29300,33044,821250
40490,47393.5,1487200,12190,16741.6,665950,28300,30651.9,821250
36290,57442.8,1487200,14070,22794.4,665950,22220,34648.4,821250
38010,61521,1487200,16140,29659.3,665950,21870,31861.7,821250
39580,64267,1487200,18160,32010.5,665950,21420,32256.5,821250
41260,69556.6,1487200,20210,36096,665950,21050,33460.6,821250
42920,76303.3,1487200,22290,42626.1,665950,20630,33677.2,821250
44650,79584.5,1487200,24590,47159.8,665950,20060,32424.7,821250
46370,83088.7,1487200,26960,49184.7,665950,19410,33904,821250
48060,85304,1487200,29300,48997.2,665950,18760,36306.8,821250
49810,87547,1487200,31630,52452.6,665950,18180,35094.4,821250
54370,85159.9,1487200,34970,49557.6,665950,19400,35602.3,821250
59110,83375.8,1487200,38370,48300.2,665950,20740,35075.6,821250
63740,80576.9,1487200,41730,44363.5,665950,22010,36213.4,821250
68440,81570.4,1487200,45100,48463.2,665950,23340,33107.2,821250
73510,91259.2,1487200,49150,62085.4,665950,24360,29173.8,821250
78590,93376.3,1487200,53220,65367.4,665950,25370,28008.9,821250
83690,96159,1487200,57280,67669.5,665950,26410,28489.5,821250
88690,98695.4,1487200,61330,72702.2,665950,27360,25993.2,821250
93980,109958.6,1487200,65570,85189.8,665950,28410,24768.8,821250
99310,111849.9,1487200,69800,85302.5,665950,29510,26547.4,821250
104640,114213.4,1487200,74040,82854.3,665950,30600,31359.1,821250
110010,109075.3,1487200,78300,76179.5,665950,31710,32895.8,821250
115770,102190.5,1487200,81660,66526.4,665950,34110,35664.1,821250
121520,108177.7,1487200,85020,68728.8,665950,36500,39448.9,821250
127320,125247.5,1487200,88440,84527.2,665950,38880,40720.3,821250
132980,136503.3,1487200,91810,96337,665950,41170,40166.3,821250
139810,139370.6,1487200,96240,97078.7,665950,43570,42291.9,821250
146550,140164.3,1487200,100610,94509.1,665950,45940,45655.2,821250
153260,145177.7,1487200,105030,93944.9,665950,48230,51232.8,821250
160020,160810.9,1487200,109430,101891.4,665950,50590,58919.5,821250
166580,168803.8,1487200,113510,104484.9,665950,53070,64318.9,821250
173140,178679.1,1487200,117600,109909.5,665950,55540,68769.6,821250
179600,188932.7,1487200,121670,116124.6,665950,57930,72808.1,821250
186330,205506.7,1487200,125780,126280.1,665950,60550,79226.6,821250
190970,211487.9,1487200,130200,129813.4,665950,60770,81674.5,821250
195720,204132.2,1487200,134630,125954.7,665950,61090,78177.5,821250
200490,193067,1487200,139050,120250.3,665950,61440,72816.7,821250
205230,190413,1487200,143480,120175,665950,61750,70238,821250
209250,199621.7,1487200,147250,130787.5,665950,62000,68834.2,821250
213290,205117.9,1487200,151010,143338,665950,62280,61779.9,821250
217280,214738.9,1487200,154770,156195.5,665950,62510,58543.4,821250
221330,239045.7,1487200,158500,177750.5,665950,62830,61295.2,821250
222010,253191,1487200,160200,187347.9,665950,61810,65843.1,821250
222690,254123.9,1487200,161890,184676.4,665950,60800,69447.5,821250
223460,270601.3,1487200,163590,199064.5,665950,59870,71536.8,821250
224120,275766.3,1487200,165270,197647.5,665950,58850,78118.8,821250
222160,284661.7,1487200,159120,199823.1,665950,63040,84838.6,821250
220110,303400.5,1487200,152990,213147.7,665950,67120,90252.8,821250
218150,315565.2,1487200,146850,224941.2,665950,71300,90624,821250
216140,307872.8,1487200,140720,221088.8,665950,75420,86784,821250
212530,293475.8,1487200,132770,206674.2,665950,79760,86801.6,821250
208930,297533.8,1487200,124800,194829,665950,84130,102704.8,821250
205350,275865.1,1487200,116860,168142.9,665950,88490,107722.2,821250
201660,278337.4,1487200,108900,166685.5,665950,92760,111651.9,821250
198880,287693.5,1487200,101890,176596.2,665950,96990,111097.3,821250
196170,272420,1487200,94930,180295.4,665950,101240,92124.6,821250
193380,265677.3,1487200,87940,179863.3,665950,105440,85814,821250
190620,261603,1487200,80980,171262.2,665950,109640,90340.8,821250
187670,235041.3,1487200,78940,138567.8,665950,108730,96473.5,821250
184710,205474.5,1487200,76890,111586.2,665950,107820,93888.3,821250
181750,182418.3,1487200,74860,94194.5,665950,106890,88223.8,821250
178710,171387.8,1487200,72820,89133,665950,105890,82254.8,821250
176160,142759.4,1487200,71080,73890.1,665950,105080,68869.3,821250
173480,151169.1,1487200,69310,76588.6,665950,104170,74580.5,821250
170820,136891.3,1487200,67590,67857.9,665950,103230,69033.4,821250
168160,130750.6,1487200,65820,61657.1,665950,102340,69093.5,821250
166050,114359.7,1487200,64760,45497.3,665950,101290,68862.4,821250
163970,102107.9,1487200,63700,32998.4,665950,100270,69109.5,821250
161930,100347.7,1487200,62630,26685.1,665950,99300,73662.6,821250
159760,107262.9,1487200,61540,26839.5,665950,98220,80423.4,821250
155900,115735.8,1487200,59450,29926.3,665950,96450,85809.5,821250
152100,118076.8,1487200,57360,33309.5,665950,94740,84767.3,821250
148280,119814.1,1487200,55310,34886.7,665950,92970,84927.4,821250
144270,117811.3,1487200,53210,32395.5,665950,91060,85415.8,821250
139520,123715.5,1487200,50100,33591.6,665950,89420,90123.9,821250
134630,129415.8,1487200,46980,34252.3,665950,87650,95163.5,821250
129830,143026.6,1487200,43890,38252.8,665950,85940,104773.8,821250
125080,151537.2,1487200,40800,40165.2,665950,84280,111372,821250
121920,160714.5,1487200,39250,41980.4,665950,82670,118734.1,821250
118810,161167.9,1487200,37750,41532.8,665950,81060,119635.1,821250
115800,159826.8,1487200,36220,40468,665950,79580,119358.8,821250
112720,160420.4,1487200,34720,39660.9,665950,78000,120759.5,821250
112260,155588.8,1487200,34640,37913.5,665950,77620,117675.3,821250
111860,159285,1487200,34550,37684.4,665950,77310,121600.6,821250
111360,156002.6,1487200,34440,36527,665950,76920,119475.6,821250
110920,159721.5,1487200,34360,37541.8,665950,76560,122179.7,821250
112130,161931.2,1487200,35770,35517.4,665950,76360,126413.8,821250
113470,169298.2,1487200,37220,38252.6,665950,76250,131045.6,821250
114790,178894.9,1487200,38640,44040.5,665950,76150,134854.4,821250
116030,183819.2,1487200,40050,49610,665950,75980,134209.2,821250
116230,183692.5,1487200,40330,51873.1,665950,75900,131819.4,821250
116400,189830.2,1487200,40590,58747.1,665950,75810,131083.1,821250
116520,216820.1,1487200,40870,86811.7,665950,75650,130008.4,821250
116770,236391.7,1487200,41180,110422.2,665950,75590,125969.5,821250
113370,249482.8,1487200,38160,128188.4,665950,75210,121294.4,821250
110040,287500.6,1487200,35160,167575.4,665950,74880,119925.2,821250
106630,345812.2,1487200,32160,225311.9,665950,74470,120500.3,821250
144390,340460.6,1487200,55440,228231.4,665950,88950,112229.2,821250
153500,386300.7,1487200,62980,278353.7,665950,90520,107947,821250
162420,422079.1,1487200,70480,312285.4,665950,91940,109793.7,821250
171380,371036.4,1487200,77980,265015.9,665950,93400,106020.5,821250
180360,292757.4,1487200,85470,185087.5,665950,94890,107669.9,821250
188190,302913.5,1487200,91650,194953.5,665950,96540,107960,821250
196080,391546,1487200,97860,285454.4,665950,98220,106091.6,821250
203880,482715,1487200,104020,373386.9,665950,99860,109328.1,821250
211700,500141,1487200,110210,382160.6,665950,101490,117980.4,821250
229340,527501.3,1487200,122320,405202.4,665950,107020,122298.9,821250
246980,527844.6,1487200,134420,404807.8,665950,112560,123036.8,821250
264590,534850.9,1487200,146510,412071.1,665950,118080,122779.8,821250
282200,520976,1487200,158610,398413.5,665950,123590,122562.5,821250
299910,530332.1,1487200,171020,399696.9,665950,128890,130635.2,821250
317540,528545.3,1487200,183390,397940.8,665950,134150,130604.5,821250
335250,564943.8,1487200,195780,429360.8,665950,139470,135583,821250
352940,604059.1,1487200,208130,467237,665950,144810,136822.1,821250
369890,631776.7,1487200,219790,484844.2,665950,150100,146932.5,821250
386940,645863.7,1487200,231440,494639.9,665950,155500,151223.8,821250
403850,639732.2,1487200,243060,488191.5,665950,160790,151540.7,821250
420770,636049.8,1487200,254690,488344.3,665950,166080,147705.5,821250
434240,640413.1,1487200,263770,481412.7,665950,170470,159000.4,821250
447690,639192.6,1487200,272820,475656.8,665950,174870,163535.8,821250
461070,663001.4,1487200,281890,485737.5,665950,179180,177263.9,821250
474530,677610.6,1487200,290940,488348.7,665950,183590,189261.9,821250
488690,703718.9,1487200,300450,504908.3,665950,188240,198810.6,821250
502870,714932.7,1487200,309960,504262.9,665950,192910,210669.8,821250
517000,718344.2,1487200,319430,501757.7,665950,197570,216586.5,821250
531140,690331.7,1487200,328950,464691.7,665950,202190,225640,821250
545570,608933.7,1487200,339010,361661.8,665950,206560,247271.9,821250
560030,649466.9,1487200,349030,369078.4,665950,211000,280388.5,821250
574460,653556.9,1487200,359100,354720.6,665950,215360,298836.3,821250
588910,623106.9,1487200,369150,334342.9,665950,219760,288764,821250
597400,637196.9,1487200,369590,325634.2,665950,227810,311562.7,821250
605970,712267.6,1487200,370040,397281.2,665950,235930,314986.4,821250
614440,713994.8,1487200,370490,387229.8,665950,243950,326765,821250
623020,644631.2,1487200,370940,325913.6,665950,252080,318717.6,821250
630710,631896.6,1487200,370110,325315.4,665950,260600,306581.2,821250
638320,728749.4,1487200,369270,408100.8,665950,269050,320648.6,821250
646030,691211.6,1487200,368440,366018.3,665950,277590,325193.3,821250
653780,670041.8,1487200,367620,363397.3,665950,286160,306644.5,821250
661210,787214.7,1487200,367100,490201.4,665950,294110,297013.3,821250
668640,799730.8,1487200,366580,501552.1,665950,302060,298178.7,821250
676030,765486.1,1487200,366030,473827.7,665950,310000,291658.4,821250
683410,760771.3,1487200,365500,458370.4,665950,317910,302400.9,821250
681170,732165,1487200,365430,443670,665950,315740,288495,821250
678840,724333.9,1487200,365310,443948.2,665950,313530,280385.7,821250
676480,665010.3,1487200,365200,383389.6,665950,311280,281620.7,821250
674210,650437.6,1487200,365090,381903.9,665950,309120,268533.7,821250
674800,623308.4,1487200,367550,364490.9,665950,307250,258817.5,821250
675440,610325.6,1487200,370000,370838.8,665950,305440,239486.8,821250
676110,617061.2,1487200,372430,382405.3,665950,303680,234655.9,821250
676620,626062.6,1487200,374860,397650,665950,301760,228412.6,821250
680340,597705.7,1487200,380160,371845.4,665950,300180,225860.3,821250
684010,590256.5,1487200,385400,356771.4,665950,298610,233485.1,821250
687790,572510.3,1487200,390690,350606.9,665950,297100,221903.4,821250
691440,545117.5,1487200,395950,344313.4,665950,295490,200804.1,821250
680860,513467.8,1487200,389460,319930,665950,291400,193537.8,821250
670180,505748.6,1487200,382920,320696.2,665950,287260,185052.4,821250
659590,470383.2,1487200,376440,304761.1,665950,283150,165622.1,821250
648930,477204.3,1487200,369940,304893.1,665950,278990,172311.2,821250
640080,450498.8,1487200,364610,275796.2,665950,275470,174702.6,821250
631270,463366.9,1487200,359320,302745.8,665950,271950,160621.1,821250
622310,446060.5,1487200,353990,304612.6,665950,268320,141447.9,821250
613500,397808.8,1487200,348700,258698.6,665950,264800,139110.2,821250
607800,430909,1487200,346440,300431.6,665950,261360,130477.4,821250
602190,456984.7,1487200,344210,344811.7,665950,257980,112173,821250
596490,455360.6,1487200,341980,343359.8,665950,254510,112000.8,821250
590850,459454.6,1487200,339760,347064.1,665950,251090,112390.5,821250
580570,424909.1,1487200,336890,320002.4,665950,243680,104906.7,821250
570190,406675,1487200,333990,307514.7,665950,236200,99160.3,821250
559880,368339.9,1487200,331080,277537.9,665950,228800,90802,821250
549560,347354.3,1487200,328220,260360.8,665950,221340,86993.5,821250
540710,367737.7,1487200,326720,278513.1,665950,213990,89224.6,821250
531830,386282.5,1487200,325250,306186,665950,206580,80096.5,821250
522970,386215,1487200,323750,314514.6,665950,199220,71700.4,821250
514100,370601.1,1487200,322260,296658.1,665950,191840,73943,821250
506880,359812.4,1487200,322290,285202.2,665950,184590,74610.2,821250
499670,341610.8,1487200,322320,270793.7,665950,177350,70817.1,821250
492510,308274.5,1487200,322340,241070.7,665950,170170,67203.8,821250
485390,298777.2,1487200,322410,224948.6,665950,162980,73828.6,821250
480600,301408,1487200,321170,235596.1,665950,159430,65811.9,821250
476040,324895.1,1487200,319920,255679.4,665950,156120,69215.7,821250
471380,329744.9,1487200,318710,266769.2,665950,152670,62975.7,821250
466680,336370.2,1487200,317450,277435.2,665950,149230,58935,821250
458970,354336.6,1487200,313150,298164.1,665950,145820,56172.5,821250
451280,386443.3,1487200,308840,328663.2,665950,142440,57780.1,821250
443510,365152.6,1487200,304510,305983,665950,139000,59169.6,821250
435770,343070,1487200,300220,277728.5,665950,135550,65341.5,821250
425210,313480.6,1487200,294830,236925.3,665950,130380,76555.3,821250
414520,291238.9,1487200,289420,210297.4,665950,125100,80941.5,821250
403970,259429,1487200,284060,176339.2,665950,119910,83089.8,821250
393370,244965.7,1487200,278660,166681.3,665950,114710,78284.4,821250
385140,245909.2,1487200,272430,174245.4,665950,112710,71663.8,821250
376990,240913.3,1487200,266190,173781.8,665950,110800,67131.5,821250
368870,221182.6,1487200,259970,152465.3,665950,108900,68717.3,821250
205050,189735.5,1487200,147000,132989.8,665950,58050,56745.7,821250
198250,176412.3,1487200,141150,123142.8,665950,57100,53269.5,821250
191360,191531.9,1487200,135280,136317.6,665950,56080,55214.3,821250
184440,156801.7,1487200,129400,99549.9,665950,55040,57251.8,821250
177690,154630.4,1487200,123550,97518.3,665950,54140,57112.1,821250
169860,153374.7,1487200,116550,99186,665950,53310,54188.7,821250
162060,153395.6,1487200,109550,97979.6,665950,52510,55416,821250
154220,159207.8,1487200,102530,98511.9,665950,51690,60695.9,821250
146450,159107.6,1487200,95530,97958.3,665950,50920,61149.3,821250
141860,158163.3,1487200,91420,96431.7,665950,50440,61731.6,821250
137290,164943.5,1487200,87340,101617.1,665950,49950,63326.4,821250
132850,157648,1487200,83270,98958,665950,49580,58690,821250
128220,166521.2,1487200,79160,106166.5,665950,49060,60354.7,821250
124620,158546.5,1487200,76500,103500.9,665950,48120,55045.6,821250
120980,135707.1,1487200,73850,83653.2,665950,47130,52053.9,821250
117420,136709.9,1487200,71170,84434.8,665950,46250,52275.1,821250
113840,136923,1487200,68520,83658,665950,45320,53265,821250
112750,132573.5,1487200,68080,80571.9,665950,44670,52001.6,821250
111550,140488,1487200,67680,90159.3,665950,43870,50328.7,821250
110500,128523,1487200,67260,82820.7,665950,43240,45702.3,821250
109480,117625.4,1487200,66850,79116.2,665950,42630,38509.2,821250
104780,104109.6,1487200,63910,70101.2,665950,40870,34008.4,821250
100100,97878.2,1487200,60990,65855.6,665950,39110,32022.6,821250
95390,102634.8,1487200,58030,68739.9,665950,37360,33894.9,821250
90740,100847.6,1487200,55100,66184.4,665950,35640,34663.2,821250
86180,94124.4,1487200,52150,60582.2,665950,34030,33542.2,821250
81600,79621.1,1487200,49200,49696,665950,32400,29925.1,821250
76980,63225.2,1487200,46220,34663.8,665950,30760,28561.4,821250
72310,53137.9,1487200,43230,26131,665950,29080,27006.9,821250
67450,46806.2,1487200,39860,20402.7,665950,27590,26403.5,821250
62560,43307.9,1487200,36490,17384.7,665950,26070,25923.2,821250
57630,42383.6,1487200,33100,19519.8,665950,24530,22863.8,821250
52680,39921,1487200,29710,18386.1,665950,22970,21534.9,821250
57970,38813.4,1487200,35270,18602.2,665950,22700,20211.2,821250
63200,34832.2,1487200,40800,19781.6,665950,22400,15050.6,821250
68470,34571.6,1487200,46370,23190.7,665950,22100,11380.9,821250
73820,41038.7,1487200,51920,28752.7,665950,21900,12286,821250
80320,43714,1487200,58740,32752.6,665950,21580,10961.4,821250
86940,46042.1,1487200,65630,35135.2,665950,21310,10906.9,821250
93550,56086.9,1487200,72490,44689.3,665950,21060,11397.6,821250
100160,63387.1,1487200,79380,52895.5,665950,20780,10491.6,821250
106050,72331.8,1487200,86330,61422.2,665950,19720,10909.6,821250
111910,77868.6,1487200,93310,67170.7,665950,18600,10697.9,821250
117760,91802,1487200,100280,80426.6,665950,17480,11375.4,821250
123710,106440.8,1487200,107290,94618.6,665950,16420,11822.2,821250
147930,124692,1487200,125410,109529.6,665950,22520,15162.4,821250
172240,144813.7,1487200,143540,125201.3,665950,28700,19612.4,821250
196540,184430.9,1487200,161730,160776.6,665950,34810,23654.3,821250
220780,219223.8,1487200,179850,190532.3,665950,40930,28691.5,821250
247790,250112.8,1487200,201320,212005,665950,46470,38107.8,821250
274890,270364.2,1487200,222750,230759.5,665950,52140,39604.7,821250
301810,304836.1,1487200,244160,259247,665950,57650,45589.1,821250
328830,341395.6,1487200,265560,287342.6,665950,63270,54053,821250
355460,392771.7,1487200,286240,334030.3,665950,69220,58741.4,821250
382030,431303.7,1487200,306850,364734.4,665950,75180,66569.3,821250
408680,464931.1,1487200,327500,393681.5,665950,81180,71249.6,821250
435330,491578.5,1487200,348120,417365.2,665950,87210,74213.3,821250
459230,529541.9,1487200,359090,445524.8,665950,100140,84017.1,821250
483180,558072.6,1487200,370090,456998.6,665950,113090,101074,821250
507060,616269.7,1487200,381070,486932.8,665950,125990,129336.9,821250
530970,643206.8,1487200,392030,501910.7,665950,138940,141296.1,821250
561940,666801.4,1487200,409970,507779,665950,151970,159022.4,821250
592820,688210.4,1487200,427890,512835.1,665950,164930,175375.3,821250
623770,707472.5,1487200,445780,520411.6,665950,177990,187060.9,821250
654670,717370.8,1487200,463710,516231.2,665950,190960,201139.6,821250
681490,726485.3,1487200,477820,517209.7,665950,203670,209275.6,821250
708360,746118.9,1487200,491960,521973.6,665950,216400,224145.3,821250
735120,733628,1487200,506070,515456.6,665950,229050,218171.4,821250
761910,742973.9,1487200,520200,521269.6,665950,241710,221704.3,821250
772760,732507.2,1487200,524410,514231.4,665950,248350,218275.8,821250
783490,720402.4,1487200,528620,508868,665950,254870,211534.4,821250
794340,691077.4,1487200,532860,494358.8,665950,261480,196718.6,821250
805170,702351.4,1487200,537100,497510.9,665950,268070,204840.5,821250
813550,706095.2,1487200,538890,494847.1,665950,274660,211248.1,821250
822060,708475,1487200,540750,494045.6,665950,281310,214429.4,821250
830590,717025.4,1487200,542590,502523.5,665950,288000,214501.9,821250
839060,750166.7,1487200,544410,521076,665950,294650,229090.7,821250
847630,781909.2,1487200,546520,526623.1,665950,301110,255286.1,821250
856250,784642.5,1487200,548660,525917,665950,307590,258725.5,821250
864850,795642,1487200,550770,529800,665950,314080,265842,821250
873480,822543.6,1487200,552890,534599.5,665950,320590,287944.1,821250
890110,832546.2,1487200,555970,526343.8,665950,334140,306202.4,821250
906830,798256,1487200,559030,485238.7,665950,347800,313017.3,821250
923460,843163.7,1487200,562090,510420.1,665950,361370,332743.6,821250
940240,879996.5,1487200,565190,531745.9,665950,375050,348250.6,821250
958130,885810.1,1487200,568370,532744.9,665950,389760,353065.2,821250
975990,909199.3,1487200,571590,535863.8,665950,404400,373335.5,821250
993830,893233.3,1487200,574770,498847.4,665950,419060,394385.9,821250
1011650,892985.3,1487200,577980,477950.9,665950,433670,415034.4,821250
1029870,887015,1487200,581400,451447.4,665950,448470,435567.6,821250
1047810,909453.6,1487200,584770,453282.6,665950,463040,456171,821250
1065900,941439.8,1487200,588150,473506.7,665950,477750,467933.1,821250
1084050,988300.9,1487200,591550,494408.5,665950,492500,493892.4,821250
1088090,1058508.9,1487200,585450,536900.4,665950,502640,521608.5,821250
1092080,1096410.6,1487200,579310,568896.2,665950,512770,527514.4,821250
1096140,1125308.1,1487200,573220,588099,665950,522920,537209.1,821250
1186860,1132542.5,1487200,576550,590897.1,665950,610310,541645.4,821250
1181450,1143262.1,1487200,566360,596674.1,665950,615090,546588,821250
1176190,1095662.6,1487200,556220,548643.4,665950,619970,547019.2,821250
1170810,996888.5,1487200,546060,459802.5,665950,624750,537086,821250
1165470,959645.5,1487200,535920,422868.8,665950,629550,536776.7,821250
1162310,979778.9,1487200,528430,440083.4,665950,633880,539695.5,821250
1159270,1017573,1487200,520940,488500.6,665950,638330,529072.4,821250
1156150,1025953,1487200,513470,493205.9,665950,642680,532747.1,821250
1153060,960588.6,1487200,506000,450437.1,665950,647060,510151.5,821250
1136680,937015.5,1487200,505030,432992.8,665950,631650,504022.7,821250
1120430,915412.2,1487200,504100,424837.7,665950,616330,490574.5,821250
1104140,914064.2,1487200,503130,445227.3,665950,601010,468836.9,821250
1087810,910495.9,1487200,502180,467520.7,665950,585630,442975.2,821250
1069790,879046.1,1487200,500180,455883.3,665950,569610,423162.8,821250
1051760,853993,1487200,498170,463325.5,665950,553590,390667.5,821250
1033730,843403.5,1487200,496190,470840.7,665950,537540,372562.8,821250
1015770,882105.5,1487200,494180,503275.9,665950,521590,378829.6,821250
999480,883399.7,1487200,494160,517874.7,665950,505320,365525,821250
983200,847752.1,1487200,494140,499506.8,665950,489060,348245.3,821250
966940,856084,1487200,494150,511724.5,665950,472790,344359.5,821250
950640,893101.2,1487200,494140,536367.7,665950,456500,356733.5,821250
936690,860464.1,1487200,492800,537646.9,665950,443890,322817.2,821250
922680,817636.6,1487200,491460,516984.6,665950,431220,300652,821250
908710,806999.1,1487200,490110,507179.7,665950,418600,299819.4,821250
894670,823615.8,1487200,488750,534424.3,665950,405920,289191.5,821250
884860,837414.6,1487200,489850,546885.5,665950,395010,290529.1,821250
875000,814410.3,1487200,490910,532813.6,665950,384090,281596.7,821250
865180,822424.7,1487200,491970,533064.5,665950,373210,289360.2,821250
855370,836928.2,1487200,493050,541001.6,665950,362320,295926.6,821250
847390,838977,1487200,495050,540292.9,665950,352340,298684.1,821250
839360,851305.9,1487200,497000,544934.6,665950,342360,306371.3,821250
831370,832347,1487200,498990,530575.1,665950,332380,301771.9,821250
823330,809665.2,1487200,500960,530401.1,665950,322370,279264.1,821250
822020,785502.4,1487200,499440,518699.2,665950,322580,266803.2,821250
820730,764420,1487200,497930,507722.5,665950,322800,256697.5,821250
819350,731494,1487200,496420,482674,665950,322930,248820,821250
817970,702033.6,1487200,494880,463824.1,665950,323090,238209.5,821250
817360,696903.2,1487200,493530,474492.7,665950,323830,222410.5,821250
816560,711841.2,1487200,492160,478828.5,665950,324400,233012.7,821250
815960,709077.8,1487200,490800,486704.4,665950,325160,222373.4,821250
815180,719438.8,1487200,489430,491392.1,665950,325750,228046.7,821250
814780,749755.6,1487200,487850,498757,665950,326930,250998.6,821250
814340,756268.9,1487200,486250,494286.8,665950,328090,261982.1,821250
813960,778375.8,1487200,484690,493659.1,665950,329270,284716.7,821250
813590,775642.3,1487200,483100,491582.2,665950,330490,284060.1,821250
807970,761712.4,1487200,477820,482999.2,665950,330150,278713.2,821250
802270,719612.3,1487200,472530,451219.1,665950,329740,268393.2,821250
796580,691038.5,1487200,467230,423284.3,665950,329350,267754.2,821250
790990,665639,1487200,461980,398146.6,665950,329010,267492.4,821250
787540,681776.3,1487200,459700,414930.6,665950,327840,266845.7,821250
784140,717830.8,1487200,457420,437094.8,665950,326720,280736,821250
780660,723837.6,1487200,455120,443498.7,665950,325540,280338.9,821250
777180,742817,1487200,452830,454905.2,665950,324350,287911.8,821250
776450,706098.6,1487200,451790,438649.1,665950,324660,267449.5,821250
775720,676854.2,1487200,450760,424499,665950,324960,252355.2,821250
774930,737525.5,1487200,449730,450708.1,665950,325200,286817.4,821250
774190,804131.1,1487200,448670,486802.1,665950,325520,317329,821250
768940,769608,1487200,444380,458550.7,665950,324560,311057.3,821250
763690,694127.7,1487200,440060,413962,665950,323630,280165.7,821250
758440,674547.7,1487200,435780,420543.2,665950,322660,254004.5,821250
753190,683552.1,1487200,431440,409040.7,665950,321750,274511.4,821250
742520,713274,1487200,423170,454812,665950,319350,258462,821250
731920,696917.9,1487200,414890,435588.4,665950,317030,261329.5,821250
721250,695541.5,1487200,406590,426229.6,665950,314660,269311.9,821250
710620,676497.9,1487200,398320,410407.1,665950,312300,266090.8,821250
703940,665935.7,1487200,395140,429108.9,665950,308800,236826.8,821250
697290,702189.8,1487200,391970,454696.9,665950,305320,247492.9,821250
690600,581101.3,1487200,388840,309244.5,665950,301760,271856.8,821250
683890,659331.9,1487200,385680,396342.4,665950,298210,262989.5,821250
672860,516025.6,1487200,383040,293811.7,665950,289820,222213.9,821250
661900,467225.2,1487200,380390,252943.2,665950,281510,214282,821250
650740,567765.7,1487200,377720,355412.1,665950,273020,212353.6,821250
639750,613190.3,1487200,375100,411884.2,665950,264650,201306.1,821250
631130,610410.6,1487200,374460,413491.5,665950,256670,196919.1,821250
622440,642751.9,1487200,373840,449097.4,665950,248600,193654.5,821250
613820,473462.5,1487200,373210,293393,665950,240610,180069.5,821250
605230,479489.1,1487200,372610,265447.5,665950,232620,214041.6,821250
596380,502315.4,1487200,371090,308197.8,665950,225290,194117.6,821250
587600,537176.5,1487200,369560,328781.1,665950,218040,208395.4,821250
578860,555645,1487200,368060,354392.6,665950,210800,201252.4,821250
570110,503084.1,1487200,366530,340035.8,665950,203580,163048.3,821250
574860,541300.9,1487200,370090,362559.6,665950,204770,178741.3,821250
579580,527788.4,1487200,373660,346095.3,665950,205920,181693.1,821250
584350,504496.5,1487200,377210,341181.4,665950,207140,163315.1,821250
589030,539114.1,1487200,380770,375747.5,665950,208260,163366.6,821250
591930,433061,1487200,381900,288914.2,665950,210030,144146.8,821250
594760,459517.5,1487200,383040,319570.3,665950,211720,139947.2,821250
597580,511848.1,1487200,384190,386158.1,665950,213390,125690,821250
600460,565124.5,1487200,385300,421890.8,665950,215160,143233.7,821250
604520,622022.6,1487200,387290,464629.1,665950,217230,157393.5,821250
608650,649135,1487200,389240,476004.6,665950,219410,173130.4,821250
612680,617482.4,1487200,391210,458204.2,665950,221470,159278.2,821250
616820,611311.6,1487200,393190,445216.2,665950,223630,166095.4,821250
627370,629693.8,1487200,399190,445749.7,665950,228180,183944.1,821250
637910,610020.7,1487200,405160,444196.1,665950,232750,165824.6,821250
648480,628958,1487200,411170,463226.4,665950,237310,165731.6,821250
596640,650086.5,1487200,389210,473390.7,665950,207430,176695.8,821250
602430,676297.9,1487200,392180,476314.7,665950,210250,199983.2,821250
608190,670931.7,1487200,395150,476122.6,665950,213040,194809.1,821250
614010,671103.6,1487200,398140,474979.1,665950,215870,196124.5,821250
619790,657421.6,1487200,401140,459406.1,665950,218650,198015.5,821250
624950,658470.1,1487200,402870,447371.7,665950,222080,211098.4,821250
630250,657299.6,1487200,404650,444201.7,665950,225600,213097.9,821250
635460,650556.8,1487200,406400,439656.4,665950,229060,210900.4,821250
640690,652494,1487200,408160,435487.6,665950,232530,217006.4,821250
643290,680085.3,1487200,409390,456928.6,665950,233900,223156.7,821250
645860,685844.1,1487200,410590,463956.2,665950,235270,221887.9,821250
648420,685027.8,1487200,411850,463378.6,665950,236570,221649.2,821250
650960,701260.5,1487200,413100,469012.1,665950,237860,232248.4,821250
654940,711747.1,1487200,415830,481244.9,665950,239110,230502.2,821250
659080,715859,1487200,418600,477148.5,665950,240480,238710.5,821250
663210,694789.1,1487200,421380,457266.8,665950,241830,237522.3,821250
667220,596864.7,1487200,424130,361381.9,665950,243090,235482.8,821250
670360,533337.3,1487200,426340,298410.3,665950,244020,234927,821250
673490,508315.1,1487200,428550,277189.5,665950,244940,231125.6,821250
676760,489315,1487200,430780,260806.2,665950,245980,228508.8,821250
679850,494730.7,1487200,433000,269965.6,665950,246850,224765.1,821250
680390,561491.5,1487200,432180,343652.5,665950,248210,217839,821250
680780,637880.5,1487200,431360,414024.1,665950,249420,223856.4,821250
681220,654061.9,1487200,430520,418582,665950,250700,235479.9,821250
681640,661645.9,1487200,429700,418279,665950,251940,243366.9,821250
679340,648251.3,1487200,426930,412732.4,665950,252410,235518.9,821250
676940,618994.1,1487200,424170,385809.2,665950,252770,233184.9,821250
674460,628750.8,1487200,421400,391226.2,665950,253060,237524.6,821250
672120,637886.7,1487200,418660,398420.1,665950,253460,239466.6,821250
671480,636535.3,1487200,417400,394327.7,665950,254080,242207.6,821250
670810,634098.4,1487200,416160,394237.6,665950,254650,239860.8,821250
670180,644058.6,1487200,414890,402709.4,665950,255290,241349.2,821250
669530,587001.3,1487200,413650,355193.4,665950,255880,231807.9,821250
673850,566999.2,1487200,413400,337134.8,665950,260450,229864.4,821250
678270,548696,1487200,413160,333171.6,665950,265110,215524.4,821250
682660,560337.4,1487200,412920,355700.4,665950,269740,204637,821250
687020,569975.8,1487200,412660,367271.6,665950,274360,202704.2,821250
687270,591320.7,1487200,410560,383141.5,665950,276710,208179.2,821250
687560,572446.8,1487200,408470,364417.9,665950,279090,208028.9,821250
687800,550979.3,1487200,406350,357455.1,665950,281450,193524.2,821250
688150,532289.5,1487200,404250,345354.6,665950,283900,186934.9,821250
694610,529498.7,1487200,403530,323370.6,665950,291080,206128.1,821250
701120,536425.8,1487200,402780,325063.9,665950,298340,211361.9,821250
707600,560643.2,1487200,402060,336821.8,665950,305540,223821.4,821250
714080,513855.1,1487200,401320,284799.5,665950,312760,229055.6,821250
724780,586257.7,1487200,402810,351022,665950,321970,235235.7,821250
735440,599135.3,1487200,404270,366402.6,665950,331170,232732.7,821250
746090,578432.2,1487200,405710,336667.5,665950,340380,241764.7,821250
756790,604370.8,1487200,407200,348083,665950,349590,256287.8,821250
768450,611832.6,1487200,410700,363955.6,665950,357750,247877,821250
780040,609311.7,1487200,414230,361103.2,665950,365810,248208.5,821250
791700,581658.1,1487200,417750,325510.3,665950,373950,256147.8,821250
803270,591753.2,1487200,421260,318980,665950,382010,272773.2,821250
812720,622997.5,1487200,423600,367092,665950,389120,255905.5,821250
822060,629541.8,1487200,425940,379723.8,665950,396120,249818,821250
831480,616872.1,1487200,428260,363856.4,665950,403220,253015.7,821250
840810,637628.1,1487200,430580,376901.7,665950,410230,260726.4,821250
823560,668605.9,1487200,420080,387664,665950,403480,280941.9,821250
806180,633887.1,1487200,409570,355826.4,665950,396610,278060.7,821250
788900,660221.5,1487200,399080,355222.4,665950,389820,304999.1,821250
771590,668214.8,1487200,388580,377101.2,665950,383010,291113.6,821250
754700,705744.7,1487200,379350,386234.7,665950,375350,319510,821250
737930,711159.5,1487200,370130,409041.9,665950,367800,302117.6,821250
721080,761312,1487200,360900,457015.4,665950,360180,304296.6,821250
704180,754852.2,1487200,351680,450215.1,665950,352500,304637.1,821250
697020,726049.2,1487200,349900,398403.8,665950,347120,327645.4,821250
689850,588647.2,1487200,348160,296369.2,665950,341690,292278,821250
682680,502905.3,1487200,346380,251559.5,665950,336300,251345.8,821250
675460,511503.1,1487200,344620,271356.2,665950,330840,240146.9,821250
678300,444379.6,1487200,340160,228269.2,665950,338140,216110.4,821250
681090,393786.3,1487200,335700,188243.9,665950,345390,205542.4,821250
683790,315709.5,1487200,331220,132739.4,665950,352570,182970.1,821250
686660,304234.4,1487200,326760,113143.3,665950,359900,191091.1,821250
680730,301326,1487200,316090,95902.9,665950,364640,205423.1,821250
674900,269879.1,1487200,305430,69790.2,665950,369470,200088.9,821250
669090,263693.9,1487200,294790,66244.5,665950,374300,197449.4,821250
663150,316929.2,1487200,284100,96905.5,665950,379050,220023.7,821250
660430,344494.3,1487200,274500,108705.6,665950,385930,235788.7,821250
657720,362979.6,1487200,264880,105830,665950,392840,257149.6,821250
654940,380614.5,1487200,255250,106058.9,665950,399690,274555.6,821250
652140,408401.3,1487200,245610,125730.1,665950,406530,282671.2,821250
649500,446982.3,1487200,238880,138988.8,665950,410620,307993.5,821250
646750,473454.3,1487200,232130,149001.5,665950,414620,324452.8,821250
644030,502795.1,1487200,225370,166652.5,665950,418660,336142.6,821250
641360,512311.9,1487200,218610,158783.6,665950,422750,353528.3,821250
639320,511778.8,1487200,214700,151737.7,665950,424620,360041.1,821250
637310,514338.8,1487200,210740,150525.1,665950,426570,363813.7,821250
635290,484332.6,1487200,206840,129867.8,665950,428450,354464.8,821250
633400,465293.6,1487200,202940,115309.5,665950,430460,349984.1,821250
633780,415839.3,1487200,200580,85367.8,665950,433200,330471.5,821250
634190,390465.6,1487200,198240,73602.7,665950,435950,316862.9,821250
634500,359901.5,1487200,195890,60421.6,665950,438610,299479.9,821250
634890,340416.7,1487200,193570,57208.5,665950,441320,283208.2,821250
638780,362735.5,1487200,199340,78902.1,665950,439440,283833.4,821250
642680,343390.6,1487200,205080,75348,665950,437600,268042.6,821250
646570,325074.9,1487200,210840,66943.9,665950,435730,258131,821250
583090,309723.3,1487200,118460,59359,665950,464630,250364.3,821250
592420,301156,1487200,123260,43878.3,665950,469160,257277.7,821250
601570,311527.4,1487200,128010,58868.2,665950,473560,252659.2,821250
610800,319021.9,1487200,132800,69956.2,665950,478000,249065.7,821250
620010,331889.4,1487200,137580,69075.1,665950,482430,262814.3,821250
636680,348849.9,1487200,149760,67245,665950,486920,281604.9,821250
653180,335525.1,1487200,161960,79352.8,665950,491220,256172.3,821250
669770,354090.4,1487200,174120,97459.9,665950,495650,256630.5,821250
686390,390327.9,1487200,186290,109239.3,665950,500100,281088.6,821250
683300,435259.4,1487200,187270,150468.6,665950,496030,284790.8,821250
680360,438576.8,1487200,188270,149180.1,665950,492090,289396.7,821250
677330,408223.9,1487200,189250,138507.3,665950,488080,269716.6,821250
674270,471142.8,1487200,190210,179405.3,665950,484060,291737.5,821250
671510,480745.7,1487200,190520,187400.1,665950,480990,293345.6,821250
668720,548998.8,1487200,190830,255718.6,665950,477890,293280.2,821250
665890,530594.7,1487200,191100,253865.7,665950,474790,276729,821250
663140,521895.4,1487200,191400,266319.6,665950,471740,255575.8,821250
660630,515019.8,1487200,193530,254655.1,665950,467100,260364.7,821250
658150,451678.3,1487200,195680,218537.3,665950,462470,233141,821250
655660,479648,1487200,197790,242469.1,665950,457870,237178.9,821250
653190,462967.8,1487200,199950,237197.8,665950,453240,225770,821250
640890,434469.7,1487200,202490,226937.5,665950,438400,207532.2,821250
628570,410313.6,1487200,205050,216916.4,665950,423520,193397.2,821250
616260,399069.8,1487200,207600,209398,665950,408660,189671.8,821250
603920,358575.7,1487200,210150,176749.5,665950,393770,181826.2,821250
588690,310193.7,1487200,209650,143670,665950,379040,166523.7,821250
573410,276759.1,1487200,209130,133707,665950,364280,143052.1,821250
558140,242941.9,1487200,208630,117893.5,665950,349510,125048.4,821250
542890,224657,1487200,208130,112764.8,665950,334760,111892.2,821250
529110,198362.1,1487200,208520,100867.8,665950,320590,97494.3,821250
515320,200289.6,1487200,208920,104294.5,665950,306400,95995.1,821250
501440,187184.4,1487200,209280,98256.6,665950,292160,88927.8,821250
487660,172739.9,1487200,209680,86970.1,665950,277980,85769.8,821250
480570,179403.2,1487200,211970,91815.8,665950,268600,87587.4,821250
473370,156758,1487200,214200,84170.5,665950,259170,72587.5,821250
466200,154982.6,1487200,216470,85246.3,665950,249730,69736.3,821250
459140,172570.3,1487200,218740,92612.7,665950,240400,79957.6,821250
450240,163068.8,1487200,218940,92325.7,665950,231300,70743.1,821250
441290,163794,1487200,219080,105106.1,665950,222210,58687.9,821250
432320,169723.8,1487200,219280,119289,665950,213040,50434.8,821250
423420,181283.5,1487200,219480,135167.8,665950,203940,46115.7,821250
417070,185451.2,1487200,221740,144640.7,665950,195330,40810.5,821250
410850,179798.3,1487200,224040,143395.8,665950,186810,36402.5,821250
404670,172949.6,1487200,226340,132307.2,665950,178330,40642.4,821250
398350,153218.2,1487200,228620,110739,665950,169730,42479.2,821250
399740,144679.4,1487200,229060,102922.4,665950,170680,41757,821250
400990,142542,1487200,229500,104793.4,665950,171490,37748.6,821250
402240,146873.4,1487200,229920,110337.5,665950,172320,36535.9,821250
403600,139836,1487200,230370,102411.8,665950,173230,37424.2,821250
402670,137301.1,1487200,228670,102505.8,665950,174000,34795.3,821250
401710,144970.7,1487200,226950,106979.2,665950,174760,37991.5,821250
400770,166500.9,1487200,225260,122405.3,665950,175510,44095.6,821250
399850,177403.1,1487200,223570,127173.1,665950,176280,50230,821250
398710,175177.4,1487200,221880,121714.9,665950,176830,53462.5,821250
397550,191814.7,1487200,220160,125756.3,665950,177390,66058.4,821250
396480,222182.1,1487200,218470,146071.7,665950,178010,76110.4,821250
395280,252965.3,1487200,216750,160220.1,665950,178530,92745.2,821250
399420,291921.1,1487200,216220,185672.7,665950,183200,106248.4,821250
403470,323352.1,1487200,215700,199749.7,665950,187770,123602.4,821250
407550,358182.2,1487200,215170,214663.3,665950,192380,143518.9,821250
411710,352198.7,1487200,214690,204548.1,665950,197020,147650.6,821250
415130,366914.6,1487200,213730,207293,665950,201400,159621.6,821250
418480,375012.4,1487200,212830,220001.7,665950,205650,155010.7,821250
421970,386417.1,1487200,211890,218802.5,665950,210080,167614.6,821250
425290,380440,1487200,211000,207705.5,665950,214290,172734.5,821250
431450,389426.5,1487200,212990,208729.2,665950,218460,180697.3,821250
437460,378508.5,1487200,214990,193702,665950,222470,184806.5,821250
443540,363359.3,1487200,216990,186472.2,665950,226550,176887.1,821250
449590,334637.9,1487200,218980,173818,665950,230610,160819.9,821250
449310,352298.2,1487200,224340,167842.1,665950,224970,184456.1,821250
449110,334121.8,1487200,229710,164982.8,665950,219400,169139,821250
448840,299358.2,1487200,235080,141692.4,665950,213760,157665.8,821250
448610,310761.1,1487200,240460,151413.3,665950,208150,159347.8,821250
445300,394028.9,1487200,243480,248249,665950,201820,145779.9,821250
441900,436841.6,1487200,246480,303141.8,665950,195420,133699.8,821250
438670,423148.6,1487200,249500,294907.7,665950,189170,128240.9,821250
435340,411352.2,1487200,252500,290719.2,665950,182840,120633,821250
431790,414828.4,1487200,255170,290393.8,665950,176620,124434.6,821250
428250,394275.3,1487200,257870,279726.5,665950,170380,114548.8,821250
424660,402462.5,1487200,260560,295538.8,665950,164100,106923.7,821250
421150,420280.1,1487200,263250,315352.2,665950,157900,104927.9,821250
424800,398079.5,1487200,267440,305653.5,665950,157360,92426,821250
428350,393460.5,1487200,271660,297587.4,665950,156690,95873.1,821250
431990,406499.7,1487200,275870,303466.2,665950,156120,103033.5,821250
435580,426225.1,1487200,280070,326833.7,665950,155510,99391.4,821250
440480,442952.7,1487200,285280,342368.9,665950,155200,100583.8,821250
445410,460261.6,1487200,290510,349800.6,665950,154900,110461,821250
450340,457823.7,1487200,295740,340541.8,665950,154600,117281.9,821250
455270,464760.6,1487200,300950,344770.7,665950,154320,119989.9,821250
457570,462218.4,1487200,303040,340378.8,665950,154530,121839.6,821250
459850,452144.7,1487200,305120,328338.6,665950,154730,123806.1,821250
462130,470003.8,1487200,307170,345215.6,665950,154960,124788.2,821250
464390,481479,1487200,309270,365512.6,665950,155120,115966.4,821250
467300,532447,1487200,310140,414841,665950,157160,117606,821250
470210,545410.6,1487200,311030,425136.6,665950,159180,120274,821250
473040,537086.8,1487200,311910,416589.5,665950,161130,120497.3,821250
488930,489064.9,1487200,333700,378434.8,665950,155230,110630.1,821250
487390,476228.1,1487200,329690,352394,665950,157700,123834.1,821250
485840,473734.7,1487200,325680,331526.8,665950,160160,142207.9,821250
484290,482891.9,1487200,321680,324805.9,665950,162610,158086,821250
482810,483226.8,1487200,317680,325716.7,665950,165130,157510.1,821250
480880,462581.9,1487200,314440,318139.7,665950,166440,144442.2,821250
478990,461398.9,1487200,311210,315269.4,665950,167780,146129.5,821250
477050,458726.5,1487200,307980,303250,665950,169070,155476.5,821250
475190,446608.6,1487200,304790,288315.5,665950,170400,158293.1,821250
468170,443729.7,1487200,299020,280451.7,665950,169150,163278,821250
461290,422992.4,1487200,293320,260872.3,665950,167970,162120.1,821250
454300,426222.1,1487200,287560,258545.8,665950,166740,167676.3,821250
447390,422385,1487200,281820,250507.3,665950,165570,171877.7,821250
442800,437217.5,1487200,278070,262764.3,665950,164730,174453.2,821250
438140,408015.6,1487200,274260,239438.4,665950,163880,168577.2,821250
433570,396121.7,1487200,270470,232626,665950,163100,163495.7,821250
429000,405308.6,1487200,266680,243530.3,665950,162320,161778.3,821250
422560,390637.8,1487200,260900,232087.6,665950,161660,158550.2,821250
416050,398027.2,1487200,255090,247192.1,665950,160960,150835.1,821250
409560,389822.7,1487200,249270,238232.1,665950,160290,151590.6,821250
403070,372330.6,1487200,243470,227525.4,665950,159600,144805.2,821250
392840,374936.3,1487200,235990,224337.3,665950,156850,150599,821250
382630,382236.2,1487200,228480,224704.3,665950,154150,157531.9,821250
372290,368328.9,1487200,220990,221444.2,665950,151300,146884.7,821250
361990,356937.6,1487200,213470,220798.2,665950,148520,136139.4,821250
351440,358370.1,1487200,205980,226143.2,665950,145460,132226.9,821250
341010,331374.9,1487200,198510,197852,665950,142500,133522.9,821250
330490,322699.2,1487200,191040,189110.5,665950,139450,133588.7,821250
319880,325833.8,1487200,183550,188690.9,665950,136330,137142.9,821250
310550,304206.7,1487200,177110,169235.4,665950,133440,134971.3,821250
301060,291108.6,1487200,170650,162035,665950,130410,129073.6,821250
291580,276470.2,1487200,164210,151445.3,665950,127370,125024.9,821250
282130,282034.8,1487200,157750,158213.3,665950,124380,123821.5,821250
278980,264357.9,1487200,156310,145202.5,665950,122670,119155.4,821250
275740,244197,1487200,154900,134774.3,665950,120840,109422.7,821250
272520,210837.6,1487200,153480,113844.4,665950,119040,96993.2,821250
269360,190078.5,1487200,152040,108521.7,665950,117320,81556.8,821250
266560,155642.8,1487200,153460,86779.9,665950,113100,68862.9,821250
263780,142231.6,1487200,154910,80364.7,665950,108870,61866.9,821250
261000,130834.8,1487200,156320,78034.3,665950,104680,52800.5,821250
258270,138873,1487200,157760,89372.1,665950,100510,49500.9,821250
253830,152892.6,1487200,157460,103705.9,665950,96370,49186.7,821250
249180,158226.2,1487200,157160,101725.2,665950,92020,56501,821250
244730,154363.9,1487200,156860,90529.9,665950,87870,63834,821250
240250,185967.7,1487200,156560,111172.4,665950,83690,74795.3,821250
251200,211530.9,1487200,160420,122139.6,665950,90780,89391.3,821250
262240,232637.4,1487200,164290,134512.6,665950,97950,98124.8,821250
273170,261423.4,1487200,168130,152572.6,665950,105040,108850.8,821250
284150,279799.3,1487200,171970,169831.6,665950,112180,109967.7,821250
303970,324285.8,1487200,183620,209416.7,665950,120350,114869.1,821250
323870,360443.7,1487200,195280,236817.9,665950,128590,123625.8,821250
343610,382744.3,1487200,206910,244141.3,665950,136700,138603,821250
363490,412216.8,1487200,218560,268508.1,665950,144930,143708.7,821250
371750,479905.2,1487200,219870,329634.1,665950,151880,150271.1,821250
380130,487569.1,1487200,221230,344867.6,665950,158900,142701.5,821250
388310,523008.2,1487200,222550,369834.5,665950,165760,153173.7,821250
396660,528607,1487200,223870,375622.9,665950,172790,152984.1,821250
412440,530141.8,1487200,237450,364728.2,665950,174990,165413.6,821250
428050,572292,1487200,250970,398519.7,665950,177080,173772.3,821250
443780,629924.3,1487200,264510,437650.1,665950,179270,192274.2,821250
459470,666623.6,1487200,278050,472384,665950,181420,194239.6,821250
471590,629926.6,1487200,288740,438338,665950,182850,191588.6,821250
483690,613544.1,1487200,299400,414848.9,665950,184290,198695.2,821250
495820,640402.5,1487200,310080,430617.4,665950,185740,209785.1,821250
507900,676439.8,1487200,320770,454846.4,665950,187130,221593.4,821250
529110,706335.2,1487200,340130,492639.7,665950,188980,213695.5,821250
550350,718780.5,1487200,359530,511000.1,665950,190820,207780.4,821250
571530,740951.6,1487200,378910,520662.1,665950,192620,220289.5,821250
592740,752709.9,1487200,398300,523530.6,665950,194440,229179.3,821250
613410,757823.1,1487200,407960,515208.3,665950,205450,242614.8,821250
634020,754328,1487200,417650,523484.9,665950,216370,230843.1,821250
654660,723462.5,1487200,427340,504723.4,665950,227320,218739.1,821250
675300,720479.1,1487200,436980,503273.4,665950,238320,217205.7,821250
701170,745755.4,1487200,450700,503274.1,665950,250470,242481.3,821250
727030,746345.9,1487200,464400,503573.3,665950,262630,242772.6,821250
752840,751118.8,1487200,478090,497837.7,665950,274750,253281.1,821250
778700,775426.3,1487200,491810,506103.6,665950,286890,269322.7,821250
796860,771761,1487200,497680,506088.9,665950,299180,265672.1,821250
814980,769383.8,1487200,503570,499598.5,665950,311410,269785.3,821250
833020,757486.1,1487200,509430,494452.9,665950,323590,263033.2,821250
851080,791708.6,1487200,515290,512353.1,665950,335790,279355.5,821250
863380,804847.4,1487200,517880,515027.2,665950,345500,289820.2,821250
875610,802289.1,1487200,520450,503351,665950,355160,298938.1,821250
887960,766977.6,1487200,523060,484913.7,665950,364900,282063.9,821250
900170,721193.8,1487200,525630,440532.2,665950,374540,280661.6,821250
905380,692694.1,1487200,521550,399587.3,665950,383830,293106.8,821250
910620,694090.1,1487200,517510,392546.8,665950,393110,301543.3,821250
915840,680503.1,1487200,513440,364357.4,665950,402400,316145.7,821250
921010,648503,1487200,509380,343378.2,665950,411630,305124.8,821250
925410,619437.3,1487200,504750,308718.4,665950,420660,310718.9,821250
929750,576544.9,1487200,500140,276083.2,665950,429610,300461.7,821250
934180,529736,1487200,495490,232571.5,665950,438690,297164.5,821250
938430,536216.7,1487200,490890,222941,665950,447540,313275.7,821250
922500,538922.7,1487200,478670,218929.5,665950,443830,319993.2,821250
906400,512800.5,1487200,466430,200743.7,665950,439970,312056.8,821250
890430,509059.5,1487200,454200,202871.2,665950,436230,306188.3,821250
800300,492402.3,1487200,390320,216401.4,665950,409980,276000.9,821250
781640,525874.6,1487200,383190,259889.2,665950,398450,265985.4,821250
762940,578526.5,1487200,376070,318608,665950,386870,259918.5,821250
744300,567716.6,1487200,368970,311460,665950,375330,256256.6,821250
725650,524300.3,1487200,361830,277540.1,665950,363820,246760.2,821250
704510,469932.8,1487200,352700,220938.4,665950,351810,248994.4,821250
683330,459612.7,1487200,343590,237233.6,665950,339740,222379.1,821250
662190,437023.3,1487200,334480,238327.9,665950,327710,198695.4,821250
641040,420301.1,1487200,325350,230964.4,665950,315690,189336.7,821250
625310,384255,1487200,321270,209405.8,665950,304040,174849.2,821250
609730,361442.2,1487200,317270,191195.9,665950,292460,170246.3,821250
593980,354804.9,1487200,313210,197537.4,665950,280770,157267.5,821250
578270,385999.9,1487200,309160,232625.9,665950,269110,153374,821250
565100,392283.9,1487200,307080,255336.7,665950,258020,136947.2,821250
551780,423499.2,1487200,304950,286634.5,665950,246830,136864.7,821250
538510,445872.7,1487200,302860,313110.2,665950,235650,132762.5,821250
525260,476393.7,1487200,300790,349805.7,665950,224470,126588,821250
516100,461879.2,1487200,302450,344085.5,665950,213650,117793.7,821250
506830,429803.4,1487200,304090,310634.4,665950,202740,119169,821250
497590,452793.7,1487200,305780,343899.6,665950,191810,108894.1,821250
488360,433490.6,1487200,307460,324524.2,665950,180900,108966.4,821250
484600,469839.4,1487200,305600,354016.3,665950,179000,115823.1,821250
480920,467870,1487200,303750,353465.5,665950,177170,114404.5,821250
477250,435607.6,1487200,301920,318279.1,665950,175330,117328.5,821250
473460,388212.5,1487200,300050,276924.2,665950,173410,111288.3,821250
466320,368190.6,1487200,294750,266283.8,665950,171570,101906.8,821250
459170,352621.6,1487200,289430,251101.3,665950,169740,101520.3,821250
452080,329639.1,1487200,284140,228767.9,665950,167940,100871.2,821250
444940,347322,1487200,278860,251473.1,665950,166080,95848.9,821250
438040,329777.6,1487200,273870,237882.5,665950,164170,91895.1,821250
431080,326963.1,1487200,268910,240775.1,665950,162170,86188,821250
424230,311859.9,1487200,263960,221029.2,665950,160270,90830.7,821250
417390,277947.2,1487200,258990,195408.1,665950,158400,82539.1,821250
408770,272322.9,1487200,250970,190580.9,665950,157800,81742,821250
400240,242618.3,1487200,242960,167310.9,665950,157280,75307.4,821250
391620,254772.7,1487200,234920,186319.9,665950,156700,68452.8,821250
383150,244852.7,1487200,226950,180244.4,665950,156200,64608.3,821250
374640,204247.1,1487200,219570,140662.5,665950,155070,63584.6,821250
366180,203675,1487200,212170,144471,665950,154010,59204,821250
357700,228350.7,1487200,204760,172269.2,665950,152940,56081.5,821250
349230,233737.8,1487200,197360,177378.8,665950,151870,56359,821250
343040,233815.4,1487200,190840,174981.1,665950,152200,58834.3,821250
336780,232761.8,1487200,184270,171581.1,665950,152510,61180.7,821250
330570,247436.7,1487200,177730,180306.2,665950,152840,67130.5,821250
324300,258727.4,1487200,171190,193806.3,665950,153110,64921.1,821250
318650,228019.4,1487200,165400,167218,665950,153250,60801.4,821250
313020,214852.6,1487200,159650,151596.8,665950,153370,63255.8,821250
307370,221414.9,1487200,153850,153060.7,665950,153520,68354.2,821250
301720,234980.2,1487200,148070,164978.3,665950,153650,70001.9,821250
296260,227252.9,1487200,142910,154710.5,665950,153350,72542.4,821250
290780,217825.5,1487200,137750,136829,665950,153030,80996.5,821250
285280,185412.5,1487200,132610,104455.1,665950,152670,80957.4,821250
279760,188164.9,1487200,127440,97074,665950,152320,91090.9,821250
277850,189576.5,1487200,125830,90828.3,665950,152020,98748.2,821250
275890,198880.7,1487200,124250,92915.4,665950,151640,105965.3,821250
273920,199948,1487200,122620,94066.6,665950,151300,105881.4,821250
271960,231772.6,1487200,121040,114100.7,665950,150920,117671.9,821250
267440,228970.6,1487200,117920,112828.9,665950,149520,116141.7,821250
262740,208053.7,1487200,114780,101802.8,665950,147960,106250.9,821250
258210,210793.2,1487200,111650,101089.2,665950,146560,109704,821250
253550,219173.1,1487200,108530,104002.8,665950,145020,115170.3,821250
246890,203191.5,1487200,103790,92121.4,665950,143100,111070.1,821250
240210,201688.3,1487200,99040,93287,665950,141170,108401.3,821250
233500,196148.8,1487200,94320,91374.3,665950,139180,104774.5,821250
226810,190281.1,1487200,89570,82938.4,665950,137240,107342.7,821250
220310,181009.8,1487200,85220,80969.5,665950,135090,100040.3,821250
213730,169033.6,1487200,80880,76047.4,665950,132850,92986.2,821250
207200,161300.1,1487200,76540,73181.3,665950,130660,88118.8,821250
200690,146374.2,1487200,72210,64487.7,665950,128480,81886.5,821250
189900,125012.6,1487200,67370,49520.5,665950,122530,75492.1,821250
179200,111626.1,1487200,62590,39824.2,665950,116610,71801.9,821250
168330,101590,1487200,57760,39860.1,665950,110570,61729.9,821250
157560,91966.2,1487200,52970,33897.6,665950,104590,58068.6,821250
146990,83689.4,1487200,48500,28570,665950,98490,55119.4,821250
136300,66217.7,1487200,44040,16691,665950,92260,49526.7,821250
125730,51006,1487200,39580,10231.6,665950,86150,40774.4,821250
114970,44577.3,1487200,35120,6841.6,665950,79850,37735.7,821250
105380,38579.9,1487200,31230,6231,665950,74150,32348.9,821250
95900,39777.9,1487200,27400,6784.5,665950,68500,32993.4,821250
86310,37881.4,1487200,23540,5919.1,665950,62770,31962.3,821250
76740,36979.5,1487200,19660,6829,665950,57080,30150.5,821250
73350,36651.9,1487200,18360,6989.9,665950,54990,29662,821250
70050,34953.3,1487200,17030,6047.8,665950,53020,28905.5,821250
66740,32696,1487200,15730,5534.3,665950,51010,27161.7,821250
63340,32701.9,1487200,14400,5345.7,665950,48940,27356.2,821250
60450,35241,1487200,13270,6240.2,665950,47180,29000.8,821250
57640,34136.4,1487200,12150,5986,665950,45490,28150.4,821250
54770,32983.6,1487200,10990,5700.9,665950,43780,27282.7,821250
51860,32209.1,1487200,9840,5544.5,665950,42020,26664.6,821250
49180,33805.8,1487200,8790,6728.9,665950,40390,27076.9,821250
46550,31161.3,1487200,7740,6481.2,665950,38810,24680.1,821250
43970,29319.4,1487200,6680,6008.6,665950,37290,23310.8,821250
41190,28969,1487200,5600,7221.1,665950,35590,21747.9,821250
40990,29544.9,1487200,5950,7628.6,665950,35040,21916.3,821250
40780,27554,1487200,6300,6878.9,665950,34480,20675.1,821250
40530,28559.2,1487200,6650,6820.7,665950,33880,21738.5,821250
25040,26354.5,1487200,7520,6616.7,665950,17520,19737.8,821250
25970,23490.4,1487200,8160,5198.8,665950,17810,18291.6,821250
26690,24024.8,1487200,8820,7245,665950,17870,16779.8,821250
27540,27087.6,1487200,9470,10424.4,665950,18070,16663.2,821250
28370,30287.6,1487200,10150,12461.1,665950,18220,17826.5,821250
29850,32564.5,1487200,11420,14006.1,665950,18430,18558.4,821250
31410,33858.1,1487200,12690,15625.7,665950,18720,18232.4,821250
32960,36747.6,1487200,13950,18798.9,665950,19010,17948.7,821250
34460,37929.2,1487200,15220,20738.8,665950,19240,17190.4,821250
35180,34571.3,1487200,16490,18595.7,665950,18690,15975.6,821250
35850,33585.2,1487200,17750,17960.4,665950,18100,15624.8,821250
36600,34328.4,1487200,19060,18918.6,665950,17540,15409.8,821250
37270,38469.5,1487200,20330,23569.5,665950,16940,14900,821250
38100,37141.9,1487200,21780,22044.1,665950,16320,15097.8,821250
38920,31220.1,1487200,23240,15730,665950,15680,15490.1,821250
39720,30782.7,1487200,24710,15871.2,665950,15010,14911.5,821250
40640,34089.1,1487200,26180,19435.5,665950,14460,14653.6,821250
40410,39713.4,1487200,26580,24949.3,665950,13830,14764.1,821250
40220,42529.3,1487200,27020,27670.8,665950,13200,14858.5,821250
40000,51535.4,1487200,27430,37077.6,665950,12570,14457.8,821250
39760,59938.9,1487200,27890,45627.8,665950,11870,14311.1,821250
43080,61632.6,1487200,30720,46999.3,665950,12360,14633.3,821250
46370,59603,1487200,33580,45646.6,665950,12790,13956.4,821250
49770,64535.8,1487200,36430,50307.1,665950,13340,14228.7,821250
53060,70812.8,1487200,39290,55849.1,665950,13770,14963.7,821250
55600,72188.4,1487200,41380,52563.2,665950,14220,19625.2,821250
58080,75317.5,1487200,43490,53301.6,665950,14590,22015.9,821250
60580,80274.2,1487200,45570,57361.1,665950,15010,22913.1,821250
63080,86262.4,1487200,47690,64142.8,665950,15390,22119.6,821250
67490,90099.7,1487200,51580,67711.7,665950,15910,22388,821250
71960,87576.2,1487200,55470,64219.2,665950,16490,23357,821250
76440,87084.3,1487200,59380,61061,665950,17060,26023.3,821250
80940,85289.9,1487200,63300,52999.2,665950,17640,32290.7,821250
82490,102184.7,1487200,65360,63685.4,665950,17130,38499.3,821250
84030,118912.2,1487200,67420,76360,665950,16610,42552.2,821250
85590,127312.4,1487200,69470,80771.6,665950,16120,46540.8,821250
87130,133689.5,1487200,71530,85140.7,665950,15600,48548.8,821250
88270,126280.1,1487200,73350,76492,665950,14920,49788.1,821250
89500,114817.7,1487200,75190,69439.9,665950,14310,45377.8,821250
90630,104577.9,1487200,77010,63314.2,665950,13620,41263.7,821250
91820,85865.4,1487200,78840,50816.3,665950,12980,35049.1,821250
92590,76370.4,1487200,80850,48016.7,665950,11740,28353.7,821250
93400,73974.3,1487200,82880,49931,665950,10520,24043.3,821250
94160,69287.5,1487200,84900,48411.4,665950,9260,20876.1,821250
94990,66609.9,1487200,86930,49344.1,665950,8060,17265.8,821250
95910,65713.3,1487200,87970,48660.8,665950,7940,17052.5,821250
96740,63668.8,1487200,89010,47475.5,665950,7730,16193.3,821250
97580,56756.6,1487200,90040,40758.6,665950,7540,15998,821250
98470,66128.7,1487200,91070,48007,665950,7400,18121.7,821250
96930,72439,1487200,89400,51107.8,665950,7530,21331.2,821250
95380,68961,1487200,87700,47459.7,665950,7680,21501.3,821250
93850,79144.8,1487200,86000,55726.7,665950,7850,23418.1,821250
92290,87421.6,1487200,84310,62730.5,665950,7980,24691.1,821250
92350,88848.9,1487200,84130,62943.7,665950,8220,25905.2,821250
92360,92663.4,1487200,83980,67190.1,665950,8380,25473.3,821250
92510,98300.7,1487200,83850,72037.1,665950,8660,26263.6,821250
92480,94052.4,1487200,83680,69546.4,665950,8800,24506,821250
94720,90737,1487200,86020,64294.3,665950,8700,26442.7,821250
96880,86082.8,1487200,88370,62815.7,665950,8510,23267.1,821250
99060,88079.6,1487200,90710,63108.9,665950,8350,24970.7,821250
101240,93612.6,1487200,93050,69966.1,665950,8190,23646.5,821250
101830,99789.3,1487200,93960,80667.1,665950,7870,19122.2,821250
102360,96459.9,1487200,94860,77924.8,665950,7500,18535.1,821250
102930,97351.4,1487200,95770,78536.5,665950,7160,18814.9,821250
103460,88706.1,1487200,96690,71503.2,665950,6770,17202.9,821250
103770,92296.3,1487200,97290,77281.4,665950,6480,15014.9,821250
103940,94409.8,1487200,97880,81595.8,665950,6060,12814,821250
104230,105521.9,1487200,98480,92677.6,665950,5750,12844.3,821250
104500,107401.2,1487200,99070,95478.7,665950,5430,11922.5,821250
105230,103879.3,1487200,99320,92639.9,665950,5910,11239.4,821250
105880,104017.8,1487200,99550,94114.8,665950,6330,9903,821250
106590,124569.5,1487200,99800,114857,665950,6790,9712.5,821250
107310,136742.2,1487200,100040,127897,665950,7270,8845.2,821250
109570,149703.1,1487200,101700,141104.7,665950,7870,8598.4,821250
111760,156542,1487200,103340,147470.7,665950,8420,9071.3,821250
113990,165638,1487200,104970,157525.7,665950,9020,8112.3,821250
116170,151903.2,1487200,106610,143376,665950,9560,8527.2,821250
115560,147639.9,1487200,105410,139086.3,665950,10150,8553.6,821250
114990,143616.4,1487200,104240,134369.3,665950,10750,9247.1,821250
114400,137767.5,1487200,103050,126755,665950,11350,11012.5,821250
113830,149575.4,1487200,101870,135625,665950,11960,13950.4,821250
114030,146625.8,1487200,101420,131428.2,665950,12610,15197.6,821250
114300,154455.4,1487200,100970,135991,665950,13330,18464.4,821250
114550,154617.3,1487200,100520,133504.2,665950,14030,21113.1,821250
114760,162372.6,1487200,100060,140274.5,665950,14700,22098.1,821250
116060,165750.4,1487200,100490,140246.2,665950,15570,25504.2,821250
117260,159696,1487200,100910,133098.1,665950,16350,26597.9,821250
118570,149942,1487200,101370,122390.3,665950,17200,27551.7,821250
119820,129723.4,1487200,101810,100899.9,665950,18010,28823.5,821250
119490,117325.2,1487200,100750,88403.6,665950,18740,28921.6,821250
119180,117378.1,1487200,99670,87351.2,665950,19510,30026.9,821250
118890,109011.7,1487200,98640,80266.2,665950,20250,28745.5,821250
118560,107343.1,1487200,97560,78225.8,665950,21000,29117.3,821250
119600,102946.4,1487200,97140,72619.1,665950,22460,30327.3,821250
120580,93023.6,1487200,96730,63032.3,665950,23850,29991.3,821250
121580,101425,1487200,96310,69686.3,665950,25270,31738.7,821250
153390,104420.4,1487200,124290,68658.1,665950,29100,35762.3,821250
150820,101985.1,1487200,120470,66019.7,665950,30350,35965.4,821250
148280,91629.4,1487200,116620,56174.9,665950,31660,35454.5,821250
145760,86351.4,1487200,112790,50259.9,665950,32970,36091.5,821250
143180,84876.5,1487200,108930,50017.9,665950,34250,34858.6,821250
140430,80826,1487200,105190,47186.7,665950,35240,33639.3,821250
137720,84600.5,1487200,101440,52748.2,665950,36280,31852.3,821250
134950,84935.3,1487200,97700,52047,665950,37250,32888.3,821250
132220,90785.1,1487200,93950,55342.1,665950,38270,35443,821250
129960,86990.6,1487200,91550,51443.8,665950,38410,35546.8,821250
127720,81979,1487200,89150,47641,665950,38570,34338,821250
125450,92490.6,1487200,86730,57823.8,665950,38720,34666.8,821250
123200,101830.7,1487200,84340,66337.2,665950,38860,35493.5,821250
121320,98208.5,1487200,82190,64990.9,665950,39130,33217.6,821250
119470,87013.4,1487200,80060,58268.6,665950,39410,28744.8,821250
117540,83843.3,1487200,77900,56939.1,665950,39640,26904.2,821250
115650,86071.4,1487200,75720,59224.8,665950,39930,26846.6,821250
115060,91771.5,1487200,74740,67031.6,665950,40320,24739.9,821250
114480,89131.5,1487200,73720,64009.1,665950,40760,25122.4,821250
113960,79211,1487200,72730,53031.3,665950,41230,26179.7,821250
113460,74926.8,1487200,71740,48268.9,665950,41720,26657.9,821250
111010,69707.2,1487200,70500,43733.3,665950,40510,25973.9,821250
108580,67906.1,1487200,69260,41581.3,665950,39320,26324.8,821250
106160,65996.3,1487200,67990,40679.3,665950,38170,25317,821250
103790,65113.7,1487200,66730,41256.2,665950,37060,23857.5,821250
100960,65415.8,1487200,65180,41110.3,665950,35780,24305.5,821250
98090,74227.1,1487200,63590,49584.9,665950,34500,24642.2,821250
95200,76072.3,1487200,62010,52538.2,665950,33190,23534.1,821250
92280,70004.7,1487200,60430,47806.6,665950,31850,22198.1,821250
89130,76919.4,1487200,58540,54809.8,665950,30590,22109.6,821250
85940,70848.4,1487200,56670,49859.2,665950,29270,20989.2,821250
82710,69372.9,1487200,54770,49453.3,665950,27940,19919.6,821250
79430,70218.8,1487200,52890,50900.7,665950,26540,19318.1,821250
76950,70762.3,1487200,51910,52445.9,665950,25040,18316.4,821250
74470,68340.4,1487200,50900,51037.7,665950,23570,17302.7,821250
71950,65463.1,1487200,49940,50065.4,665950,22010,15397.7,821250
69480,58960.7,1487200,48950,45186.7,665950,20530,13774,821250
67310,50860.7,1487200,48260,37941.8,665950,19050,12918.9,821250
65090,57412.9,1487200,47550,45218.7,665950,17540,12194.2,821250
62880,66662.3,1487200,46850,54408.5,665950,16030,12253.8,821250
60640,67038.9,1487200,46130,54230.5,665950,14510,12808.4,821250
58370,69108.5,1487200,45500,55723.5,665950,12870,13385,821250
56040,70585.2,1487200,44810,58409,665950,11230,12176.2,821250
53710,67053.2,1487200,44120,55894.8,665950,9590,11158.4,821250
51440,60332.5,1487200,43460,50108.8,665950,7980,10223.7,821250
51090,59928.9,1487200,42760,50235.3,665950,8330,9693.6,821250
50580,59546.8,1487200,42030,50039.5,665950,8550,9507.3,821250
50240,67116.8,1487200,41310,57550.6,665950,8930,9566.2,821250
49860,66781,1487200,40620,57779.5,665950,9240,9001.5,821250
49200,65246.1,1487200,39770,55695.1,665950,9430,9551,821250
48570,69586.9,1487200,38970,58988.2,665950,9600,10598.7,821250
48020,61851.3,1487200,38160,51261.5,665950,9860,10589.8,821250
47350,56104.2,1487200,37320,45361.3,665950,10030,10742.9,821250
46500,60624.9,1487200,36210,48543.8,665950,10290,12081.1,821250
45600,67515.8,1487200,35130,54337.7,665950,10470,13178.1,821250
44760,69614.8,1487200,34040,55818.4,665950,10720,13796.4,821250
43890,71828.3,1487200,32930,56828.3,665950,10960,15000,821250
44360,75554.3,1487200,33200,60209,665950,11160,15345.3,821250
44810,78419.6,1487200,33450,62947.2,665950,11360,15472.4,821250
45270,74241.1,1487200,33710,61531.7,665950,11560,12709.4,821250
45700,63052.1,1487200,33950,52114.1,665950,11750,10938,821250
46280,44511,1487200,34280,35240.1,665950,12000,9270.9,821250
46910,44989.7,1487200,34600,35679.2,665950,12310,9310.5,821250
47430,44318.2,1487200,34920,35258.9,665950,12510,9059.3,821250
47920,44358.6,1487200,35240,35300.9,665950,12680,9057.7,821250
48410,36544.4,1487200,35540,28035.9,665950,12870,8508.5,821250
48850,29767.1,1487200,35790,20788.7,665950,13060,8978.4,821250
49320,31095.4,1487200,36120,22481.8,665950,13200,8613.6,821250
49810,35750.2,1487200,36420,26593.7,665950,13390,9156.5,821250
47790,41533.6,1487200,34460,32081.6,665950,13330,9452,821250
45790,44323.7,1487200,32520,34367,665950,13270,9956.7,821250
43720,42045.4,1487200,30560,32628.1,665950,13160,9417.3,821250
41680,45072.3,1487200,28620,35274.5,665950,13060,9797.8,821250
39740,45342.7,1487200,26790,36102.9,665950,12950,9239.8,821250
37790,47899,1487200,24900,37200.1,665950,12890,10698.9,821250
35670,50833.9,1487200,23070,40052.5,665950,12600,10781.4,821250
33730,49336.2,1487200,21210,39781.9,665950,12520,9554.3,821250
31700,36061.1,1487200,19260,26342.1,665950,12440,9719,821250
29670,36400.6,1487200,17320,27362.3,665950,12350,9038.3,821250
27480,31969.6,1487200,15330,23866.2,665950,12150,8103.4,821250
25430,32991,1487200,13380,25117.3,665950,12050,7873.7,821250
24590,34086.2,1487200,12840,23942.3,665950,11750,10143.9,821250
23710,36889,1487200,12340,27156.4,665950,11370,9732.6,821250
22800,32237.2,1487200,11780,21460.4,665950,11020,10776.8,821250
21910,37104.2,1487200,11230,25696.5,665950,10680,11407.7,821250
21160,38558.2,1487200,10780,26021.9,665950,10380,12536.3,821250
20290,37882.5,1487200,10300,25300.4,665950,9990,12582.1,821250
19510,35396.5,1487200,9830,21223.6,665950,9680,14172.9,821250
18560,33815.8,1487200,9330,18599.3,665950,9230,15216.5,821250
17750,31660.5,1487200,8830,15723.6,665950,8920,15936.9,821250
16970,25389.1,1487200,8330,10786.5,665950,8640,14602.6,821250
16130,22456.8,1487200,7840,7782.2,665950,8290,14674.6,821250
15320,19930.6,1487200,7350,6315.8,665950,7970,13614.8,821250
15100,16290.3,1487200,7140,4009.1,665950,7960,12281.2,821250
14780,13939.2,1487200,6950,2744.5,665950,7830,11194.7,821250
14710,12287.4,1487200,6780,2847.4,665950,7930,9440,821250
15950,11285.7,1487200,5290,1997.6,665950,10660,9288.1,821250
15600,11370.8,1487200,5400,2392.5,665950,10200,8978.3,821250
15270,10191.9,1487200,5520,1634.3,665950,9750,8557.6,821250
14920,9822.1,1487200,5640,2148.6,665950,9280,7673.5,821250
14590,10180.4,1487200,5740,3339.9,665950,8850,6840.5,821250
14190,8894.2,1487200,5840,2067.7,665950,8350,6826.5,821250
13940,8257.9,1487200,5990,1644.1,665950,7950,6613.8,821250
13550,7438.5,1487200,6080,1211.4,665950,7470,6227.1,821250
13280,6378.3,1487200,6200,658.6,665950,7080,5719.7,821250
12550,5721.6,1487200,5810,662,665950,6740,5059.6,821250
11870,6002.1,1487200,5410,570.8,665950,6460,5431.3,821250
11120,6075.8,1487200,5050,785.2,665950,6070,5290.6,821250
10370,5882.1,1487200,4640,1002.2,665950,5730,4879.9,821250
9660,5779.3,1487200,4240,871.1,665950,5420,4908.2,821250
8890,5902.3,1487200,3810,1018,665950,5080,4884.3,821250
8130,5457.1,1487200,3390,610.5,665950,4740,4846.6,821250
7350,6211.5,1487200,2970,1793.2,665950,4380,4418.3,821250
6630,7403.9,1487200,2570,2502.4,665950,4060,4901.5,821250
5830,8730.2,1487200,2110,4181.8,665950,3720,4548.4,821250
5030,10418.4,1487200,1700,5917.1,665950,3330,4501.3,821250
4290,11281,1487200,1260,7621.7,665950,3030,3659.3,821250
4150,10278.9,1487200,1260,6961.3,665950,2890,3317.6,821250
4020,8969.9,1487200,1250,5669.3,665950,2770,3300.6,821250
3850,6927.8,1487200,1250,3521.2,665950,2600,3406.6,821250
3700,5536.6,1487200,1240,1966.5,665950,2460,3570.1,821250
3570,6303.9,1487200,1230,2816.5,665950,2340,3487.4,821250
3420,8155.3,1487200,1230,4108.8,665950,2190,4046.5,821250
3240,8587.1,1487200,1230,4596.2,665950,2010,3990.9,821250
3120,9983.2,1487200,1240,6159.7,665950,1880,3823.5,821250
2920,18411.9,1487200,1210,14668.4,665950,1710,3743.5,821250
2800,26633.8,1487200,1200,23042.4,665950,1600,3591.4,821250
2630,36107.7,1487200,1150,31599.5,665950,1480,4508.2,821250
2440,39375.2,1487200,1130,33848.4,665950,1310,5526.8,821250
2370,33805.7,1487200,1150,28246.7,665950,1220,5559,821250
2320,36964.8,1487200,1170,31746.4,665950,1150,5218.4,821250
2270,32944.9,1487200,1210,27665.4,665950,1060,5279.5,821250
2250,31928.6,1487200,1240,25946.9,665950,1010,5981.7,821250
2240,26266,1487200,1290,20794,665950,950,5472,821250
2180,18745.7,1487200,1340,13981.8,665950,840,4763.9,821250
2180,19385.7,1487200,1400,14737.9,665950,780,4647.8,821250
2150,22429.7,1487200,1460,17720.9,665950,690,4708.8,821250
2130,21070.9,1487200,1520,16515.7,665950,610,4555.2,821250
2110,22097.5,1487200,1610,16799.9,665950,500,5297.6,821250
2130,19939.7,1487200,1670,13290,665950,460,6649.7,821250
2110,17332.8,1487200,1750,10875.6,665950,360,6457.2,821250
2030,15039.7,1487200,1650,8697.3,665950,380,6342.4,821250
1960,12759.5,1487200,1570,6817.6,665950,390,5941.9,821250
1890,8118.7,1487200,1480,2329.5,665950,410,5789.2,821250
1830,7769.6,1487200,1380,1942.3,665950,450,5827.3,821250
1730,7745.9,1487200,1290,1967.2,665950,440,5778.7,821250
1680,7841.1,1487200,1210,1992.6,665950,470,5848.5,821250
1560,7334.5,1487200,1120,1758.1,665950,440,5576.4,821250
1520,7634.3,1487200,1030,1697.8,665950,490,5936.5,821250
1390,6915.6,1487200,870,1495.7,665950,520,5419.9,821250
1270,6887.3,1487200,760,1455.4,665950,510,5431.9,821250
1160,6442.9,1487200,610,1241.6,665950,550,5201.3,821250
1050,6260,1487200,470,1260.7,665950,580,4999.3,821250
1140,6872.5,1487200,420,1508.6,665950,720,5363.9,821250
1280,6623.3,1487200,360,1435.8,665950,920,5187.5,821250
1370,7257.6,1487200,300,1455.6,665950,1070,5802,821250
1460,7382.8,1487200,260,1630,665950,1200,5752.8,821250
1670,7919.4,1487200,300,1734.9,665950,1370,6184.5,821250
1850,7712.6,1487200,310,1560.8,665950,1540,6151.8,821250
2020,7441.7,1487200,320,1347.4,665950,1700,6094.3,821250
2240,6850.6,1487200,320,1210.8,665950,1920,5639.8,821250
2610,9249.1,1487200,370,1599.6,665950,2240,7649.5,821250
2890,8560.7,1487200,410,1745.2,665950,2480,6815.5,821250
3230,7789.7,1487200,430,1615.9,665950,2800,6173.8,821250
3540,7472,1487200,490,1333.5,665950,3050,6138.5,821250
4970,6183.4,1487200,740,1321,665950,4230,4862.4,821250
6350,6694.2,1487200,980,1567,665950,5370,5127.2,821250
7730,6415,1487200,1230,1694,665950,6500,4721,821250
9110,8309.9,1487200,1460,1294,665950,7650,7015.9,821250
10620,10355.6,1487200,1700,1566.8,665950,8920,8788.8,821250
12120,11851.8,1487200,1930,1955.6,665950,10190,9896.2,821250
13660,12337.6,1487200,2160,2024.7,665950,11500,10312.9,821250
15170,16265.7,1487200,2390,2634.5,665950,12780,13631.2,821250
16710,26155.1,1487200,2660,4342.3,665950,14050,21812.8,821250
18120,35541.8,1487200,2900,7179.6,665950,15220,28362.2,821250
19630,45435,1487200,3170,9119.8,665950,16460,36315.2,821250
21120,50605.8,1487200,3430,9966.3,665950,17690,40639.5,821250
22570,58532.3,1487200,3890,11555.5,665950,18680,46976.8,821250
23990,59089.5,1487200,4320,11547.1,665950,19670,47542.4,821250
25420,66284.1,1487200,4770,12678.6,665950,20650,53605.5,821250
26860,74118.2,1487200,5230,13561.5,665950,21630,60556.7,821250
28120,83683.9,1487200,5680,14638.3,665950,22440,69045.6,821250
29430,93855,1487200,6140,17031.8,665950,23290,76823.2,821250
30700,101067.3,1487200,6610,16945.4,665950,24090,84121.9,821250
32020,101172,1487200,7080,16250.3,665950,24940,84921.7,821250
33150,105933.3,1487200,7580,19694.3,665950,25570,86239,821250
34210,103431,1487200,8060,19866.5,665950,26150,83564.5,821250
35320,102087.3,1487200,8550,20501.3,665950,26770,81586,821250
36490,102937.3,1487200,9060,22485.6,665950,27430,80451.7,821250
37090,106564.1,1487200,9000,24096.1,665950,28090,82468,821250
37740,110228.2,1487200,8950,25231.1,665950,28790,84997.1,821250
38430,118433.7,1487200,8880,27582,665950,29550,90851.7,821250
24060,124251.8,1487200,5120,26955.2,665950,18940,97296.6,821250
24070,130305.7,1487200,5240,25706.7,665950,18830,104599,821250
23960,134491.4,1487200,5340,26639.7,665950,18620,107851.7,821250
23920,126534.8,1487200,5460,25498.2,665950,18460,101036.6,821250
23780,117623.2,1487200,5520,24489.1,665950,18260,93134.1,821250
23000,105789.3,1487200,5010,22742.4,665950,17990,83046.9,821250
22160,97375.4,1487200,4440,21138.1,665950,17720,76237.3,821250
21380,98265.3,1487200,3950,20047.4,665950,17430,78217.9,821250
20510,92257.3,1487200,3400,17615.6,665950,17110,74641.7,821250
19250,93280.6,1487200,3200,18077.1,665950,16050,75203.5,821250
18010,88836.4,1487200,2990,15751.8,665950,15020,73084.6,821250
16790,83007,1487200,2800,13384.8,665950,13990,69622.2,821250
15540,79727,1487200,2590,14474.2,665950,12950,65252.8,821250
14320,78375.6,1487200,2560,16199.2,665950,11760,62176.4,821250
13110,75640.9,1487200,2510,18143.2,665950,10600,57497.7,821250
11880,83322.1,1487200,2460,22819.6,665950,9420,60502.5,821250
10670,83111.6,1487200,2410,22254.1,665950,8260,60857.5,821250
9390,73309.9,1487200,2130,19095.3,665950,7260,54214.6,821250
8100,67399.6,1487200,1830,16272.7,665950,6270,51126.9,821250
6870,62890.2,1487200,1540,16032.3,665950,5330,46857.9,821250
5550,51377.8,1487200,1250,11010.8,665950,4300,40367,821250
5640,47798.9,1487200,1380,11553.1,665950,4260,36245.8,821250
5880,44892.4,1487200,1550,10793.9,665950,4330,34098.5,821250
6040,41210.7,1487200,1700,10617.5,665950,4340,30593.2,821250
6110,37762,1487200,1850,9345.1,665950,4260,28416.9,821250
6200,38190.5,1487200,1920,10590.4,665950,4280,27600.1,821250
6290,38076.5,1487200,2010,10774.7,665950,4280,27301.8,821250
6430,33196.9,1487200,2100,9644.1,665950,4330,23552.8,821250
6500,31321.5,1487200,2180,9149.2,665950,4320,22172.3,821250
6600,31722.9,1487200,2250,8921.3,665950,4350,22801.6,821250
6640,34150.6,1487200,2320,9319.5,665950,4320,24831.1,821250
6640,37826.7,1487200,2390,11169.1,665950,4250,26657.6,821250
6700,38357.9,1487200,2460,11145.5,665950,4240,27212.4,821250
6920,40604.7,1487200,2880,12487.7,665950,4040,28117,821250
7130,46416.3,1487200,3290,17181.1,665950,3840,29235.2,821250
7430,44845.8,1487200,3760,15498.6,665950,3670,29347.2,821250
7670,40337.2,1487200,4180,12469.8,665950,3490,27867.4,821250
7190,35123.1,1487200,3940,9862.9,665950,3250,25260.2,821250
6690,29322.9,1487200,3660,8116,665950,3030,21206.9,821250
6180,22702.9,1487200,3410,5347.4,665950,2770,17355.5,821250
5680,17117.8,1487200,3150,3064,665950,2530,14053.8,821250
5140,12644.3,1487200,3000,2156.7,665950,2140,10487.6,821250
4620,10236.1,1487200,2860,1752.9,665950,1760,8483.2,821250
4100,8457.5,1487200,2740,1700.5,665950,1360,6757,821250
3550,7702.2,1487200,2580,1646.6,665950,970,6055.6,821250
3580,7745.9,1487200,2510,1663.6,665950,1070,6082.3,821250
3660,7853.3,1487200,2460,1618.8,665950,1200,6234.5,821250
3760,7195.6,1487200,2400,1363.7,665950,1360,5831.9,821250
3850,6934.5,1487200,2340,1330.9,665950,1510,5603.6,821250
3740,6552.6,1487200,2120,1159.3,665950,1620,5393.3,821250
3550,6660.9,1487200,1900,1163.8,665950,1650,5497.1,821250
3470,7023.7,1487200,1700,1189.9,665950,1770,5833.8,821250
3340,7175.2,1487200,1490,1207.7,665950,1850,5967.5,821250
3190,7396.8,1487200,1350,1240.5,665950,1840,6156.3,821250
3070,7680.5,1487200,1190,1273.2,665950,1880,6407.3,821250
2940,9407.9,1487200,1080,2177.6,665950,1860,7230.3,821250
2840,10270.3,1487200,940,2493.7,665950,1900,7776.6,821250
3080,9517,1487200,1060,2287.9,665950,2020,7229.1,821250
3330,9219,1487200,1200,2242,665950,2130,6977,821250
3520,12186.3,1487200,1330,4505.6,665950,2190,7680.7,821250
3790,16033.2,1487200,1470,8814.7,665950,2320,7218.5,821250
4240,18604.9,1487200,1760,11257.6,665950,2480,7347.3,821250
4650,19419.8,1487200,2050,11996.9,665950,2600,7422.9,821250
5140,17678.4,1487200,2350,10308.4,665950,2790,7370,821250
5530,15684.1,1487200,2630,9308.7,665950,2900,6375.4,821250
7260,18602.4,1487200,4130,12019.8,665950,3130,6582.6,821250
9020,18052.5,1487200,5680,10976.8,665950,3340,7075.7,821250
10770,18871.6,1487200,7200,11632.7,665950,3570,7238.9,821250
12530,19066.6,1487200,8760,11850.4,665950,3770,7216.2,821250
19180,20434.3,1487200,13290,12570.7,665950,5890,7863.6,821250
25860,23670.4,1487200,17890,15322.5,665950,7970,8347.9,821250
32540,24206.2,1487200,22440,14797.9,665950,10100,9408.3,821250
39240,24179.4,1487200,27010,13844,665950,12230,10335.4,821250
45600,24938.9,1487200,31100,14224.1,665950,14500,10714.8,821250
51900,27594.2,1487200,35190,15520.2,665950,16710,12074,821250
58290,33515.9,1487200,39290,18504.7,665950,19000,15011.2,821250
64600,42766.8,1487200,43380,25543.2,665950,21220,17223.6,821250
70970,48473.2,1487200,47600,27991.6,665950,23370,20481.6,821250
77370,59117.3,1487200,51850,34078.7,665950,25520,25038.6,821250
83780,83991.1,1487200,56100,51460.9,665950,27680,32530.2,821250
90180,87806.7,1487200,60340,50052.1,665950,29840,37754.6,821250
96270,85961.4,1487200,63000,44302.4,665950,33270,41659,821250
102330,93276.8,1487200,65670,48299.8,665950,36660,44977,821250
108380,106178.2,1487200,68350,59724.8,665950,40030,46453.4,821250
114500,117549.7,1487200,71030,70339,665950,43470,47210.7,821250
119450,116955.3,1487200,72440,71236.6,665950,47010,45718.7,821250
124260,121804.1,1487200,73820,72384.1,665950,50440,49420,821250
129260,121155.2,1487200,75240,69961.5,665950,54020,51193.7,821250
134120,122585.9,1487200,76600,69559.6,665950,57520,53026.3,821250
139570,127699.5,1487200,78820,74751.4,665950,60750,52948.1,821250
145080,140411.5,1487200,81060,88342.2,665950,64020,52069.3,821250
150610,148193.5,1487200,83290,98955,665950,67320,49238.5,821250
156060,154234.6,1487200,85500,105090.2,665950,70560,49144.4,821250
155530,156057.1,1487200,84470,105048,665950,71060,51009.1,821250
154940,150770.4,1487200,83460,100663.5,665950,71480,50106.9,821250
154450,139835.4,1487200,82450,93988.3,665950,72000,45847.1,821250
71700,129871.9,1487200,26880,90287.3,665950,44820,39584.6,821250
70750,124909.2,1487200,26380,84700,665950,44370,40209.2,821250
69790,122465.3,1487200,25880,78727,665950,43910,43738.3,821250
68720,134520.5,1487200,25350,91756.6,665950,43370,42763.9,821250
67790,146631.8,1487200,24870,104986.7,665950,42920,41645.1,821250
65600,160741.2,1487200,23200,115142.3,665950,42400,45598.9,821250
63380,142067.8,1487200,21510,99454.3,665950,41870,42613.5,821250
61200,123804.3,1487200,19850,81794,665950,41350,42010.3,821250
59030,106851.1,1487200,18190,65275.8,665950,40840,41575.3,821250
55750,91679.8,1487200,16910,53961.3,665950,38840,37718.5,821250
52520,91645,1487200,15630,55775.1,665950,36890,35869.9,821250
49250,92866.2,1487200,14360,59110.5,665950,34890,33755.7,821250
46070,88415.6,1487200,13110,57252.3,665950,32960,31163.3,821250
43420,85632.9,1487200,12280,53943.7,665950,31140,31689.2,821250
40740,75734.2,1487200,11450,43786.5,665950,29290,31947.7,821250
38010,62952.5,1487200,10660,32416.1,665950,27350,30536.4,821250
35320,53441,1487200,9820,26959.8,665950,25500,26481.2,821250
32990,45413.9,1487200,9150,22230.4,665950,23840,23183.5,821250
30620,40553,1487200,8450,15223.7,665950,22170,25329.3,821250
28280,35605.2,1487200,7800,8670.4,665950,20480,26934.8,821250
25970,29616.8,1487200,7120,5239.9,665950,18850,24376.9,821250
24380,29206.8,1487200,6630,4750.1,665950,17750,24456.7,821250
22720,28191.6,1487200,6130,3909,665950,16590,24282.6,821250
21150,28478.2,1487200,5660,3203.7,665950,15490,25274.5,821250
19500,28860.2,1487200,5180,2666.1,665950,14320,26194.1,821250
18020,29411.9,1487200,4730,2285.2,665950,13290,27126.7,821250
16480,32591.6,1487200,4270,3497.6,665950,12210,29094,821250
14920,33857.7,1487200,3820,3577.9,665950,11100,30279.8,821250
13380,33876.4,1487200,3340,3250.6,665950,10040,30625.8,821250
11930,32267.5,1487200,2880,3598.6,665950,9050,28668.9,821250
10490,31887.5,1487200,2440,3842.1,665950,8050,28045.4,821250
9060,32376.1,1487200,1990,3403.2,665950,7070,28972.9,821250
7640,31795.8,1487200,1580,3148.9,665950,6060,28646.9,821250
7000,31217.4,1487200,1450,3091.5,665950,5550,28125.9,821250
6520,29360.5,1487200,1340,2996.2,665950,5180,26364.3,821250
6020,29422.9,1487200,1230,3166.3,665950,4790,26256.6,821250
5450,29642.7,1487200,1120,3406,665950,4330,26236.7,821250
4820,25439.5,1487200,980,3074.7,665950,3840,22364.8,821250
4290,24836.4,1487200,860,3157.1,665950,3430,21679.3,821250
3500,20179.2,1487200,690,2636.5,665950,2810,17542.7,821250
2920,16572.5,1487200,570,2294.9,665950,2350,14277.6,821250
2350,10481.8,1487200,460,1939.6,665950,1890,8542.2,821250
1790,8822.8,1487200,320,1822.6,665950,1470,7000.2,821250
1150,5999.4,1487200,210,1588.1,665950,940,4411.3,821250
670,6061.9,1487200,110,1671.4,665950,560,4390.5,821250
790,5632.6,1487200,150,1653.2,665950,640,3979.4,821250
890,5147.8,1487200,200,1620.6,665950,690,3527.2,821250
1000,5115.9,1487200,250,1582.9,665950,750,3533,821250
1180,3795.4,1487200,320,1122.8,665950,860,2672.6,821250
1260,4839.4,1487200,330,1559.1,665950,930,3280.3,821250
1330,4856,1487200,340,1538.4,665950,990,3317.6,821250
1380,4847.4,1487200,340,1534.1,665950,1040,3313.3,821250
1460,5670.4,1487200,350,1519.8,665950,1110,4150.6,821250
1490,5234,1487200,320,1512.3,665950,1170,3721.7,821250
1540,4704.4,1487200,300,1329.7,665950,1240,3374.7,821250
1590,4257,1487200,270,1068.6,665950,1320,3188.4,821250
1610,4656.1,1487200,240,1367.3,665950,1370,3288.8,821250
1750,7481.5,1487200,290,1967.7,665950,1460,5513.8,821250
1990,9389.3,1487200,320,2133.6,665950,1670,7255.7,821250
2180,12780.9,1487200,360,2416.8,665950,1820,10364.1,821250
2400,16983.1,1487200,400,3480.4,665950,2000,13502.7,821250
2760,19946.3,1487200,530,4098.9,665950,2230,15847.4,821250
3090,22196.6,1487200,630,3944.9,665950,2460,18251.7,821250
3370,23866.5,1487200,720,3284.1,665950,2650,20582.4,821250
3790,23442.3,1487200,870,3318.2,665950,2920,20124.1,821250
3990,20817.9,1487200,870,3338.4,665950,3120,17479.5,821250
4310,23086.7,1487200,900,3217.3,665950,3410,19869.4,821250
4560,22037.4,1487200,910,2964.1,665950,3650,19073.3,821250
4820,22668.2,1487200,910,3264.2,665950,3910,19404,821250
6340,21548.1,1487200,1280,3774.8,665950,5060,17773.3,821250
7830,26154,1487200,1670,5228.3,665950,6160,20925.7,821250
9310,28785,1487200,2020,5475.7,665950,7290,23309.3,821250
10820,30874.2,1487200,2410,6824.9,665950,8410,24049.3,821250
12220,25925.8,1487200,2520,5304.9,665950,9700,20620.9,821250
13650,26553.6,1487200,2620,4792,665950,11030,21761.6,821250
15060,32678.6,1487200,2760,4869.3,665950,12300,27809.3,821250
16470,37376.5,1487200,2840,6707.7,665950,13630,30668.8,821250
17620,40642.2,1487200,2930,8300.9,665950,14690,32341.3,821250
18850,37381.5,1487200,3020,6888.1,665950,15830,30493.4,821250
19960,37289.5,1487200,3070,8298.7,665950,16890,28990.8,821250
21140,33482.7,1487200,3160,7186.8,665950,17980,26295.9,821250
20330,32779.2,1487200,3040,5196.9,665950,17290,27582.3,821250
19520,31823.8,1487200,2890,4324.9,665950,16630,27498.9,821250
18620,32927.3,1487200,2740,4823.4,665950,15880,28103.9,821250
17830,30075.8,1487200,2610,4944.8,665950,15220,25131,821250
17270,27243.5,1487200,2590,3880.3,665950,14680,23363.2,821250
16680,27748.8,1487200,2570,3792.6,665950,14110,23956.2,821250
15970,33436.5,1487200,2540,5110.2,665950,13430,28326.3,821250
15340,29419.5,1487200,2530,4822.9,665950,12810,24596.6,821250
14320,31334,1487200,2280,5651.5,665950,12040,25682.5,821250
13340,35438.2,1487200,2050,6576.1,665950,11290,28862.1,821250
12330,33664,1487200,1830,7098.7,665950,10500,26565.3,821250
11290,29934.3,1487200,1550,4919.3,665950,9740,25015,821250
10800,30389.9,1487200,1540,4460,665950,9260,25929.9,821250
10420,29953.9,1487200,1520,5888.4,665950,8900,24065.5,821250
9970,32727.6,1487200,1500,8024.4,665950,8470,24703.2,821250
24100,27002.1,1487200,8090,6469.5,665950,16010,20532.6,821250
24680,22197.2,1487200,7720,6079.7,665950,16960,16117.5,821250
25230,23960.8,1487200,7370,7154.3,665950,17860,16806.5,821250
25740,29678.3,1487200,6980,9011.7,665950,18760,20666.6,821250
26180,27929.5,1487200,6560,8341.7,665950,19620,19587.8,821250
26690,29896.5,1487200,6870,8043.8,665950,19820,21852.7,821250
27140,41638.8,1487200,7160,13499.8,665950,19980,28139,821250
27550,57456.6,1487200,7420,21814.7,665950,20130,35641.9,821250
28080,56951.7,1487200,7720,21836.7,665950,20360,35115,821250
27660,54317.9,1487200,8110,22785.6,665950,19550,31532.3,821250
27290,56508.4,1487200,8500,26176,665950,18790,30332.4,821250
26870,57282,1487200,8900,27138.2,665950,17970,30143.8,821250
26540,65576.7,1487200,9310,32861.1,665950,17230,32715.6,821250
26240,71605.8,1487200,9610,36991.3,665950,16630,34614.5,821250
25870,70267.9,1487200,9940,33597.8,665950,15930,36670.1,821250
25600,70593.1,1487200,10260,36209,665950,15340,34384.1,821250
25330,86299.6,1487200,10590,53658,665950,14740,32641.6,821250
24590,78114.8,1487200,10490,49890.2,665950,14100,28224.6,821250
23980,78842.7,1487200,10430,46465.4,665950,13550,32377.3,821250
23270,122005.5,1487200,10350,87834.4,665950,12920,34171.1,821250
22570,113359.6,1487200,10250,82141.4,665950,12320,31218.2,821250
24020,115603.2,1487200,11730,84283.6,665950,12290,31319.6,821250
25470,159898.2,1487200,13200,127663,665950,12270,32235.2,821250
26840,180765.6,1487200,14640,148498.7,665950,12200,32266.9,821250
28200,202067.4,1487200,16120,170989.2,665950,12080,31078.2,821250
29250,208217.5,1487200,17390,172445.8,665950,11860,35771.7,821250
30330,215842.4,1487200,18640,175963.6,665950,11690,39878.8,821250
31370,219025.1,1487200,19900,176753.5,665950,11470,42271.6,821250
32440,216611.2,1487200,21140,174025.9,665950,11300,42585.3,821250
33870,202167.3,1487200,22680,164202.9,665950,11190,37964.4,821250
35420,201386.6,1487200,24210,167484.8,665950,11210,33901.8,821250
36920,202255.8,1487200,25730,166092.4,665950,11190,36163.4,821250
38390,215444,1487200,27270,182066.8,665950,11120,33377.2,821250
38560,208893.3,1487200,27570,171647.8,665950,10990,37245.5,821250
38820,180525.2,1487200,27900,145383,665950,10920,35142.2,821250
39010,165018.4,1487200,28220,132718.5,665950,10790,32299.9,821250
39300,158434.7,1487200,28540,125890.6,665950,10760,32544.1,821250
37300,151486.7,1487200,27080,118652.7,665950,10220,32834,821250
35320,139584,1487200,25650,108216.1,665950,9670,31367.9,821250
33350,118734,1487200,24190,94275.2,665950,9160,24458.8,821250
31340,114862.4,1487200,22750,90918.7,665950,8590,23943.7,821250
29030,120442.3,1487200,20580,92372.5,665950,8450,28069.8,821250
26770,121656.7,1487200,18430,94592.5,665950,8340,27064.2,821250
24430,110782.2,1487200,16260,84594.6,665950,8170,26187.6,821250
22060,114959.1,1487200,14100,95648.5,665950,7960,19310.6,821250
20740,117058.3,1487200,13230,100123.2,665950,7510,16935.1,821250
19450,110471.3,1487200,12360,94239.4,665950,7090,16231.9,821250
18180,113559.7,1487200,11490,96483.9,665950,6690,17075.8,821250
16820,115060.7,1487200,10630,88563.2,665950,6190,26497.5,821250
15720,110025.7,1487200,9920,85049,665950,5800,24976.7,821250
14660,109149.2,1487200,9210,88167.9,665950,5450,20981.3,821250
13560,108905.1,1487200,8500,92437.4,665950,5060,16467.7,821250
12460,111410.5,1487200,7800,95159.5,665950,4660,16251,821250
11230,107739.4,1487200,7080,94117.4,665950,4150,13622,821250
10010,91062,1487200,6400,78047,665950,3610,13015,821250
8790,101423.7,1487200,5680,85362.9,665950,3110,16060.8,821250
7530,110792.1,1487200,4980,92948.6,665950,2550,17843.5,821250
7650,111540.1,1487200,4960,94119,665950,2690,17421.1,821250
7680,109515.4,1487200,4930,92133.7,665950,2750,17381.7,821250
7740,110110.5,1487200,4910,90375.6,665950,2830,19734.9,821250
7810,106981.7,1487200,4880,91640.2,665950,2930,15341.5,821250
8100,103434.5,1487200,5000,90903.5,665950,3100,12531,821250
8420,98908.9,1487200,5110,87433.5,665950,3310,11475.4,821250
8680,92105.8,1487200,5210,81619.7,665950,3470,10486.1,821250
9040,85374,1487200,5350,73591.2,665950,3690,11782.8,821250
9260,86078.9,1487200,5270,72799.8,665950,3990,13279.1,821250
9500,81324.2,1487200,5210,66734.4,665950,4290,14589.8,821250
9660,78669.9,1487200,5140,62135.5,665950,4520,16534.4,821250
9910,78046.7,1487200,5080,61533.3,665950,4830,16513.4,821250
15520,84083.6,1487200,7370,68132.4,665950,8150,15951.2,821250
21240,90158,1487200,9660,75263.9,665950,11580,14894.1,821250
26890,88682.9,1487200,11960,74288.1,665950,14930,14394.8,821250
32480,81110.6,1487200,14280,66337.6,665950,18200,14773,821250
39380,80325.2,1487200,17220,65051.4,665950,22160,15273.8,821250
46290,87954.4,1487200,20180,71076.8,665950,26110,16877.6,821250
53180,87290.5,1487200,23130,65688.4,665950,30050,21602.1,821250
60030,92283.7,1487200,26050,67458.6,665950,33980,24825.1,821250
67120,99740.6,1487200,29190,73033.2,665950,37930,26707.4,821250
74140,104218.2,1487200,32340,74333.7,665950,41800,29884.5,821250
81200,112764.8,1487200,35480,80198.8,665950,45720,32566,821250
88300,117760.8,1487200,38660,85875.3,665950,49640,31885.5,821250
94460,115919.5,1487200,42290,86738.4,665950,52170,29181.1,821250
100690,105564.1,1487200,45940,78397.1,665950,54750,27167,821250
106900,90197.6,1487200,49590,66189.6,665950,57310,24008,821250
113060,98961.2,1487200,53240,67507.8,665950,59820,31453.4,821250
117160,121635.4,1487200,55500,74600.5,665950,61660,47034.9,821250
121420,142840.6,1487200,57790,82801.7,665950,63630,60038.9,821250
125580,173640.3,1487200,60050,106247.3,665950,65530,67393,821250
129780,197336.2,1487200,62320,126818.7,665950,67460,70517.5,821250
133950,212688.5,1487200,65020,141361,665950,68930,71327.5,821250
138120,249639.4,1487200,67730,174085.7,665950,70390,75553.7,821250
142230,254616.8,1487200,70430,172836.4,665950,71800,81780.4,821250
146430,254215.5,1487200,73130,169729.9,665950,73300,84485.6,821250
150870,254437,1487200,77350,170205.8,665950,73520,84231.2,821250
155360,259407.8,1487200,81570,168893.2,665950,73790,90514.6,821250
159850,257670.3,1487200,85810,168591,665950,74040,89079.3,821250
196350,247482.8,1487200,121600,160440.7,665950,74750,87042.1,821250
196760,240134,1487200,121640,152885.8,665950,75120,87248.2,821250
197230,229365.6,1487200,121640,149191.9,665950,75590,80173.7,821250
197570,230028.3,1487200,121650,152843.1,665950,75920,77185.2,821250
197920,210311.8,1487200,121660,136896.1,665950,76260,73415.7,821250
198000,214249.3,1487200,121140,140161.5,665950,76860,74087.8,821250
197990,218739.6,1487200,120630,147686.6,665950,77360,71053,821250
198040,206737.1,1487200,120130,140934.8,665950,77910,65802.3,821250
198020,191301.2,1487200,119610,128354.5,665950,78410,62946.7,821250
195380,181086.8,1487200,117810,116719.3,665950,77570,64367.5,821250
192760,179573,1487200,116010,118437.3,665950,76750,61135.7,821250
190130,186829.5,1487200,114200,131482.5,665950,75930,55347,821250
187510,161595.3,1487200,112380,112812,665950,75130,48783.3,821250
185000,152687.1,1487200,110420,107604.4,665950,74580,45082.7,821250
182390,150518.3,1487200,108450,107579.4,665950,73940,42938.9,821250
179800,149469.3,1487200,106490,106898.2,665950,73310,42571.1,821250
177270,146398.8,1487200,104510,107527.2,665950,72760,38871.6,821250
174560,144580.9,1487200,103010,105851.9,665950,71550,38729,821250
171930,155120,1487200,101500,115605.8,665950,70430,39514.2,821250
169290,136936.4,1487200,99980,100383.7,665950,69310,36552.7,821250
166610,111444.3,1487200,98470,79031.6,665950,68140,32412.7,821250
161700,99956.5,1487200,94660,70612.1,665950,67040,29344.4,821250
156710,90221.7,1487200,90810,62941.8,665950,65900,27279.9,821250
151810,110893,1487200,87010,85275.8,665950,64800,25617.2,821250
146810,116466.5,1487200,83180,92022,665950,63630,24444.5,821250
143500,109020,1487200,80160,86776.8,665950,63340,22243.2,821250
140170,102972.7,1487200,77200,79606.8,665950,62970,23365.9,821250
136850,84995.7,1487200,74250,61017.9,665950,62600,23977.8,821250
133560,75221.5,1487200,71260,50385.2,665950,62300,24836.3,821250
130280,74913,1487200,68510,49449,665950,61770,25464,821250
126960,75236.5,1487200,65740,50991.7,665950,61220,24244.8,821250
123680,79696.4,1487200,62970,54421.1,665950,60710,25275.3,821250
120440,80836.1,1487200,60230,56207.4,665950,60210,24628.7,821250
116130,83616.6,1487200,58840,59638,665950,57290,23978.6,821250
111790,72072.5,1487200,57440,48480.5,665950,54350,23592,821250
107420,67546.2,1487200,56050,45449.7,665950,51370,22096.5,821250
103200,63011.9,1487200,54670,41846.9,665950,48530,21165,821250
100210,61009,1487200,55670,40589.9,665950,44540,20419.1,821250
97210,58696.6,1487200,56660,40147.9,665950,40550,18548.7,821250
94230,54872.4,1487200,57610,37353.3,665950,36620,17519.1,821250
91230,60876.2,1487200,58590,43617,665950,32640,17259.2,821250
89070,69854,1487200,60490,54183.2,665950,28580,15670.8,821250
87000,70594.6,1487200,62350,55965.2,665950,24650,14629.4,821250
84880,71425,1487200,64250,58495.2,665950,20630,12929.8,821250
82750,79851.2,1487200,66140,67297.9,665950,16610,12553.3,821250
80480,88805.7,1487200,63440,74321.5,665950,17040,14484.2,821250
78220,90938.1,1487200,60740,75174.6,665950,17480,15763.5,821250
76010,88323.4,1487200,58050,72861.9,665950,17960,15461.5,821250
73780,83964.7,1487200,55340,68535,665950,18440,15429.7,821250
72080,87698.5,1487200,53460,70883.2,665950,18620,16815.3,821250
70340,69714.2,1487200,51540,54022.9,665950,18800,15691.3,821250
68640,60755.4,1487200,49610,46429.3,665950,19030,14326.1,821250
66910,57477.6,1487200,47710,43747.3,665950,19200,13730.3,821250
66640,49242.7,1487200,47060,36186.1,665950,19580,13056.6,821250
66380,44124.7,1487200,46410,30772.9,665950,19970,13351.8,821250
66040,41778,1487200,45780,28972.3,665950,20260,12805.7,821250
65720,41390.7,1487200,45130,26314.1,665950,20590,15076.6,821250
65800,43162.8,1487200,44980,27716.7,665950,20820,15446.1,821250
66020,47985.1,1487200,44860,31835.5,665950,21160,16149.6,821250
66100,47838.1,1487200,44710,30240.5,665950,21390,17597.6,821250
66210,51246.5,1487200,44570,32260.6,665950,21640,18985.9,821250
67590,43187.2,1487200,45410,23134.9,665950,22180,20052.3,821250
69090,42108.6,1487200,46240,20086.1,665950,22850,22022.5,821250
70460,50071.8,1487200,47070,24267.6,665950,23390,25804.2,821250
71930,55243.9,1487200,47910,29190.6,665950,24020,26053.3,821250
74180,50297.1,1487200,49340,23493.4,665950,24840,26803.7,821250
76430,54164.8,1487200,50760,27043,665950,25670,27121.8,821250
78680,68164.8,1487200,52160,38040.2,665950,26520,30124.6,821250
80900,71243.7,1487200,53590,40240.8,665950,27310,31002.9,821250
94480,78181.8,1487200,61020,43270.6,665950,33460,34911.2,821250
108150,84183.1,1487200,68480,44624.3,665950,39670,39558.8,821250
121710,93020.7,1487200,75910,50016.2,665950,45800,43004.5,821250
135310,103468,1487200,83360,53188.7,665950,51950,50279.3,821250
146950,121541.1,1487200,88790,67720.3,665950,58160,53820.8,821250
158630,126615.4,1487200,94210,70299.5,665950,64420,56315.9,821250
170240,150406.2,1487200,99630,85756.4,665950,70610,64649.8,821250
181940,167198.6,1487200,105040,91605.4,665950,76900,75593.2,821250
196060,179749.7,1487200,112620,92681.7,665950,83440,87068,821250
210210,203001.5,1487200,120190,103430,665950,90020,99571.5,821250
224260,223193.9,1487200,127770,109252.8,665950,96490,113941.1,821250
238430,240419.5,1487200,135360,109747.2,665950,103070,130672.3,821250
247610,252514.9,1487200,141350,106983.3,665950,106260,145531.6,821250
256820,253617.3,1487200,147320,103271.9,665950,109500,150345.4,821250
266080,270694.6,1487200,153350,121363.8,665950,112730,149330.8,821250
275350,271401.9,1487200,159330,123615.1,665950,116020,147786.8,821250
283270,292180.4,1487200,164090,138902.6,665950,119180,153277.8,821250
291270,321116.6,1487200,168810,163303.8,665950,122460,157812.8,821250
299220,351521.5,1487200,173570,187395.3,665950,125650,164126.2,821250
307240,357447.4,1487200,178300,190569.9,665950,128940,166877.5,821250
314290,359541.2,1487200,182000,191685.6,665950,132290,167855.6,821250
321300,362931.7,1487200,185690,199297.3,665950,135610,163634.4,821250
328290,394434.2,1487200,189400,230884.2,665950,138890,163550,821250
335270,403335,1487200,193100,239411.1,665950,142170,163923.9,821250
332980,385075.9,1487200,192040,223414.1,665950,140940,161661.8,821250
330640,371344.8,1487200,190980,211618.8,665950,139660,159726,821250
328420,346283.5,1487200,189970,188363.8,665950,138450,157919.7,821250
371650,356958.1,1487200,215170,194350.7,665950,156480,162607.4,821250
364280,378218.2,1487200,210240,214809.9,665950,154040,163408.3,821250
356840,347281.5,1487200,205250,202653.1,665950,151590,144628.4,821250
349500,325567.8,1487200,200320,188967.5,665950,149180,136600.3,821250
342080,314587,1487200,195330,183345.2,665950,146750,131241.8,821250
333500,320691.3,1487200,189190,190596.3,665950,144310,130095,821250
324840,311144.2,1487200,183040,185952,665950,141800,125192.2,821250
316260,278567.5,1487200,176880,164143.3,665950,139380,114424.2,821250
307650,245157.3,1487200,170720,138063,665950,136930,107094.3,821250
304860,232046.9,1487200,169690,129611.3,665950,135170,102435.6,821250
301990,226215.4,1487200,168630,120303.2,665950,133360,105912.2,821250
299070,215109.2,1487200,167580,111594.8,665950,131490,103514.4,821250
296270,221156.5,1487200,166540,116076.6,665950,129730,105079.9,821250
297880,248786.9,1487200,169320,131516.2,665950,128560,117270.7,821250
299530,255127.8,1487200,172110,141142.1,665950,127420,113985.7,821250
301230,242917.6,1487200,174930,136640.7,665950,126300,106276.9,821250
302820,250082.1,1487200,177720,140373.2,665950,125100,109708.9,821250
305860,240668.8,1487200,180270,134244.8,665950,125590,106424,821250
308990,245421,1487200,182840,141142.2,665950,126150,104278.8,821250
312080,265320.3,1487200,185380,155501.8,665950,126700,109818.5,821250
315230,277329.7,1487200,187960,165191.8,665950,127270,112137.9,821250
319750,280235.5,1487200,189910,170855,665950,129840,109380.5,821250
324270,268121,1487200,191810,163075,665950,132460,105046,821250
328780,269735.3,1487200,193740,167139.9,665950,135040,102595.4,821250
333390,280360.8,1487200,195700,172004.8,665950,137690,108356,821250
340770,266389.8,1487200,200300,157765.5,665950,140470,108624.3,821250
348100,274158.2,1487200,204840,156296.5,665950,143260,117861.7,821250
355480,284322.5,1487200,209440,156373.1,665950,146040,127949.4,821250
362800,291012.3,1487200,214000,162261.4,665950,148800,128750.9,821250
369250,325890.7,1487200,218740,178670.4,665950,150510,147220.3,821250
375670,341513,1487200,223510,194854.8,665950,152160,146658.2,821250
382070,375319.7,1487200,228240,234005.8,665950,153830,141313.9,821250
388460,362510.6,1487200,233000,230143,665950,155460,132367.6,821250
384200,352898.5,1487200,232840,220222.7,665950,151360,132675.8,821250
380060,323163.4,1487200,232700,193975.2,665950,147360,129188.2,821250
375870,285055.2,1487200,232510,170480.3,665950,143360,114574.9,821250
371630,260530.6,1487200,232360,152366.7,665950,139270,108163.9,821250
366170,246426.1,1487200,233340,145087.6,665950,132830,101338.5,821250
360780,239829.7,1487200,234280,148365.8,665950,126500,91463.9,821250
355320,247392.9,1487200,235240,168124.6,665950,120080,79268.3,821250
349900,239940.6,1487200,236220,174818.3,665950,113680,65122.3,821250
343710,205108.2,1487200,237860,150984.3,665950,105850,54123.9,821250
337560,182916.7,1487200,239460,135652.4,665950,98100,47264.3,821250
331410,167548.9,1487200,241100,125764.3,665950,90310,41784.6,821250
325210,160826.2,1487200,242730,123358.1,665950,82480,37468.1,821250
327320,145586.6,1487200,243130,112300.1,665950,84190,33286.5,821250
329440,145024.7,1487200,243550,111463.4,665950,85890,33561.3,821250
331480,156532,1487200,243970,118536.8,665950,87510,37995.2,821250
333630,171537,1487200,244380,131407.4,665950,89250,40129.6,821250
339110,203510.1,1487200,246750,159136.5,665950,92360,44373.6,821250
344530,239841,1487200,249120,190824.5,665950,95410,49016.5,821250
350000,269628.1,1487200,251510,214687.5,665950,98490,54940.6,821250
355470,269324.4,1487200,253900,209321.2,665950,101570,60003.2,821250
361730,265012.4,1487200,256790,196739.5,665950,104940,68272.9,821250
368020,271586.7,1487200,259730,192372.7,665950,108290,79214,821250
374290,293243.8,1487200,262610,203942,665950,111680,89301.8,821250
380530,318335.7,1487200,265550,220707.7,665950,114980,97628,821250
390370,336068.2,1487200,269630,230085.5,665950,120740,105982.7,821250
400220,361816.5,1487200,273690,242848,665950,126530,118968.5,821250
410040,404850.4,1487200,277760,270463.5,665950,132280,134386.9,821250
419820,462152,1487200,281810,308668.9,665950,138010,153483.1,821250
432780,497179.1,1487200,288890,330783.2,665950,143890,166395.9,821250
445730,518446.8,1487200,295950,339621,665950,149780,178825.8,821250
458670,530051.9,1487200,303030,355484,665950,155640,174567.9,821250
471610,536142.9,1487200,310090,357166,665950,161520,178976.9,821250
479280,546798,1487200,312460,365765.9,665950,166820,181032.1,821250
487060,579279.7,1487200,314820,391639.4,665950,172240,187640.3,821250
494770,573587.1,1487200,317190,388448.7,665950,177580,185138.4,821250
502520,574912,1487200,319540,398884.8,665950,182980,176027.2,821250
525760,581337.7,1487200,330200,415053.6,665950,195560,166284.1,821250
548990,602446.1,1487200,340860,430378.2,665950,208130,172067.9,821250
572270,612859,1487200,351510,443934.4,665950,220760,168924.6,821250
595530,640338.3,1487200,362170,471803.6,665950,233360,168534.7,821250
618820,650807.2,1487200,372780,487907.4,665950,246040,162899.8,821250
642210,675660.6,1487200,383390,498008.5,665950,258820,177652.1,821250
665440,690986.1,1487200,394010,498490.5,665950,271430,192495.6,821250
688780,711161.2,1487200,404610,501401.1,665950,284170,209760.1,821250
713090,709732.9,1487200,415880,492421.7,665950,297210,217311.2,821250
737480,712262.5,1487200,427220,486875.4,665950,310260,225387.1,821250
761880,745288.1,1487200,438530,497300.3,665950,323350,247987.8,821250
786230,768227.7,1487200,449880,507066.3,665950,336350,261161.4,821250
790180,782550.5,1487200,452230,511480.8,665950,337950,271069.7,821250
794270,817380.1,1487200,454620,528408.7,665950,339650,288971.4,821250
798210,820794.3,1487200,456990,528701.2,665950,341220,292093.1,821250
802190,806388,1487200,459390,523315.9,665950,342800,283072.1,821250
805540,812121.3,1487200,461430,525548.4,665950,344110,286572.9,821250
808720,807078.6,1487200,463510,519482.2,665950,345210,287596.4,821250
811950,796945.7,1487200,465560,511707.9,665950,346390,285237.8,821250
815200,768380.1,1487200,467620,501379.4,665950,347580,267000.7,821250
817030,742339.6,1487200,469100,496922.6,665950,347930,245417,821250
818850,731610.9,1487200,470600,493456.1,665950,348250,238154.8,821250
820700,720442.8,1487200,472080,490775.9,665950,348620,229666.9,821250
822590,711827.3,1487200,473580,489961.1,665950,349010,221866.2,821250
818090,706410.9,1487200,471900,489549.4,665950,346190,216861.5,821250
813610,705676.7,1487200,470230,487522.6,665950,343380,218154.1,821250
809080,692751.8,1487200,468560,474975.9,665950,340520,217775.9,821250
805520,689747.8,1487200,467960,469329.6,665950,337560,220418.2,821250
803900,688537.5,1487200,467780,462522.3,665950,336120,226015.2,821250
802360,689507.9,1487200,467660,454632.1,665950,334700,234875.8,821250
800670,691887.5,1487200,467500,452998.5,665950,333170,238889,821250
799140,690554.1,1487200,467400,439930.8,665950,331740,250623.3,821250
796400,678030.5,1487200,467180,425862.4,665950,329220,252168.1,821250
793830,679993.5,1487200,467030,427842.6,665950,326800,252150.9,821250
791170,664375.6,1487200,466840,418640.5,665950,324330,245735.1,821250
788450,672650.7,1487200,466620,432158.3,665950,321830,240492.4,821250
790820,687419.6,1487200,467840,452069.2,665950,322980,235350.4,821250
793230,695154.7,1487200,469090,472788.5,665950,324140,222366.2,821250
795630,693074.9,1487200,470310,474449.7,665950,325320,218625.2,821250
798020,686331.9,1487200,471530,468714.9,665950,326490,217617,821250
799410,697952.9,1487200,472110,482211.4,665950,327300,215741.5,821250
800810,698658.4,1487200,472670,486092.6,665950,328140,212565.8,821250
802240,705831.6,1487200,473280,480792,665950,328960,225039.6,821250
803650,711745.4,1487200,473850,479731.7,665950,329800,232013.7,821250
803750,721370.3,1487200,473160,480475.5,665950,330590,240894.8,821250
803730,730043.9,1487200,472480,481495.6,665950,331250,248548.3,821250
803780,741511.2,1487200,471780,486027.8,665950,332000,255483.4,821250
803770,724634.4,1487200,471110,477814.9,665950,332660,246819.5,821250
802470,718238.6,1487200,470560,483954.3,665950,331910,234284.3,821250
801090,739046.6,1487200,469990,500217.3,665950,331100,238829.3,821250
799750,734523.6,1487200,469480,493082.9,665950,330270,241440.7,821250
798370,732902,1487200,468930,491830.4,665950,329440,241071.6,821250
797390,722163.8,1487200,468470,486518.8,665950,328920,235645,821250
796440,693852.4,1487200,468010,473693,665950,328430,220159.4,821250
795540,686893.6,1487200,467570,468386.1,665950,327970,218507.5,821250
794630,688104.2,1487200,467140,465156.3,665950,327490,222947.9,821250
793020,682309.4,1487200,467230,459155.4,665950,325790,223154,821250
791360,685412.5,1487200,467320,461768.6,665950,324040,223643.9,821250
789780,686877.4,1487200,467400,464739.6,665950,322380,222137.8,821250
788140,684930.8,1487200,467480,466261.6,665950,320660,218669.2,821250
783830,664490,1487200,468350,454967.1,665950,315480,209522.9,821250
779540,643339.7,1487200,469170,442830.1,665950,310370,200509.6,821250
775150,612585,1487200,469990,427299.8,665950,305160,185285.2,821250
770840,590373,1487200,470840,416993.5,665950,300000,173379.5,821250
765250,576457.2,1487200,470590,407500.8,665950,294660,168956.4,821250
759630,574091,1487200,470330,410503.8,665950,289300,163587.2,821250
754140,573684.8,1487200,470090,413132.9,665950,284050,160551.9,821250
748480,567599.7,1487200,469830,410989.4,665950,278650,156610.3,821250
741730,545470.9,1487200,468060,393726.3,665950,273670,151744.6,821250
734980,526689.4,1487200,466300,377944.8,665950,268680,148744.6,821250
728160,500403.9,1487200,464510,352439.9,665950,263650,147964,821250
721400,501392.8,1487200,462740,354651.3,665950,258660,146741.5,821250
713160,480239.1,1487200,457260,340293.8,665950,255900,139945.3,821250
704860,466129,1487200,451780,331698.1,665950,253080,134430.9,821250
696540,454673.4,1487200,446300,325363.7,665950,250240,129309.7,821250
688240,451425.2,1487200,440810,328856.5,665950,247430,122568.7,821250
678640,450338,1487200,433830,330789.7,665950,244810,119548.3,821250
669010,456868.9,1487200,426870,341186,665950,242140,115682.9,821250
659430,456565.3,1487200,419910,343276,665950,239520,113289.3,821250
649840,433468.5,1487200,412940,325949,665950,236900,107519.5,821250
642410,423274.1,1487200,407440,315863.3,665950,234970,107410.8,821250
635100,417867.1,1487200,401940,313274,665950,233160,104593.1,821250
627760,422407.7,1487200,396440,314626.2,665950,231320,107781.5,821250
620370,419825.5,1487200,390930,314014.7,665950,229440,105810.8,821250
620010,421156.1,1487200,390470,316053.3,665950,229540,105102.8,821250
619700,415417.7,1487200,390050,311603.6,665950,229650,103814.1,821250
619290,412006.6,1487200,389610,307702.8,665950,229680,104303.8,821250
618960,414772.2,1487200,389150,303198.5,665950,229810,111573.7,821250
617550,399150.2,1487200,387270,283706.9,665950,230280,115443.3,821250
616180,396302.7,1487200,385390,277015.9,665950,230790,119286.8,821250
614630,384246.3,1487200,383460,257567.6,665950,231170,126678.7,821250
613160,384059.3,1487200,381580,251554.8,665950,231580,132504.5,821250
612150,385721.9,1487200,380430,242211.9,665950,231720,143510,821250
611020,386270.2,1487200,379260,242866.9,665950,231760,143403.3,821250
609990,396887.6,1487200,378100,248547.5,665950,231890,148340.1,821250
608960,404857.4,1487200,376940,257000.9,665950,232020,147856.5,821250
614030,423332.3,1487200,379000,268343.8,665950,235030,154988.5,821250
619140,439444.8,1487200,381050,269632.8,665950,238090,169812,821250
624290,442514.6,1487200,383130,267742.1,665950,241160,174772.5,821250
629400,452090.5,1487200,385180,275768.7,665950,244220,176321.8,821250
634430,463119.7,1487200,387090,290726.1,665950,247340,172393.6,821250
639600,483012.7,1487200,389020,310081.4,665950,250580,172931.3,821250
644690,511836.7,1487200,390940,326122.7,665950,253750,185714,821250
649710,527596.3,1487200,392850,330164.6,665950,256860,197431.7,821250
653490,551621.4,1487200,394000,337745.1,665950,259490,213876.3,821250
657360,574671.1,1487200,395140,358277.3,665950,262220,216393.8,821250
661130,592691.3,1487200,396250,360284.2,665950,264880,232407.1,821250
664900,593645.3,1487200,397390,355163.1,665950,267510,238482.2,821250
664520,626347.2,1487200,397720,377846.6,665950,266800,248500.6,821250
664160,656981,1487200,398030,399095.9,665950,266130,257885.1,821250
663710,675440.6,1487200,398300,417275.7,665950,265410,258164.9,821250
663310,665072.6,1487200,398620,414851.1,665950,264690,250221.5,821250
662060,667210.8,1487200,398080,419950.8,665950,263980,247260,821250
660770,666217.7,1487200,397530,433181.5,665950,263240,233036.2,821250
659540,660127.9,1487200,396970,441933.1,665950,262570,218194.8,821250
658310,640838.4,1487200,396440,433828,665950,261870,207010.4,821250
657090,599606.5,1487200,396430,402602.5,665950,260660,197004,821250
655920,573483.7,1487200,396440,378150.1,665950,259480,195333.6,821250
654770,563209.8,1487200,396430,365206.4,665950,258340,198003.4,821250
653690,543579.2,1487200,396440,346857.9,665950,257250,196721.3,821250
643760,517603.6,1487200,391120,323570.3,665950,252640,194033.3,821250
633870,498871.4,1487200,385800,309378.9,665950,248070,189492.5,821250
624130,480724.6,1487200,380500,299372.6,665950,243630,181352,821250
622080,472546.8,1487200,367630,292293.6,665950,254450,180253.2,821250
614150,472630,1487200,364640,291235,665950,249510,181395,821250
606120,473615.5,1487200,361620,296651,665950,244500,176964.5,821250
598170,458599.4,1487200,358630,293388.1,665950,239540,165211.3,821250
590220,440356.8,1487200,355640,284994.2,665950,234580,155362.6,821250
583410,422744.5,1487200,353480,274412.7,665950,229930,148331.8,821250
576580,413367.9,1487200,351310,265427.7,665950,225270,147940.2,821250
569830,399991.1,1487200,349170,254070.1,665950,220660,145921,821250
562990,394343,1487200,346980,251482.5,665950,216010,142860.5,821250
562810,406299.1,1487200,347490,266402.4,665950,215320,139896.7,821250
562560,407428.5,1487200,347980,273012.4,665950,214580,134416.1,821250
562280,400081.2,1487200,348480,271551.4,665950,213800,128529.8,821250
562010,396292.8,1487200,348950,268341,665950,213060,127951.8,821250
563100,404443.1,1487200,350630,274927.9,665950,212470,129515.2,821250
564250,420965,1487200,352290,284703.4,665950,211960,136261.6,821250
565290,412872.4,1487200,353960,274549.8,665950,211330,138322.6,821250
566380,407056.4,1487200,355580,272068.5,665950,210800,134987.9,821250
566450,406674,1487200,356220,270855.3,665950,210230,135818.7,821250
566560,400166.8,1487200,356820,265971.2,665950,209740,134195.6,821250
566660,403531.6,1487200,357430,264481.4,665950,209230,139050.2,821250
566720,392463.1,1487200,358030,252911,665950,208690,139552.1,821250
564280,381636.2,1487200,356100,241187.3,665950,208180,140448.9,821250
561830,380028.1,1487200,354120,238515.8,665950,207710,141512.3,821250
559330,390277.8,1487200,352200,244201.8,665950,207130,146076,821250
556920,393147.1,1487200,350260,244654.4,665950,206660,148492.7,821250
553820,375889.7,1487200,347830,234689.1,665950,205990,141200.6,821250
550760,381959,1487200,345450,242494.9,665950,205310,139464.1,821250
547590,389124.8,1487200,343050,244362,665950,204540,144762.8,821250
544500,391622.6,1487200,340640,240674.4,665950,203860,150948.2,821250
543130,397957.8,1487200,339550,244981,665950,203580,152976.8,821250
541780,384803.7,1487200,338440,225758.8,665950,203340,159044.9,821250
540470,378426.8,1487200,337360,214067.2,665950,203110,164359.6,821250
539180,381061.3,1487200,336270,217225,665950,202910,163836.3,821250
528460,393002.6,1487200,332380,230600.9,665950,196080,162401.7,821250
517780,387423.9,1487200,328520,230172.4,665950,189260,157251.5,821250
507110,359447.3,1487200,324640,221302,665950,182470,138145.3,821250
496480,341617.7,1487200,320750,225272.6,665950,175730,116345.1,821250
480760,317270.8,1487200,315250,219705.9,665950,165510,97564.9,821250
465100,292898.3,1487200,309830,211951.2,665950,155270,80947.1,821250
449480,289290,1487200,304350,215865.6,665950,145130,73424.4,821250
433850,274076.9,1487200,298870,209689.5,665950,134980,64387.4,821250
421690,254777.2,1487200,294020,198113.3,665950,127670,56663.9,821250
409570,246129.4,1487200,289200,191822.2,665950,120370,54307.2,821250
397470,229920.6,1487200,284370,180368.4,665950,113100,49552.2,821250
385240,217054.1,1487200,279490,171876.1,665950,105750,45178,821250
374510,196062.7,1487200,271080,154312.4,665950,103430,41750.3,821250
363850,188984.6,1487200,262690,148933.4,665950,101160,40051.2,821250
353100,175005.1,1487200,254290,136100.4,665950,98810,38904.7,821250
342370,166962.1,1487200,245890,128807.4,665950,96480,38154.7,821250
334400,168519.6,1487200,240280,128770.8,665950,94120,39748.8,821250
326390,170558.1,1487200,234680,131206.6,665950,91710,39351.5,821250
318390,174334,1487200,229060,132330.1,665950,89330,42003.9,821250
310330,172180,1487200,223440,129062.7,665950,86890,43117.3,821250
303410,172107.8,1487200,218840,128101.4,665950,84570,44006.4,821250
296450,180636.7,1487200,214220,137428,665950,82230,43208.7,821250
289470,194751.4,1487200,209600,152244.3,665950,79870,42507.1,821250
282460,206312.2,1487200,204990,163897.5,665950,77470,42414.7,821250
280390,203427,1487200,202640,163394.5,665950,77750,40032.5,821250
278210,193244.8,1487200,200270,154731.6,665950,77940,38513.2,821250
276100,183445.7,1487200,197920,145663.3,665950,78180,37782.4,821250
274020,172322.6,1487200,195570,134407.2,665950,78450,37915.4,821250
272530,156877.6,1487200,194010,118084.2,665950,78520,38793.4,821250
271090,148688.6,1487200,192430,109958.5,665950,78660,38730.1,821250
269540,143184.5,1487200,190840,102232.1,665950,78700,40952.4,821250
268120,157640.1,1487200,189260,111255.4,665950,78860,46384.7,821250
264730,183701.9,1487200,185520,129459.5,665950,79210,54242.4,821250
261310,204481.4,1487200,181740,146063.1,665950,79570,58418.3,821250
257880,220174.4,1487200,177950,158574.5,665950,79930,61599.9,821250
254480,232035.4,1487200,174210,162384.1,665950,80270,69651.3,821250
263970,245719.6,1487200,179380,167060.5,665950,84590,78659.1,821250
273530,261677.3,1487200,184590,177299.5,665950,88940,84377.8,821250
282980,274490.4,1487200,189780,187740.4,665950,93200,86750,821250
292490,286388.8,1487200,194950,197284.9,665950,97540,89103.9,821250
303390,314208.9,1487200,201590,220633.1,665950,101800,93575.8,821250
314350,321110,1487200,208240,225075.8,665950,106110,96034.2,821250
325280,332457.6,1487200,214880,229895.1,665950,110400,102562.5,821250
336210,355104.9,1487200,221520,233953.3,665950,114690,121151.6,821250
347380,378599.4,1487200,228730,239109.8,665950,118650,139489.6,821250
358560,408071.3,1487200,235920,251861.9,665950,122640,156209.4,821250
369770,443795.9,1487200,243100,275549.7,665950,126670,168246.2,821250
380960,470984.5,1487200,250310,300853.5,665950,130650,170131,821250
380750,492993.2,1487200,249230,317679.5,665950,131520,175313.7,821250
380520,514148.7,1487200,248140,335099,665950,132380,179049.7,821250
380370,534649.8,1487200,247040,350392.8,665950,133330,184257,821250
380160,540427.2,1487200,245960,349440.4,665950,134200,190986.8,821250
377620,541265.8,1487200,242680,348035.6,665950,134940,193230.2,821250
375090,542683.4,1487200,239400,341553.7,665950,135690,201129.7,821250
372530,534311.9,1487200,236120,328913.3,665950,136410,205398.6,821250
370020,519149.2,1487200,232860,318351.8,665950,137160,200797.4,821250
370060,500528.1,1487200,232010,303864.1,665950,138050,196664,821250
370080,478054.9,1487200,231160,290674.3,665950,138920,187380.6,821250
370090,474013.8,1487200,230280,289667.5,665950,139810,184346.3,821250
370050,466434.7,1487200,229460,283138,665950,140590,183296.7,821250
364260,445464.8,1487200,227450,273580,665950,136810,171884.8,821250
358380,411596.8,1487200,225460,250981.5,665950,132920,160615.3,821250
352500,368139.5,1487200,223430,218292.8,665950,129070,149846.7,821250
